,total_degree,in_degree,internal_edges,out_degree,external_edges
10,819,152,101384,667,0
35,2102,402,683400,1700,0
60,119,22,2134,97,0
65,1552,299,374647,1253,0
94,135,30,3150,105,0
102,1876,359,544603,1517,0
107,1558,313,389685,1245,0
149,552,113,49607,439,0
176,1657,315,422730,1342,0
180,595,120,57000,475,0
181,865,167,116566,698,0
187,932,168,128352,764,0
202,385,71,22294,314,0
214,1296,252,263088,1044,0
219,1558,313,389685,1245,0
229,1331,255,274380,1076,0
240,1934,345,548205,1589,0
270,62,16,736,46,0
273,932,168,128352,764,0
297,1411,281,317530,1130,0
305,620,121,60379,499,0
315,1296,252,263088,1044,0
327,821,143,96954,678,0
332,821,143,96954,678,0
358,1541,306,377910,1235,0
359,1558,313,389685,1245,0
360,282,50,11600,232,0
384,337,74,19462,263,0
387,821,143,96954,678,0
398,516,103,42539,413,0
399,217,44,7612,173,0
411,2102,402,683400,1700,0
412,714,137,79049,577,0
433,932,168,128352,764,0
450,778,163,100245,615,0
453,380,76,23104,304,0
454,61,14,658,47,0
484,1342,282,298920,1060,0
509,950,193,146101,757,0
530,1934,345,548205,1589,0
537,1296,252,263088,1044,0
540,1934,345,548205,1589,0
551,700,128,73216,572,0
557,135,30,3150,105,0
560,156,34,4148,122,0
576,932,168,128352,764,0
584,1025,201,165624,824,0
597,88,17,1207,71,0
615,217,44,7612,173,0
616,971,184,144808,787,0
662,971,184,144808,787,0
665,1552,299,374647,1253,0
668,124,28,2688,96,0
675,69,12,684,57,0
676,1411,281,317530,1130,0
682,971,184,144808,787,0
684,620,121,60379,499,0
688,1280,232,243136,1048,0
696,305,70,16450,235,0
698,1829,353,521028,1476,0
700,415,75,25500,340,0
714,819,152,101384,667,0
716,1934,345,548205,1589,0
719,950,193,146101,757,0
733,950,193,146101,757,0
752,641,131,66810,510,0
758,1552,299,374647,1253,0
764,1657,315,422730,1342,0
767,595,120,57000,475,0
780,1181,246,230010,935,0
795,1280,232,243136,1048,0
815,40,7,231,33,0
819,1552,299,374647,1253,0
821,793,158,100330,635,0
848,976,180,143280,796,0
851,819,152,101384,667,0
858,971,184,144808,787,0
884,1025,201,165624,824,0
890,971,184,144808,787,0
903,548,102,45492,446,0
907,1829,353,521028,1476,0
910,1552,299,374647,1253,0
917,1876,359,544603,1517,0
931,1876,359,544603,1517,0
932,950,193,146101,757,0
934,2102,402,683400,1700,0
954,110,27,2241,83,0
976,793,158,100330,635,0
982,2102,402,683400,1700,0
1000,568,114,51756,454,0
1011,641,131,66810,510,0
1026,1342,282,298920,1060,0
1037,865,167,116566,698,0
1045,58,11,517,47,0
1048,1342,282,298920,1060,0
1066,1541,306,377910,1235,0
1095,534,102,44064,432,0
1105,534,102,44064,432,0
1127,976,180,143280,796,0
1131,1558,313,389685,1245,0
1145,1411,281,317530,1130,0
1153,1078,198,174240,880,0
1165,17,3,42,14,0
1179,1541,306,377910,1235,0
1189,1552,299,374647,1253,0
1190,1262,259,259777,1003,0
1194,1411,281,317530,1130,0
1198,317,63,16002,254,0
1199,1181,246,230010,935,0
1200,64,15,735,49,0
1261,317,63,16002,254,0
1270,1558,313,389685,1245,0
1273,395,72,23256,323,0
1283,54,14,560,40,0
1288,323,55,14740,268,0
1293,778,163,100245,615,0
1297,401,77,24948,324,0
1312,1411,281,317530,1130,0
1319,495,87,35496,408,0
1344,595,121,57354,474,0
1355,1181,246,230010,935,0
1358,174,36,4968,138,0
1359,156,34,4148,122,0
1366,1262,259,259777,1003,0
1367,497,97,38800,400,0
1377,819,152,101384,667,0
1396,620,121,60379,499,0
1405,1876,359,544603,1517,0
1417,2102,402,683400,1700,0
1425,950,193,146101,757,0
1426,568,114,51756,454,0
1429,641,131,66810,510,0
1439,865,167,116566,698,0
1465,62,16,736,46,0
1486,1025,201,165624,824,0
1494,282,50,11600,232,0
1521,1280,232,243136,1048,0
1522,23,6,102,17,0
1523,551,102,45798,449,0
1551,1552,299,374647,1253,0
1557,264,56,11648,208,0
1563,572,130,57460,442,0
1569,976,180,143280,796,0
1581,2102,402,683400,1700,0
1591,16,3,39,13,0
1602,24,6,108,18,0
1616,819,152,101384,667,0
1619,1280,232,243136,1048,0
1625,2102,402,683400,1700,0
1632,932,168,128352,764,0
1640,1181,246,230010,935,0
1644,534,102,44064,432,0
1655,1876,359,544603,1517,0
1669,1583,310,394630,1273,0
1673,595,120,57000,475,0
1685,415,75,25500,340,0
1688,110,27,2241,83,0
1691,700,128,73216,572,0
1706,539,101,44238,438,0
1725,1296,252,263088,1044,0
1726,1411,281,317530,1130,0
1748,793,158,100330,635,0
1769,1934,345,548205,1589,0
1771,2102,402,683400,1700,0
1779,305,70,16450,235,0
1783,1876,359,544603,1517,0
1789,1025,201,165624,824,0
1799,778,163,100245,615,0
1815,836,151,103435,685,0
1819,551,102,45798,449,0
1828,131,21,2310,110,0
1848,950,193,146101,757,0
1873,27,4,92,23,0
1897,620,121,60379,499,0
1909,535,94,41454,441,0
1927,1331,255,274380,1076,0
1930,836,151,103435,685,0
1934,1552,299,374647,1253,0
1938,1331,255,274380,1076,0
1944,767,144,89712,623,0
1945,1583,310,394630,1273,0
1974,932,168,128352,764,0
1979,443,85,30430,358,0
1994,1078,198,174240,880,0
2022,337,74,19462,263,0
2034,516,103,42539,413,0
2039,1280,232,243136,1048,0
2070,2102,402,683400,1700,0
2075,185,36,5364,149,0
2081,1331,255,274380,1076,0
2084,65,13,676,52,0
2089,119,22,2134,97,0
2103,89,15,1110,74,0
2106,1934,345,548205,1589,0
2124,160,29,3799,131,0
2155,122,22,2200,100,0
2181,571,114,52098,457,0
2194,932,168,128352,764,0
2195,443,85,30430,358,0
2221,1558,313,389685,1245,0
2233,36,10,260,26,0
2262,379,65,20410,314,0
2263,620,121,60379,499,0
2285,516,103,42539,413,0
2304,1541,306,377910,1235,0
2316,1934,345,548205,1589,0
2325,137,25,2800,112,0
2346,1296,252,263088,1044,0
2354,1657,315,422730,1342,0
2365,2102,402,683400,1700,0
2369,131,25,2650,106,0
2397,971,184,144808,787,0
2409,61,11,550,50,0
2427,119,25,2350,94,0
2443,252,45,9315,207,0
2460,793,158,100330,635,0
2472,16,3,39,13,0
2487,767,144,89712,623,0
2497,771,137,86858,634,0
2530,572,130,57460,442,0
2550,660,133,69928,527,0
2564,366,70,20720,296,0
2576,976,180,143280,796,0
2585,495,87,35496,408,0
2587,365,74,21534,291,0
2601,767,144,89712,623,0
2609,620,121,60379,499,0
2622,315,56,14504,259,0
2625,571,114,52098,457,0
2628,932,168,128352,764,0
2665,22,3,57,19,0
2697,2102,402,683400,1700,0
2715,1078,198,174240,880,0
2735,1262,259,259777,1003,0
2742,405,82,26486,323,0
2747,548,102,45492,446,0
2758,1829,353,521028,1476,0
2760,145,23,2806,122,0
2766,778,163,100245,615,0
2774,793,158,100330,635,0
2799,950,193,146101,757,0
2806,1558,313,389685,1245,0
2807,572,130,57460,442,0
2828,1078,198,174240,880,0
2830,976,180,143280,796,0
2836,1583,310,394630,1273,0
2847,932,168,128352,764,0
2867,1558,313,389685,1245,0
2881,252,45,9315,207,0
2906,1558,313,389685,1245,0
2907,323,55,14740,268,0
2940,122,22,2200,100,0
2957,105,15,1350,90,0
2971,552,113,49607,439,0
2986,1558,313,389685,1245,0
2992,373,74,22126,299,0
2999,102,20,1640,82,0
3000,135,30,3150,105,0
3005,1025,201,165624,824,0
3006,385,71,22294,314,0
3025,660,133,69928,527,0
3026,5,1,4,4,0
3034,1181,246,230010,935,0
3058,1552,299,374647,1253,0
3062,1296,252,263088,1044,0
3067,1934,345,548205,1589,0
3108,463,83,31540,380,0
3130,976,180,143280,796,0
3133,64,16,768,48,0
3137,236,50,9300,186,0
3146,571,114,52098,457,0
3162,1331,255,274380,1076,0
3190,516,103,42539,413,0
3199,821,171,111150,650,0
3206,595,121,57354,474,0
3214,1541,306,377910,1235,0
3218,32,5,135,27,0
3226,305,70,16450,235,0
3232,620,121,60379,499,0
3233,1078,198,174240,880,0
3250,1829,353,521028,1476,0
3255,1342,282,298920,1060,0
3257,1541,306,377910,1235,0
3285,1583,310,394630,1273,0
3287,379,65,20410,314,0
3290,373,74,22126,299,0
3303,793,158,100330,635,0
3312,572,130,57460,442,0
3323,778,163,100245,615,0
3326,659,132,69928,527,0
3337,1280,232,243136,1048,0
3342,2102,402,683400,1700,0
3351,595,121,57354,474,0
3378,771,137,86858,634,0
3380,932,168,128352,764,0
3382,1657,315,422730,1342,0
3388,971,184,144808,787,0
3395,61,7,378,54,0
3413,1262,259,259777,1003,0
3425,1025,201,165624,824,0
3437,641,131,66810,510,0
3439,660,133,69928,527,0
3444,185,36,5364,149,0
3446,1552,299,374647,1253,0
3463,365,74,21534,291,0
3465,552,113,49607,439,0
3466,821,143,96954,678,0
3476,971,184,144808,787,0
3477,264,56,11648,208,0
3488,495,87,35496,408,0
3490,1280,232,243136,1048,0
3519,273,58,12470,215,0
3533,865,167,116566,698,0
3534,778,163,100245,615,0
3540,305,70,16450,235,0
3557,61,11,550,50,0
3559,1411,281,317530,1130,0
3569,595,120,57000,475,0
3581,131,21,2310,110,0
3589,1558,313,389685,1245,0
3593,27,5,110,22,0
3620,836,151,103435,685,0
3625,1078,198,174240,880,0
3631,932,168,128352,764,0
3632,410,76,25384,334,0
3679,1025,201,165624,824,0
3680,714,137,79049,577,0
3693,1204,251,239203,953,0
3710,71,15,840,56,0
3726,1296,252,263088,1044,0
3727,1541,306,377910,1235,0
3751,771,137,86858,634,0
3756,1204,251,239203,953,0
3761,236,50,9300,186,0
3777,821,171,111150,650,0
3781,410,76,25384,334,0
3788,315,56,14504,259,0
3790,1411,281,317530,1130,0
3817,767,144,89712,623,0
3818,700,128,73216,572,0
3824,1331,255,274380,1076,0
3829,1558,313,389685,1245,0
3830,134,30,3120,104,0
3854,971,184,144808,787,0
3861,305,70,16450,235,0
3885,401,77,24948,324,0
3896,274,57,12369,217,0
3899,122,20,2040,102,0
3900,1078,198,174240,880,0
3912,193,39,6006,154,0
3920,1296,252,263088,1044,0
3955,971,184,144808,787,0
3969,110,27,2241,83,0
3992,516,103,42539,413,0
3994,1558,313,389685,1245,0
3996,836,151,103435,685,0
4000,771,137,86858,634,0
4001,497,97,38800,400,0
4011,976,180,143280,796,0
4012,971,184,144808,787,0
4022,595,121,57354,474,0
4029,1181,246,230010,935,0
4038,217,44,7612,173,0
4039,1204,251,239203,953,0
4079,323,55,14740,268,0
4097,134,30,3120,104,0
4098,156,34,4148,122,0
4100,778,163,100245,615,0
4102,1552,299,374647,1253,0
4118,145,23,2806,122,0
4145,37,5,160,32,0
4159,1262,259,259777,1003,0
4177,1558,313,389685,1245,0
4182,200,40,6400,160,0
4192,1541,306,377910,1235,0
4210,1876,359,544603,1517,0
4211,102,20,1640,82,0
4224,714,137,79049,577,0
4225,207,41,6806,166,0
4232,1025,201,165624,824,0
4262,1296,252,263088,1044,0
4295,337,74,19462,263,0
4311,127,29,2842,98,0
4330,534,102,44064,432,0
4332,1078,198,174240,880,0
4336,185,36,5364,149,0
4340,171,35,4760,136,0
4349,1296,252,263088,1044,0
4350,1541,306,377910,1235,0
4351,551,102,45798,449,0
4361,1657,315,422730,1342,0
4376,1829,353,521028,1476,0
4383,1876,359,544603,1517,0
4405,185,36,5364,149,0
4419,34,7,189,27,0
4420,1078,198,174240,880,0
4431,137,25,2800,112,0
4443,572,130,57460,442,0
4460,410,76,25384,334,0
4463,32,5,135,27,0
4478,1583,310,394630,1273,0
4482,976,180,143280,796,0
4498,793,158,100330,635,0
4502,395,72,23256,323,0
4505,443,85,30430,358,0
4514,976,180,143280,796,0
4533,405,82,26486,323,0
4570,1558,313,389685,1245,0
4574,174,36,4968,138,0
4603,778,163,100245,615,0
4604,767,144,89712,623,0
4610,1025,201,165624,824,0
4620,641,131,66810,510,0
4647,1829,353,521028,1476,0
4650,415,75,25500,340,0
4666,595,120,57000,475,0
4684,1204,251,239203,953,0
4704,778,163,100245,615,0
4707,21,6,90,15,0
4730,700,128,73216,572,0
4732,337,74,19462,263,0
4765,971,184,144808,787,0
4770,323,55,14740,268,0
4804,1934,345,548205,1589,0
4823,976,180,143280,796,0
4853,1829,353,521028,1476,0
4860,1262,259,259777,1003,0
4883,572,130,57460,442,0
4885,1296,252,263088,1044,0
4889,821,143,96954,678,0
4892,77,18,1062,59,0
4916,1025,201,165624,824,0
4917,1876,359,544603,1517,0
4977,539,101,44238,438,0
4983,1876,359,544603,1517,0
5029,1541,306,377910,1235,0
5047,373,74,22126,299,0
5053,305,70,16450,235,0
5058,516,103,42539,413,0
5063,535,94,41454,441,0
5080,950,193,146101,757,0
5103,659,132,69928,527,0
5129,1181,246,230010,935,0
5136,551,102,45798,449,0
5139,28,7,147,21,0
5140,551,102,45798,449,0
5150,1331,255,274380,1076,0
5155,1411,281,317530,1130,0
5160,1657,315,422730,1342,0
5161,1558,313,389685,1245,0
5175,568,114,51756,454,0
5178,155,27,3456,128,0
5197,8,1,7,7,0
5206,1296,252,263088,1044,0
5209,932,168,128352,764,0
5210,155,27,3456,128,0
5224,1411,281,317530,1130,0
5227,323,55,14740,268,0
5244,1262,259,259777,1003,0
5267,127,29,2842,98,0
5271,836,151,103435,685,0
5276,2102,402,683400,1700,0
5281,1934,345,548205,1589,0
5309,1552,299,374647,1253,0
5314,360,66,19404,294,0
5329,317,63,16002,254,0
5340,950,193,146101,757,0
5341,836,151,103435,685,0
5344,572,130,57460,442,0
5351,401,77,24948,324,0
5355,595,120,57000,475,0
5358,1078,198,174240,880,0
5364,1552,299,374647,1253,0
5370,68,15,795,53,0
5375,821,171,111150,650,0
5390,1583,310,394630,1273,0
5416,1280,232,243136,1048,0
5425,1934,345,548205,1589,0
5428,72,17,935,55,0
5440,1342,282,298920,1060,0
5441,821,143,96954,678,0
5467,1411,281,317530,1130,0
5469,1262,259,259777,1003,0
5487,321,54,14418,267,0
5510,1296,252,263088,1044,0
5518,971,184,144808,787,0
5527,1583,310,394630,1273,0
5531,1331,255,274380,1076,0
5541,463,83,31540,380,0
5560,595,120,57000,475,0
5563,836,151,103435,685,0
5596,2102,402,683400,1700,0
5603,1181,246,230010,935,0
5605,1583,310,394630,1273,0
5627,1025,201,165624,824,0
5634,1078,198,174240,880,0
5644,144,29,3335,115,0
5648,1078,198,174240,880,0
5649,185,36,5364,149,0
5653,1280,232,243136,1048,0
5655,77,19,1102,58,0
5656,1541,306,377910,1235,0
5673,193,39,6006,154,0
5700,568,114,51756,454,0
5701,1181,246,230010,935,0
5703,1934,345,548205,1589,0
5717,88,17,1207,71,0
5720,1078,198,174240,880,0
5737,659,132,69928,527,0
5747,552,113,49607,439,0
5783,207,41,6806,166,0
5794,495,87,35496,408,0
5809,767,144,89712,623,0
5818,193,39,6006,154,0
5841,1280,232,243136,1048,0
5846,282,50,11600,232,0
5855,1204,251,239203,953,0
5857,105,22,1826,83,0
5872,778,163,100245,615,0
5894,198,43,6665,155,0
5896,1657,315,422730,1342,0
5905,1657,315,422730,1342,0
5906,380,76,23104,304,0
5923,1342,282,298920,1060,0
5937,1078,198,174240,880,0
5943,865,167,116566,698,0
5944,65,17,816,48,0
5950,767,144,89712,623,0
5952,1934,345,548205,1589,0
5955,1541,306,377910,1235,0
5995,932,168,128352,764,0
6027,72,17,935,55,0
6028,443,85,30430,358,0
6043,819,152,101384,667,0
6047,865,167,116566,698,0
6098,1934,345,548205,1589,0
6106,1331,255,274380,1076,0
6113,380,76,23104,304,0
6117,1025,201,165624,824,0
6121,346,76,20520,270,0
6135,932,168,128352,764,0
6151,700,128,73216,572,0
6165,1934,345,548205,1589,0
6168,572,130,57460,442,0
6171,264,56,11648,208,0
6182,1876,359,544603,1517,0
6206,1934,345,548205,1589,0
6226,160,29,3799,131,0
6233,65,17,816,48,0
6237,1541,306,377910,1235,0
6246,1342,282,298920,1060,0
6247,305,70,16450,235,0
6271,58,15,645,43,0
6282,971,184,144808,787,0
6284,1552,299,374647,1253,0
6321,405,82,26486,323,0
6325,534,102,44064,432,0
6334,64,16,768,48,0
6345,22,6,96,16,0
6358,767,144,89712,623,0
6359,366,70,20720,296,0
6371,119,25,2350,94,0
6407,6,1,5,5,0
6408,1934,345,548205,1589,0
6410,1411,281,317530,1130,0
6411,1025,201,165624,824,0
6412,26,8,144,18,0
6427,1541,306,377910,1235,0
6446,1025,201,165624,824,0
6455,1331,255,274380,1076,0
6471,236,50,9300,186,0
6478,43,7,252,36,0
6481,1583,310,394630,1273,0
6501,54,14,560,40,0
6503,819,152,101384,667,0
6520,337,74,19462,263,0
6525,1583,310,394630,1273,0
6535,819,152,101384,667,0
6543,552,113,49607,439,0
6546,1552,299,374647,1253,0
6552,660,133,69928,527,0
6554,767,144,89712,623,0
6568,122,25,2425,97,0
6572,36,10,260,26,0
6574,1181,246,230010,935,0
6578,1558,313,389685,1245,0
6587,495,87,35496,408,0
6600,1331,255,274380,1076,0
6609,401,77,24948,324,0
6612,1411,281,317530,1130,0
6644,40,9,279,31,0
6655,1342,282,298920,1060,0
6663,273,58,12470,215,0
6689,950,193,146101,757,0
6699,1829,353,521028,1476,0
6712,144,29,3335,115,0
6720,28,7,147,21,0
6757,89,15,1110,74,0
6760,207,41,6806,166,0
6761,1829,353,521028,1476,0
6792,976,180,143280,796,0
6800,1078,198,174240,880,0
6810,171,35,4760,136,0
6821,595,120,57000,475,0
6822,1280,232,243136,1048,0
6851,198,43,6665,155,0
6888,134,30,3120,104,0
6917,11,4,28,7,0
6941,836,151,103435,685,0
6944,552,113,49607,439,0
6970,950,193,146101,757,0
6982,700,128,73216,572,0
6983,1078,198,174240,880,0
6990,185,36,5364,149,0
6999,373,74,22126,299,0
7012,31,9,198,22,0
7013,1583,310,394630,1273,0
7028,1181,246,230010,935,0
7035,401,77,24948,324,0
7055,950,193,146101,757,0
7072,778,163,100245,615,0
7078,1296,252,263088,1044,0
7097,324,67,17219,257,0
7099,282,50,11600,232,0
7109,539,101,44238,438,0
7121,315,56,14504,259,0
7132,495,87,35496,408,0
7135,227,44,8052,183,0
7141,950,193,146101,757,0
7161,69,14,770,55,0
7167,26,4,88,22,0
7191,2102,402,683400,1700,0
7198,1331,255,274380,1076,0
7221,366,70,20720,296,0
7223,1331,255,274380,1076,0
7224,443,85,30430,358,0
7260,821,143,96954,678,0
7281,405,82,26486,323,0
7285,1934,345,548205,1589,0
7302,200,40,6400,160,0
7309,1829,353,521028,1476,0
7330,1583,310,394630,1273,0
7334,1280,232,243136,1048,0
7366,1558,313,389685,1245,0
7383,443,85,30430,358,0
7387,346,76,20520,270,0
7389,1262,259,259777,1003,0
7391,551,102,45798,449,0
7392,273,58,12470,215,0
7395,1558,313,389685,1245,0
7396,1829,353,521028,1476,0
7399,1657,315,422730,1342,0
7405,572,130,57460,442,0
7417,317,63,16002,254,0
7433,186,35,5285,151,0
7434,1552,299,374647,1253,0
7444,1829,353,521028,1476,0
7457,1829,353,521028,1476,0
7458,47,11,396,36,0
7467,1657,315,422730,1342,0
7478,1280,232,243136,1048,0
7502,976,180,143280,796,0
7504,321,54,14418,267,0
7505,1078,198,174240,880,0
7518,1541,306,377910,1235,0
7521,28,7,147,21,0
7529,410,76,25384,334,0
7551,1829,353,521028,1476,0
7577,65,17,816,48,0
7582,1558,313,389685,1245,0
7596,1181,246,230010,935,0
7611,135,30,3150,105,0
7619,548,102,45492,446,0
7631,185,36,5364,149,0
7648,1657,315,422730,1342,0
7675,1876,359,544603,1517,0
7692,534,102,44064,432,0
7695,548,102,45492,446,0
7709,1296,252,263088,1044,0
7735,1181,246,230010,935,0
7747,534,102,44064,432,0
7751,1876,359,544603,1517,0
7762,337,74,19462,263,0
7764,1541,306,377910,1235,0
7771,572,130,57460,442,0
7777,2102,402,683400,1700,0
7780,1552,299,374647,1253,0
7818,1342,282,298920,1060,0
7823,85,18,1206,67,0
7829,1541,306,377910,1235,0
7837,1583,310,394630,1273,0
7848,620,121,60379,499,0
7854,305,70,16450,235,0
7859,119,25,2350,94,0
7871,1262,259,259777,1003,0
7892,1876,359,544603,1517,0
7930,65,17,816,48,0
7987,2102,402,683400,1700,0
7990,1025,201,165624,824,0
8018,1934,345,548205,1589,0
8037,155,27,3456,128,0
8044,134,30,3120,104,0
8070,1204,251,239203,953,0
8091,282,50,11600,232,0
8118,1078,198,174240,880,0
8123,1331,255,274380,1076,0
8124,1558,313,389685,1245,0
8140,535,94,41454,441,0
8168,819,152,101384,667,0
8186,836,151,103435,685,0
8188,174,36,4968,138,0
8192,49,9,360,40,0
8214,373,74,22126,299,0
8236,1411,281,317530,1130,0
8237,323,55,14740,268,0
8239,1342,282,298920,1060,0
8240,61,8,424,53,0
8256,124,28,2688,96,0
8262,1280,232,243136,1048,0
8270,415,75,25500,340,0
8285,950,193,146101,757,0
8288,1829,353,521028,1476,0
8294,865,167,116566,698,0
8305,385,71,22294,314,0
8306,200,40,6400,160,0
8310,1876,359,544603,1517,0
8324,595,120,57000,475,0
8344,415,75,25500,340,0
8345,317,63,16002,254,0
8371,20,4,64,16,0
8388,2102,402,683400,1700,0
8390,821,143,96954,678,0
8411,1541,306,377910,1235,0
8416,137,25,2800,112,0
8424,2102,402,683400,1700,0
8433,1934,345,548205,1589,0
8449,379,65,20410,314,0
8454,1342,282,298920,1060,0
8465,236,50,9300,186,0
8467,1331,255,274380,1076,0
8469,264,56,11648,208,0
8493,1262,259,259777,1003,0
8497,572,130,57460,442,0
8503,714,137,79049,577,0
8519,1657,315,422730,1342,0
8523,1934,345,548205,1589,0
8531,360,66,19404,294,0
8572,385,71,22294,314,0
8574,1078,198,174240,880,0
8620,821,171,111150,650,0
8623,836,151,103435,685,0
8625,1657,315,422730,1342,0
8626,317,63,16002,254,0
8647,1411,281,317530,1130,0
8658,1025,201,165624,824,0
8663,401,77,24948,324,0
8664,25,3,66,22,0
8669,198,43,6665,155,0
8678,194,39,6045,155,0
8710,641,131,66810,510,0
8712,1181,246,230010,935,0
8721,700,128,73216,572,0
8722,1934,345,548205,1589,0
8734,950,193,146101,757,0
8753,568,114,51756,454,0
8754,1657,315,422730,1342,0
8755,1552,299,374647,1253,0
8758,821,171,111150,650,0
8772,1552,299,374647,1253,0
8773,1541,306,377910,1235,0
8774,31,7,168,24,0
8776,274,57,12369,217,0
8782,1934,345,548205,1589,0
8786,778,163,100245,615,0
8789,714,137,79049,577,0
8795,516,103,42539,413,0
8802,395,72,23256,323,0
8810,1558,313,389685,1245,0
8814,1331,255,274380,1076,0
8829,595,120,57000,475,0
8830,71,15,840,56,0
8834,1296,252,263088,1044,0
8847,463,83,31540,380,0
8855,778,163,100245,615,0
8885,551,102,45798,449,0
8889,778,163,100245,615,0
8918,47,11,396,36,0
8926,200,40,6400,160,0
8947,572,130,57460,442,0
8950,539,101,44238,438,0
8958,793,158,100330,635,0
8993,1657,315,422730,1342,0
9015,793,158,100330,635,0
9032,1552,299,374647,1253,0
9042,274,57,12369,217,0
9055,1541,306,377910,1235,0
9063,2102,402,683400,1700,0
9086,373,74,22126,299,0
9095,1262,259,259777,1003,0
9125,134,30,3120,104,0
9140,122,25,2425,97,0
9148,1583,310,394630,1273,0
9150,1541,306,377910,1235,0
9153,1657,315,422730,1342,0
9173,1657,315,422730,1342,0
9176,70,15,825,55,0
9184,380,76,23104,304,0
9198,1280,232,243136,1048,0
9223,160,29,3799,131,0
9227,11,3,24,8,0
9228,641,131,66810,510,0
9248,1204,251,239203,953,0
9259,68,14,756,54,0
9271,1204,251,239203,953,0
9279,200,40,6400,160,0
9281,1025,201,165624,824,0
9298,1296,252,263088,1044,0
9299,1262,259,259777,1003,0
9304,1876,359,544603,1517,0
9305,1262,259,259777,1003,0
9322,595,121,57354,474,0
9335,1541,306,377910,1235,0
9337,1204,251,239203,953,0
9348,1541,306,377910,1235,0
9349,495,87,35496,408,0
9361,1342,282,298920,1060,0
9380,1078,198,174240,880,0
9382,323,55,14740,268,0
9401,105,22,1826,83,0
9425,2102,402,683400,1700,0
9450,315,56,14504,259,0
9453,976,180,143280,796,0
9473,551,102,45798,449,0
9504,415,75,25500,340,0
9512,89,15,1110,74,0
9517,1552,299,374647,1253,0
9526,1583,310,394630,1273,0
9537,660,133,69928,527,0
9569,1181,246,230010,935,0
9574,131,21,2310,110,0
9575,1552,299,374647,1253,0
9580,35,9,234,26,0
9590,571,114,52098,457,0
9602,552,113,49607,439,0
9603,1331,255,274380,1076,0
9604,821,143,96954,678,0
9609,793,158,100330,635,0
9610,1583,310,394630,1273,0
9612,1025,201,165624,824,0
9617,821,143,96954,678,0
9626,1876,359,544603,1517,0
9633,950,193,146101,757,0
9643,405,82,26486,323,0
9651,552,113,49607,439,0
9657,1025,201,165624,824,0
9666,264,56,11648,208,0
9669,1558,313,389685,1245,0
9674,127,29,2842,98,0
9683,1829,353,521028,1476,0
9696,379,65,20410,314,0
9697,1657,315,422730,1342,0
9701,1934,345,548205,1589,0
9706,497,97,38800,400,0
9745,395,72,23256,323,0
9777,714,137,79049,577,0
9788,1829,353,521028,1476,0
9797,122,22,2200,100,0
9800,282,50,11600,232,0
9814,19,3,48,16,0
9817,1657,315,422730,1342,0
9824,641,131,66810,510,0
9842,767,144,89712,623,0
9867,572,130,57460,442,0
9879,821,171,111150,650,0
9882,160,32,4096,128,0
9891,1411,281,317530,1130,0
9894,194,39,6045,155,0
9907,1552,299,374647,1253,0
9908,1934,345,548205,1589,0
9925,821,143,96954,678,0
9945,1331,255,274380,1076,0
9960,385,71,22294,314,0
9965,660,133,69928,527,0
9986,548,102,45492,446,0
9997,68,15,795,53,0
10027,660,133,69928,527,0
10048,323,55,14740,268,0
10056,321,54,14418,267,0
10065,26,6,120,20,0
10066,595,120,57000,475,0
10079,274,57,12369,217,0
10093,380,76,23104,304,0
10096,198,43,6665,155,0
10126,1331,255,274380,1076,0
10133,572,130,57460,442,0
10135,1280,232,243136,1048,0
10143,1181,246,230010,935,0
10151,971,184,144808,787,0
10168,380,76,23104,304,0
10170,148,24,2976,124,0
10199,1262,259,259777,1003,0
10218,595,121,57354,474,0
10221,571,114,52098,457,0
10223,497,97,38800,400,0
10225,1583,310,394630,1273,0
10231,366,70,20720,296,0
10241,1331,255,274380,1076,0
10252,865,167,116566,698,0
10255,568,114,51756,454,0
10256,2102,402,683400,1700,0
10270,1583,310,394630,1273,0
10276,793,158,100330,635,0
10291,660,133,69928,527,0
10300,1331,255,274380,1076,0
10302,1541,306,377910,1235,0
10349,1829,353,521028,1476,0
10365,379,65,20410,314,0
10368,337,74,19462,263,0
10378,1829,353,521028,1476,0
10381,865,167,116566,698,0
10389,1280,232,243136,1048,0
10399,410,76,25384,334,0
10453,70,12,696,58,0
10454,1342,282,298920,1060,0
10459,410,76,25384,334,0
10464,127,29,2842,98,0
10489,193,39,6006,154,0
10525,950,193,146101,757,0
10537,32,5,135,27,0
10554,1280,232,243136,1048,0
10563,1181,246,230010,935,0
10566,595,120,57000,475,0
10576,110,18,1656,92,0
10579,1558,313,389685,1245,0
10581,778,163,100245,615,0
10592,385,71,22294,314,0
10604,1331,255,274380,1076,0
10607,236,50,9300,186,0
10613,1558,313,389685,1245,0
10637,571,114,52098,457,0
10641,1025,201,165624,824,0
10651,127,29,2842,98,0
10660,121,27,2538,94,0
10663,60,12,576,48,0
10664,2102,402,683400,1700,0
10669,1411,281,317530,1130,0
10674,1280,232,243136,1048,0
10684,1934,345,548205,1589,0
10686,1876,359,544603,1517,0
10687,1411,281,317530,1130,0
10700,1552,299,374647,1253,0
10736,110,27,2241,83,0
10743,1583,310,394630,1273,0
10748,495,87,35496,408,0
10758,821,143,96954,678,0
10787,385,71,22294,314,0
10788,516,103,42539,413,0
10796,1558,313,389685,1245,0
10827,105,15,1350,90,0
10839,1541,306,377910,1235,0
10857,620,121,60379,499,0
10866,252,45,9315,207,0
10877,34,7,189,27,0
10881,1552,299,374647,1253,0
10896,552,113,49607,439,0
10897,346,76,20520,270,0
10902,463,83,31540,380,0
10929,198,43,6665,155,0
10935,155,27,3456,128,0
10938,793,158,100330,635,0
10941,836,151,103435,685,0
10958,365,74,21534,291,0
10960,144,29,3335,115,0
10991,539,101,44238,438,0
11006,273,58,12470,215,0
11017,58,12,552,46,0
11019,1552,299,374647,1253,0
11046,121,27,2538,94,0
11053,568,114,51756,454,0
11124,282,50,11600,232,0
11133,552,113,49607,439,0
11134,865,167,116566,698,0
11136,1558,313,389685,1245,0
11142,385,71,22294,314,0
11145,534,102,44064,432,0
11153,365,74,21534,291,0
11160,1342,282,298920,1060,0
11178,49,8,328,41,0
11183,539,101,44238,438,0
11190,443,85,30430,358,0
11199,1552,299,374647,1253,0
11204,1558,313,389685,1245,0
11209,976,180,143280,796,0
11224,106,19,1653,87,0
11226,1331,255,274380,1076,0
11246,865,167,116566,698,0
11265,1876,359,544603,1517,0
11315,771,137,86858,634,0
11334,61,11,550,50,0
11344,819,152,101384,667,0
11348,572,130,57460,442,0
11384,714,137,79049,577,0
11388,700,128,73216,572,0
11391,548,102,45492,446,0
11423,821,171,111150,650,0
11425,771,137,86858,634,0
11432,401,77,24948,324,0
11444,976,180,143280,796,0
11454,315,56,14504,259,0
11457,1411,281,317530,1130,0
11460,1181,246,230010,935,0
11474,144,29,3335,115,0
11531,495,87,35496,408,0
11536,1583,310,394630,1273,0
11538,273,58,12470,215,0
11540,714,137,79049,577,0
11541,443,85,30430,358,0
11546,497,97,38800,400,0
11547,950,193,146101,757,0
11551,641,131,66810,510,0
11562,2102,402,683400,1700,0
11571,971,184,144808,787,0
11574,821,171,111150,650,0
11588,1262,259,259777,1003,0
11623,1541,306,377910,1235,0
11633,1296,252,263088,1044,0
11658,572,130,57460,442,0
11662,976,180,143280,796,0
11694,1181,246,230010,935,0
11698,1204,251,239203,953,0
11699,1934,345,548205,1589,0
11705,70,15,825,55,0
11729,950,193,146101,757,0
11731,950,193,146101,757,0
11733,568,114,51756,454,0
11735,1262,259,259777,1003,0
11739,535,94,41454,441,0
11740,836,151,103435,685,0
11751,821,171,111150,650,0
11758,1331,255,274380,1076,0
11775,620,121,60379,499,0
11796,1411,281,317530,1130,0
11800,1829,353,521028,1476,0
11809,535,94,41454,441,0
11816,107,18,1602,89,0
11819,1558,313,389685,1245,0
11826,337,74,19462,263,0
11860,534,102,44064,432,0
11862,1342,282,298920,1060,0
11865,1829,353,521028,1476,0
11869,58,12,552,46,0
11877,194,39,6045,155,0
11883,160,32,4096,128,0
11902,865,167,116566,698,0
11907,1657,315,422730,1342,0
11910,121,27,2538,94,0
11912,950,193,146101,757,0
11922,122,22,2200,100,0
11957,1331,255,274380,1076,0
11963,865,167,116566,698,0
11965,323,55,14740,268,0
11983,1342,282,298920,1060,0
11999,595,120,57000,475,0
12001,379,65,20410,314,0
12002,793,158,100330,635,0
12009,193,39,6006,154,0
12012,1876,359,544603,1517,0
12013,1541,306,377910,1235,0
12030,1204,251,239203,953,0
12045,282,50,11600,232,0
12049,1876,359,544603,1517,0
12054,198,43,6665,155,0
12057,950,193,146101,757,0
12059,40,9,279,31,0
12073,595,120,57000,475,0
12078,1657,315,422730,1342,0
12085,61,11,550,50,0
12094,1262,259,259777,1003,0
12097,548,102,45492,446,0
12098,950,193,146101,757,0
12115,595,121,57354,474,0
12118,379,65,20410,314,0
12125,164,34,4420,130,0
12126,495,87,35496,408,0
12131,305,70,16450,235,0
12138,1583,310,394630,1273,0
12163,767,144,89712,623,0
12174,1541,306,377910,1235,0
12185,379,65,20410,314,0
12195,1025,201,165624,824,0
12217,1583,310,394630,1273,0
12218,1204,251,239203,953,0
12226,122,25,2425,97,0
12242,641,131,66810,510,0
12251,1411,281,317530,1130,0
12256,535,94,41454,441,0
12260,1025,201,165624,824,0
12288,1657,315,422730,1342,0
12295,1296,252,263088,1044,0
12304,700,128,73216,572,0
12327,1411,281,317530,1130,0
12328,2102,402,683400,1700,0
12338,572,130,57460,442,0
12340,793,158,100330,635,0
12355,137,25,2800,112,0
12361,1876,359,544603,1517,0
12366,58,15,645,43,0
12367,1204,251,239203,953,0
12368,61,14,658,47,0
12375,1411,281,317530,1130,0
12381,52,10,420,42,0
12386,105,16,1424,89,0
12387,836,151,103435,685,0
12388,714,137,79049,577,0
12420,85,18,1206,67,0
12421,539,101,44238,438,0
12437,1411,281,317530,1130,0
12440,35,5,150,30,0
12447,1342,282,298920,1060,0
12460,18,3,45,15,0
12462,700,128,73216,572,0
12473,660,133,69928,527,0
12488,35,9,234,26,0
12509,1296,252,263088,1044,0
12511,836,151,103435,685,0
12514,495,87,35496,408,0
12533,1342,282,298920,1060,0
12537,971,184,144808,787,0
12549,793,158,100330,635,0
12567,660,133,69928,527,0
12584,641,131,66810,510,0
12598,771,137,86858,634,0
12600,571,114,52098,457,0
12634,548,102,45492,446,0
12652,1876,359,544603,1517,0
12657,146,34,3808,112,0
12663,1262,259,259777,1003,0
12678,778,163,100245,615,0
12681,1934,345,548205,1589,0
12695,77,18,1062,59,0
12722,52,10,420,42,0
12723,2102,402,683400,1700,0
12727,410,76,25384,334,0
12735,568,114,51756,454,0
12737,551,102,45798,449,0
12758,932,168,128352,764,0
12759,1934,345,548205,1589,0
12788,1342,282,298920,1060,0
12790,1829,353,521028,1476,0
12791,767,144,89712,623,0
12805,77,19,1102,58,0
12807,971,184,144808,787,0
12821,193,39,6006,154,0
12828,1657,315,422730,1342,0
12837,264,56,11648,208,0
12843,2102,402,683400,1700,0
12847,1342,282,298920,1060,0
12851,534,102,44064,432,0
12855,495,87,35496,408,0
12856,2102,402,683400,1700,0
12868,135,30,3150,105,0
12877,122,22,2200,100,0
12903,55,11,484,44,0
12905,1934,345,548205,1589,0
12916,1934,345,548205,1589,0
12945,1280,232,243136,1048,0
12957,1078,198,174240,880,0
12965,535,94,41454,441,0
12979,771,137,86858,634,0
12985,105,22,1826,83,0
12992,1078,198,174240,880,0
13001,186,35,5285,151,0
13003,1411,281,317530,1130,0
13005,1078,198,174240,880,0
13006,1829,353,521028,1476,0
13010,1262,259,259777,1003,0
13014,971,184,144808,787,0
13016,11,4,28,7,0
13021,495,87,35496,408,0
13037,1204,251,239203,953,0
13038,2102,402,683400,1700,0
13094,365,74,21534,291,0
13109,1829,353,521028,1476,0
13120,23,6,102,17,0
13121,976,180,143280,796,0
13146,365,74,21534,291,0
13158,714,137,79049,577,0
13159,1296,252,263088,1044,0
13168,1541,306,377910,1235,0
13179,119,25,2350,94,0
13182,2102,402,683400,1700,0
13189,1342,282,298920,1060,0
13209,1078,198,174240,880,0
13216,793,158,100330,635,0
13236,1657,315,422730,1342,0
13247,535,94,41454,441,0
13251,227,44,8052,183,0
13278,110,18,1656,92,0
13294,1296,252,263088,1044,0
13302,1558,313,389685,1245,0
13303,1181,246,230010,935,0
13340,1583,310,394630,1273,0
13343,568,114,51756,454,0
13362,1204,251,239203,953,0
13391,145,23,2806,122,0
13394,932,168,128352,764,0
13396,1262,259,259777,1003,0
13419,55,11,484,44,0
13420,1181,246,230010,935,0
13425,1280,232,243136,1048,0
13430,1558,313,389685,1245,0
13437,88,17,1207,71,0
13442,1552,299,374647,1253,0
13459,539,101,44238,438,0
13462,568,114,51756,454,0
13471,767,144,89712,623,0
13486,360,66,19404,294,0
13492,865,167,116566,698,0
13499,1657,315,422730,1342,0
13542,836,151,103435,685,0
13544,89,15,1110,74,0
13605,401,77,24948,324,0
13616,37,11,286,26,0
13634,401,77,24948,324,0
13642,77,17,1020,60,0
13649,1331,255,274380,1076,0
13653,1657,315,422730,1342,0
13667,552,113,49607,439,0
13673,1552,299,374647,1253,0
13683,700,128,73216,572,0
13729,836,151,103435,685,0
13737,1829,353,521028,1476,0
13747,1181,246,230010,935,0
13752,1583,310,394630,1273,0
13787,641,131,66810,510,0
13800,194,39,6045,155,0
13815,198,43,6665,155,0
13818,620,121,60379,499,0
13826,641,131,66810,510,0
13842,976,180,143280,796,0
13848,819,152,101384,667,0
13851,2102,402,683400,1700,0
13873,778,163,100245,615,0
13874,156,34,4148,122,0
13880,660,133,69928,527,0
13884,65,13,676,52,0
13886,185,36,5364,149,0
13888,1583,310,394630,1273,0
13889,324,67,17219,257,0
13899,552,113,49607,439,0
13907,821,143,96954,678,0
13915,40,9,279,31,0
13917,131,25,2650,106,0
13926,767,144,89712,623,0
13927,61,9,468,52,0
13929,1280,232,243136,1048,0
13953,1558,313,389685,1245,0
13959,568,114,51756,454,0
13975,1280,232,243136,1048,0
13979,21,6,90,15,0
13982,62,16,736,46,0
13993,1558,313,389685,1245,0
14004,21,3,54,18,0
14009,1078,198,174240,880,0
14042,1876,359,544603,1517,0
14073,1331,255,274380,1076,0
14076,976,180,143280,796,0
14080,9,1,8,8,0
14081,1934,345,548205,1589,0
14099,1331,255,274380,1076,0
14113,194,39,6045,155,0
14115,552,113,49607,439,0
14123,1342,282,298920,1060,0
14140,2102,402,683400,1700,0
14145,1280,232,243136,1048,0
14151,641,131,66810,510,0
14194,1934,345,548205,1589,0
14208,950,193,146101,757,0
14222,620,121,60379,499,0
14255,107,19,1672,88,0
14258,1204,251,239203,953,0
14270,1934,345,548205,1589,0
14277,1280,232,243136,1048,0
14307,21,6,90,15,0
14322,1331,255,274380,1076,0
14333,1331,255,274380,1076,0
14354,401,77,24948,324,0
14372,34,7,189,27,0
14374,305,70,16450,235,0
14394,641,131,66810,510,0
14396,1876,359,544603,1517,0
14398,1583,310,394630,1273,0
14412,61,13,624,48,0
14413,1342,282,298920,1060,0
14418,1025,201,165624,824,0
14423,1078,198,174240,880,0
14425,75,19,1064,56,0
14430,1204,251,239203,953,0
14436,50,8,336,42,0
14443,1262,259,259777,1003,0
14452,641,131,66810,510,0
14464,1204,251,239203,953,0
14493,47,8,312,39,0
14499,1657,315,422730,1342,0
14501,641,131,66810,510,0
14503,976,180,143280,796,0
14557,971,184,144808,787,0
14564,1296,252,263088,1044,0
14566,1331,255,274380,1076,0
14572,1078,198,174240,880,0
14577,1025,201,165624,824,0
14587,252,45,9315,207,0
14596,135,30,3150,105,0
14607,1552,299,374647,1253,0
14625,571,114,52098,457,0
14627,1657,315,422730,1342,0
14634,1331,255,274380,1076,0
14649,1296,252,263088,1044,0
14653,1934,345,548205,1589,0
14679,821,143,96954,678,0
14681,1876,359,544603,1517,0
14687,660,133,69928,527,0
14696,1541,306,377910,1235,0
14700,620,121,60379,499,0
14704,1829,353,521028,1476,0
14719,767,144,89712,623,0
14726,1025,201,165624,824,0
14731,19,3,48,16,0
14767,107,18,1602,89,0
14782,282,50,11600,232,0
14790,1411,281,317530,1130,0
14804,767,144,89712,623,0
14827,145,23,2806,122,0
14832,1934,345,548205,1589,0
14842,1876,359,544603,1517,0
14850,1411,281,317530,1130,0
14854,595,121,57354,474,0
14863,18,5,65,13,0
14871,1331,255,274380,1076,0
14872,72,17,935,55,0
14883,236,50,9300,186,0
14892,1829,353,521028,1476,0
14899,539,101,44238,438,0
14918,1078,198,174240,880,0
14928,1657,315,422730,1342,0
14936,346,76,20520,270,0
14980,1657,315,422730,1342,0
14990,497,97,38800,400,0
14992,1204,251,239203,953,0
15008,385,71,22294,314,0
15017,821,171,111150,650,0
15030,821,143,96954,678,0
15056,366,70,20720,296,0
15064,821,171,111150,650,0
15066,146,34,3808,112,0
15074,1558,313,389685,1245,0
15101,534,102,44064,432,0
15107,516,103,42539,413,0
15109,1934,345,548205,1589,0
15123,819,152,101384,667,0
15132,160,29,3799,131,0
15145,160,32,4096,128,0
15157,767,144,89712,623,0
15164,323,55,14740,268,0
15167,68,12,672,56,0
15170,2102,402,683400,1700,0
15212,2102,402,683400,1700,0
15232,121,27,2538,94,0
15251,1411,281,317530,1130,0
15255,778,163,100245,615,0
15273,641,131,66810,510,0
15294,535,94,41454,441,0
15302,714,137,79049,577,0
15315,186,35,5285,151,0
15318,443,85,30430,358,0
15329,1829,353,521028,1476,0
15339,324,67,17219,257,0
15343,548,102,45492,446,0
15354,971,184,144808,787,0
15375,534,102,44064,432,0
15396,122,20,2040,102,0
15411,405,82,26486,323,0
15428,1541,306,377910,1235,0
15473,865,167,116566,698,0
15514,395,72,23256,323,0
15515,1876,359,544603,1517,0
15540,1181,246,230010,935,0
15565,971,184,144808,787,0
15572,641,131,66810,510,0
15577,865,167,116566,698,0
15589,305,70,16450,235,0
15624,2102,402,683400,1700,0
15632,836,151,103435,685,0
15634,1296,252,263088,1044,0
15640,443,85,30430,358,0
15642,415,75,25500,340,0
15650,1262,259,259777,1003,0
15658,193,39,6006,154,0
15667,836,151,103435,685,0
15696,31,9,198,22,0
15703,2102,402,683400,1700,0
15705,8,1,7,7,0
15709,1262,259,259777,1003,0
15728,620,121,60379,499,0
15729,194,39,6045,155,0
15743,1204,251,239203,953,0
15761,1342,282,298920,1060,0
15771,932,168,128352,764,0
15821,200,40,6400,160,0
15853,1552,299,374647,1253,0
15858,641,131,66810,510,0
15866,1342,282,298920,1060,0
15874,155,27,3456,128,0
15889,315,56,14504,259,0
15897,315,56,14504,259,0
15903,714,137,79049,577,0
15917,539,101,44238,438,0
15921,572,130,57460,442,0
15927,2102,402,683400,1700,0
15937,148,24,2976,124,0
15947,1583,310,394630,1273,0
15970,1411,281,317530,1130,0
15972,1876,359,544603,1517,0
15974,1552,299,374647,1253,0
15976,1204,251,239203,953,0
16017,1558,313,389685,1245,0
16028,2102,402,683400,1700,0
16050,595,120,57000,475,0
16053,321,54,14418,267,0
16058,1342,282,298920,1060,0
16080,160,29,3799,131,0
16085,1025,201,165624,824,0
16088,1657,315,422730,1342,0
16110,1342,282,298920,1060,0
16114,33,5,140,28,0
16122,49,8,328,41,0
16123,1296,252,263088,1044,0
16130,68,15,795,53,0
16135,1558,313,389685,1245,0
16146,1296,252,263088,1044,0
16149,865,167,116566,698,0
16150,106,19,1653,87,0
16168,405,82,26486,323,0
16170,337,74,19462,263,0
16196,145,23,2806,122,0
16212,1280,232,243136,1048,0
16214,1552,299,374647,1253,0
16227,146,34,3808,112,0
16256,1552,299,374647,1253,0
16260,362,69,20217,293,0
16279,534,102,44064,432,0
16286,395,72,23256,323,0
16302,821,171,111150,650,0
16326,568,114,51756,454,0
16332,1876,359,544603,1517,0
16338,135,30,3150,105,0
16360,273,58,12470,215,0
16367,360,66,19404,294,0
16376,1181,246,230010,935,0
16383,365,74,21534,291,0
16422,217,44,7612,173,0
16426,2102,402,683400,1700,0
16434,97,22,1650,75,0
16441,1296,252,263088,1044,0
16443,793,158,100330,635,0
16445,1025,201,165624,824,0
16496,971,184,144808,787,0
16519,360,66,19404,294,0
16546,1181,246,230010,935,0
16547,819,152,101384,667,0
16577,572,130,57460,442,0
16579,401,77,24948,324,0
16581,1583,310,394630,1273,0
16601,119,22,2134,97,0
16614,362,69,20217,293,0
16653,1657,315,422730,1342,0
16658,19,3,48,16,0
16660,821,143,96954,678,0
16664,1541,306,377910,1235,0
16670,1558,313,389685,1245,0
16685,1541,306,377910,1235,0
16698,641,131,66810,510,0
16729,1552,299,374647,1253,0
16738,571,114,52098,457,0
16740,865,167,116566,698,0
16755,274,57,12369,217,0
16765,700,128,73216,572,0
16783,85,18,1206,67,0
16789,124,28,2688,96,0
16791,932,168,128352,764,0
16794,793,158,100330,635,0
16797,373,74,22126,299,0
16820,49,8,328,41,0
16821,1262,259,259777,1003,0
16831,1829,353,521028,1476,0
16836,64,16,768,48,0
16846,17,6,66,11,0
16854,106,19,1653,87,0
16859,1552,299,374647,1253,0
16871,1657,315,422730,1342,0
16875,1583,310,394630,1273,0
16879,194,39,6045,155,0
16883,714,137,79049,577,0
16898,1331,255,274380,1076,0
16921,1541,306,377910,1235,0
16924,821,171,111150,650,0
16930,194,39,6045,155,0
16934,950,193,146101,757,0
16938,110,27,2241,83,0
16941,97,22,1650,75,0
16943,771,137,86858,634,0
16955,620,121,60379,499,0
16985,1657,315,422730,1342,0
16994,1829,353,521028,1476,0
16996,1078,198,174240,880,0
17012,836,151,103435,685,0
17016,112,18,1692,94,0
17028,1078,198,174240,880,0
17030,1181,246,230010,935,0
17053,323,55,14740,268,0
17054,252,45,9315,207,0
17061,85,18,1206,67,0
17065,620,121,60379,499,0
17069,1204,251,239203,953,0
17076,463,83,31540,380,0
17114,1411,281,317530,1130,0
17124,793,158,100330,635,0
17127,551,102,45798,449,0
17151,1296,252,263088,1044,0
17162,415,75,25500,340,0
17163,1934,345,548205,1589,0
17175,217,44,7612,173,0
17179,1262,259,259777,1003,0
17197,1829,353,521028,1476,0
17208,164,34,4420,130,0
17213,1331,255,274380,1076,0
17216,548,102,45492,446,0
17248,105,22,1826,83,0
17252,1829,353,521028,1476,0
17257,1934,345,548205,1589,0
17259,273,58,12470,215,0
17265,1876,359,544603,1517,0
17268,1280,232,243136,1048,0
17275,778,163,100245,615,0
17276,1025,201,165624,824,0
17293,572,130,57460,442,0
17299,971,184,144808,787,0
17301,2102,402,683400,1700,0
17302,641,131,66810,510,0
17312,1411,281,317530,1130,0
17323,950,193,146101,757,0
17329,836,151,103435,685,0
17336,324,67,17219,257,0
17348,1296,252,263088,1044,0
17361,821,171,111150,650,0
17379,273,58,12470,215,0
17406,1078,198,174240,880,0
17410,620,121,60379,499,0
17434,137,25,2800,112,0
17443,1204,251,239203,953,0
17457,976,180,143280,796,0
17473,572,130,57460,442,0
17489,932,168,128352,764,0
17491,380,76,23104,304,0
17515,595,121,57354,474,0
17516,1296,252,263088,1044,0
17526,1181,246,230010,935,0
17530,700,128,73216,572,0
17531,160,29,3799,131,0
17532,595,121,57354,474,0
17541,535,94,41454,441,0
17546,49,9,360,40,0
17568,821,171,111150,650,0
17583,2102,402,683400,1700,0
17584,405,82,26486,323,0
17587,282,50,11600,232,0
17591,463,83,31540,380,0
17604,42,5,185,37,0
17615,1296,252,263088,1044,0
17645,362,69,20217,293,0
17652,971,184,144808,787,0
17654,463,83,31540,380,0
17666,836,151,103435,685,0
17678,305,70,16450,235,0
17711,18,5,65,13,0
17715,552,113,49607,439,0
17740,660,133,69928,527,0
17774,337,74,19462,263,0
17785,535,94,41454,441,0
17790,2102,402,683400,1700,0
17814,185,36,5364,149,0
17852,1204,251,239203,953,0
17862,714,137,79049,577,0
17883,1829,353,521028,1476,0
17885,105,15,1350,90,0
17903,1296,252,263088,1044,0
17904,819,152,101384,667,0
17927,198,43,6665,155,0
17930,865,167,116566,698,0
17937,2102,402,683400,1700,0
17962,1331,255,274380,1076,0
17966,714,137,79049,577,0
17985,1025,201,165624,824,0
17989,572,130,57460,442,0
17998,70,15,825,55,0
18002,568,114,51756,454,0
18021,273,58,12470,215,0
18052,971,184,144808,787,0
18079,1296,252,263088,1044,0
18080,61,8,424,53,0
18084,1342,282,298920,1060,0
18091,2102,402,683400,1700,0
18094,360,66,19404,294,0
18095,252,45,9315,207,0
18100,305,70,16450,235,0
18108,865,167,116566,698,0
18118,700,128,73216,572,0
18139,548,102,45492,446,0
18147,1541,306,377910,1235,0
18148,1078,198,174240,880,0
18158,385,71,22294,314,0
18160,365,74,21534,291,0
18163,660,133,69928,527,0
18187,1342,282,298920,1060,0
18196,337,74,19462,263,0
18226,360,66,19404,294,0
18229,819,152,101384,667,0
18236,1411,281,317530,1130,0
18290,1657,315,422730,1342,0
18308,1342,282,298920,1060,0
18385,950,193,146101,757,0
18389,1657,315,422730,1342,0
18423,836,151,103435,685,0
18427,443,85,30430,358,0
18431,1657,315,422730,1342,0
18441,821,143,96954,678,0
18444,1342,282,298920,1060,0
18445,535,94,41454,441,0
18452,305,70,16450,235,0
18458,1541,306,377910,1235,0
18481,950,193,146101,757,0
18499,1262,259,259777,1003,0
18504,97,22,1650,75,0
18508,1934,345,548205,1589,0
18520,836,151,103435,685,0
18522,89,15,1110,74,0
18537,620,121,60379,499,0
18541,516,103,42539,413,0
18563,1025,201,165624,824,0
18566,539,101,44238,438,0
18567,1876,359,544603,1517,0
18584,1331,255,274380,1076,0
18613,1411,281,317530,1130,0
18618,495,87,35496,408,0
18619,821,171,111150,650,0
18643,88,17,1207,71,0
18695,1876,359,544603,1517,0
18698,1541,306,377910,1235,0
18699,1078,198,174240,880,0
18702,2102,402,683400,1700,0
18710,443,85,30430,358,0
18716,198,43,6665,155,0
18717,337,74,19462,263,0
18720,415,75,25500,340,0
18721,1204,251,239203,953,0
18726,819,152,101384,667,0
18743,1558,313,389685,1245,0
18765,1657,315,422730,1342,0
18772,1876,359,544603,1517,0
18773,1657,315,422730,1342,0
18792,1558,313,389685,1245,0
18808,120,24,2304,96,0
18819,273,58,12470,215,0
18823,14,4,40,10,0
18828,20,3,51,17,0
18833,1657,315,422730,1342,0
18847,767,144,89712,623,0
18860,52,10,420,42,0
18861,950,193,146101,757,0
18863,1296,252,263088,1044,0
18911,819,152,101384,667,0
18915,539,101,44238,438,0
18935,106,19,1653,87,0
18937,620,121,60379,499,0
18950,107,19,1672,88,0
18970,324,67,17219,257,0
19006,595,121,57354,474,0
19008,35,5,150,30,0
19013,102,20,1640,82,0
19019,1204,251,239203,953,0
19024,1583,310,394630,1273,0
19037,1342,282,298920,1060,0
19048,932,168,128352,764,0
19055,1296,252,263088,1044,0
19056,1583,310,394630,1273,0
19066,821,171,111150,650,0
19104,1934,345,548205,1589,0
19107,1558,313,389685,1245,0
19121,273,58,12470,215,0
19122,463,83,31540,380,0
19127,1262,259,259777,1003,0
19174,7,2,10,5,0
19186,134,30,3120,104,0
19189,497,97,38800,400,0
19209,2102,402,683400,1700,0
19228,971,184,144808,787,0
19232,568,114,51756,454,0
19236,821,171,111150,650,0
19239,107,19,1672,88,0
19241,1829,353,521028,1476,0
19257,660,133,69928,527,0
19267,7,1,6,6,0
19270,571,114,52098,457,0
19296,641,131,66810,510,0
19303,641,131,66810,510,0
19304,1876,359,544603,1517,0
19315,641,131,66810,510,0
19317,2102,402,683400,1700,0
19326,641,131,66810,510,0
19340,1829,353,521028,1476,0
19367,1876,359,544603,1517,0
19368,324,67,17219,257,0
19376,595,120,57000,475,0
19384,366,70,20720,296,0
19387,551,102,45798,449,0
19390,1331,255,274380,1076,0
19396,20,3,51,17,0
19405,700,128,73216,572,0
19410,373,74,22126,299,0
19419,186,35,5285,151,0
19491,207,41,6806,166,0
19496,771,137,86858,634,0
19504,976,180,143280,796,0
19506,107,18,1602,89,0
19509,1657,315,422730,1342,0
19524,155,35,4200,120,0
19529,1583,310,394630,1273,0
19537,971,184,144808,787,0
19549,122,22,2200,100,0
19573,32,7,175,25,0
19575,104,16,1408,88,0
19590,950,193,146101,757,0
19601,164,34,4420,130,0
19605,1280,232,243136,1048,0
19606,337,74,19462,263,0
19616,54,14,560,40,0
19619,516,103,42539,413,0
19628,595,120,57000,475,0
19633,1541,306,377910,1235,0
19658,819,152,101384,667,0
19664,317,63,16002,254,0
19667,194,39,6045,155,0
19672,932,168,128352,764,0
19685,836,151,103435,685,0
19692,821,171,111150,650,0
19705,552,113,49607,439,0
19709,1829,353,521028,1476,0
19720,146,34,3808,112,0
19738,568,114,51756,454,0
19787,865,167,116566,698,0
19794,552,113,49607,439,0
19801,1657,315,422730,1342,0
19820,819,152,101384,667,0
19821,659,132,69928,527,0
19822,1181,246,230010,935,0
19824,539,101,44238,438,0
19825,410,76,25384,334,0
19841,1552,299,374647,1253,0
19842,595,121,57354,474,0
19844,72,13,767,59,0
19863,321,54,14418,267,0
19864,950,193,146101,757,0
19883,1829,353,521028,1476,0
19891,1078,198,174240,880,0
19896,1829,353,521028,1476,0
19901,1181,246,230010,935,0
19921,1342,282,298920,1060,0
19923,539,101,44238,438,0
19928,365,74,21534,291,0
19930,37,10,270,27,0
19934,119,22,2134,97,0
19941,771,137,86858,634,0
19956,1829,353,521028,1476,0
19965,324,67,17219,257,0
19970,1181,246,230010,935,0
19988,700,128,73216,572,0
20010,714,137,79049,577,0
20017,641,131,66810,510,0
20019,660,133,69928,527,0
20036,976,180,143280,796,0
20037,2102,402,683400,1700,0
20038,1876,359,544603,1517,0
20039,194,39,6045,155,0
20067,112,18,1692,94,0
20068,976,180,143280,796,0
20070,146,34,3808,112,0
20072,819,152,101384,667,0
20074,1411,281,317530,1130,0
20090,1296,252,263088,1044,0
20099,101,20,1620,81,0
20102,932,168,128352,764,0
20115,571,114,52098,457,0
20121,1342,282,298920,1060,0
20126,572,130,57460,442,0
20131,49,9,360,40,0
20132,337,74,19462,263,0
20141,1296,252,263088,1044,0
20147,1829,353,521028,1476,0
20152,836,151,103435,685,0
20156,124,28,2688,96,0
20170,346,76,20520,270,0
20188,2102,402,683400,1700,0
20195,568,114,51756,454,0
20201,50,8,336,42,0
20207,137,25,2800,112,0
20208,155,27,3456,128,0
20216,836,151,103435,685,0
20219,1552,299,374647,1253,0
20237,1078,198,174240,880,0
20253,1829,353,521028,1476,0
20255,323,55,14740,268,0
20280,714,137,79049,577,0
20281,1025,201,165624,824,0
20288,145,23,2806,122,0
20291,1262,259,259777,1003,0
20304,535,94,41454,441,0
20325,1552,299,374647,1253,0
20335,217,44,7612,173,0
20345,1934,345,548205,1589,0
20361,971,184,144808,787,0
20364,97,22,1650,75,0
20381,14,4,40,10,0
20411,1411,281,317530,1130,0
20413,1876,359,544603,1517,0
20433,1262,259,259777,1003,0
20450,379,65,20410,314,0
20495,1657,315,422730,1342,0
20531,865,167,116566,698,0
20554,2102,402,683400,1700,0
20559,1934,345,548205,1589,0
20570,1331,255,274380,1076,0
20575,1204,251,239203,953,0
20578,463,83,31540,380,0
20580,1541,306,377910,1235,0
20588,836,151,103435,685,0
20592,1296,252,263088,1044,0
20607,821,171,111150,650,0
20629,75,19,1064,56,0
20639,1025,201,165624,824,0
20674,551,102,45798,449,0
20686,571,114,52098,457,0
20702,1078,198,174240,880,0
20721,185,36,5364,149,0
20728,1541,306,377910,1235,0
20732,793,158,100330,635,0
20735,1411,281,317530,1130,0
20741,495,87,35496,408,0
20750,385,71,22294,314,0
20756,495,87,35496,408,0
20757,410,76,25384,334,0
20762,971,184,144808,787,0
20786,1331,255,274380,1076,0
20795,1829,353,521028,1476,0
20815,113,24,2136,89,0
20839,1296,252,263088,1044,0
20847,1583,310,394630,1273,0
20851,1541,306,377910,1235,0
20856,572,130,57460,442,0
20868,1876,359,544603,1517,0
20876,155,34,4114,121,0
20880,1876,359,544603,1517,0
20883,1342,282,298920,1060,0
20888,2102,402,683400,1700,0
20910,1541,306,377910,1235,0
20921,771,137,86858,634,0
20924,2102,402,683400,1700,0
20931,2102,402,683400,1700,0
20933,366,70,20720,296,0
20941,1541,306,377910,1235,0
20949,122,20,2040,102,0
20950,1541,306,377910,1235,0
20972,44,10,340,34,0
20975,700,128,73216,572,0
20977,1829,353,521028,1476,0
20997,2102,402,683400,1700,0
21010,194,39,6045,155,0
21017,1204,251,239203,953,0
21022,836,151,103435,685,0
21026,252,45,9315,207,0
21028,2102,402,683400,1700,0
21031,1025,201,165624,824,0
21032,127,29,2842,98,0
21039,1552,299,374647,1253,0
21047,1296,252,263088,1044,0
21057,405,82,26486,323,0
21058,337,74,19462,263,0
21061,950,193,146101,757,0
21086,660,133,69928,527,0
21110,198,43,6665,155,0
21120,1552,299,374647,1253,0
21121,1296,252,263088,1044,0
21135,1262,259,259777,1003,0
21165,1181,246,230010,935,0
21197,1280,232,243136,1048,0
21198,1657,315,422730,1342,0
21205,819,152,101384,667,0
21212,105,16,1424,89,0
21218,443,85,30430,358,0
21220,535,94,41454,441,0
21227,1204,251,239203,953,0
21244,107,19,1672,88,0
21250,2102,402,683400,1700,0
21263,1181,246,230010,935,0
21268,534,102,44064,432,0
21323,2102,402,683400,1700,0
21325,1552,299,374647,1253,0
21326,950,193,146101,757,0
21343,1558,313,389685,1245,0
21345,68,15,795,53,0
21350,264,56,11648,208,0
21355,1552,299,374647,1253,0
21370,1204,251,239203,953,0
21393,1411,281,317530,1130,0
21407,64,15,735,49,0
21420,1204,251,239203,953,0
21453,194,39,6045,155,0
21459,1876,359,544603,1517,0
21466,1583,310,394630,1273,0
21488,1552,299,374647,1253,0
21490,821,171,111150,650,0
21510,568,114,51756,454,0
21512,1552,299,374647,1253,0
21513,552,113,49607,439,0
21527,145,23,2806,122,0
21565,819,152,101384,667,0
21570,186,35,5285,151,0
21574,595,121,57354,474,0
21599,1025,201,165624,824,0
21605,380,76,23104,304,0
21612,950,193,146101,757,0
21623,932,168,128352,764,0
21630,1829,353,521028,1476,0
21647,1204,251,239203,953,0
21664,1181,246,230010,935,0
21666,373,74,22126,299,0
21674,778,163,100245,615,0
21690,976,180,143280,796,0
21698,346,76,20520,270,0
21701,2102,402,683400,1700,0
21702,1552,299,374647,1253,0
21710,551,102,45798,449,0
21748,273,58,12470,215,0
21755,1829,353,521028,1476,0
21763,23,6,102,17,0
21768,971,184,144808,787,0
21781,2102,402,683400,1700,0
21786,321,54,14418,267,0
21793,1541,306,377910,1235,0
21802,516,103,42539,413,0
21833,119,22,2134,97,0
21855,366,70,20720,296,0
21857,2102,402,683400,1700,0
21875,865,167,116566,698,0
21882,32,7,175,25,0
21891,700,128,73216,572,0
21892,119,22,2134,97,0
21905,1876,359,544603,1517,0
21915,2102,402,683400,1700,0
21978,595,121,57354,474,0
21980,415,75,25500,340,0
21981,1583,310,394630,1273,0
21991,75,19,1064,56,0
21997,778,163,100245,615,0
22000,1657,315,422730,1342,0
22010,976,180,143280,796,0
22011,385,71,22294,314,0
22015,976,180,143280,796,0
22025,1558,313,389685,1245,0
22026,836,151,103435,685,0
22027,365,74,21534,291,0
22036,1876,359,544603,1517,0
22038,463,83,31540,380,0
22047,52,10,420,42,0
22051,595,121,57354,474,0
22057,495,87,35496,408,0
22061,273,58,12470,215,0
22077,2102,402,683400,1700,0
22079,346,76,20520,270,0
22097,548,102,45492,446,0
22102,2102,402,683400,1700,0
22128,55,10,450,45,0
22129,1934,345,548205,1589,0
22135,405,82,26486,323,0
22169,346,76,20520,270,0
22173,1280,232,243136,1048,0
22183,273,58,12470,215,0
22189,819,152,101384,667,0
22208,1583,310,394630,1273,0
22226,217,44,7612,173,0
22240,1342,282,298920,1060,0
22247,410,76,25384,334,0
22258,1411,281,317530,1130,0
22259,1411,281,317530,1130,0
22268,104,16,1408,88,0
22278,1331,255,274380,1076,0
22294,778,163,100245,615,0
22296,1280,232,243136,1048,0
22297,571,114,52098,457,0
22298,1552,299,374647,1253,0
22313,495,87,35496,408,0
22339,1876,359,544603,1517,0
22341,1934,345,548205,1589,0
22349,443,85,30430,358,0
22378,415,75,25500,340,0
22383,1876,359,544603,1517,0
22386,362,69,20217,293,0
22429,793,158,100330,635,0
22444,274,57,12369,217,0
22468,1078,198,174240,880,0
22475,819,152,101384,667,0
22478,19,3,48,16,0
22487,193,39,6006,154,0
22488,264,56,11648,208,0
22515,395,72,23256,323,0
22529,44,10,340,34,0
22553,535,94,41454,441,0
22593,836,151,103435,685,0
22611,1657,315,422730,1342,0
22623,64,8,448,56,0
22632,1331,255,274380,1076,0
22635,534,102,44064,432,0
22646,771,137,86858,634,0
22655,1934,345,548205,1589,0
22666,21,4,68,17,0
22669,410,76,25384,334,0
22674,1280,232,243136,1048,0
22692,1181,246,230010,935,0
22700,26,6,120,20,0
22711,1342,282,298920,1060,0
22731,23,6,102,17,0
22746,620,121,60379,499,0
22751,1934,345,548205,1589,0
22761,1829,353,521028,1476,0
22768,1934,345,548205,1589,0
22787,317,63,16002,254,0
22811,1657,315,422730,1342,0
22812,207,41,6806,166,0
22819,160,32,4096,128,0
22821,18,3,45,15,0
22832,410,76,25384,334,0
22844,77,17,1020,60,0
22845,236,50,9300,186,0
22852,865,167,116566,698,0
22857,122,25,2425,97,0
22867,1296,252,263088,1044,0
22872,1876,359,544603,1517,0
22880,155,34,4114,121,0
22894,1262,259,259777,1003,0
22934,1552,299,374647,1253,0
22943,821,143,96954,678,0
22945,1541,306,377910,1235,0
22956,865,167,116566,698,0
22959,155,35,4200,120,0
22960,1331,255,274380,1076,0
22971,112,18,1692,94,0
22986,1829,353,521028,1476,0
23014,950,193,146101,757,0
23020,41,8,264,33,0
23032,771,137,86858,634,0
23033,2102,402,683400,1700,0
23036,1411,281,317530,1130,0
23050,865,167,116566,698,0
23054,101,20,1620,81,0
23056,1558,313,389685,1245,0
23070,641,131,66810,510,0
23083,976,180,143280,796,0
23092,793,158,100330,635,0
23128,365,74,21534,291,0
23135,217,44,7612,173,0
23146,1829,353,521028,1476,0
23153,1583,310,394630,1273,0
23193,58,12,552,46,0
23211,2102,402,683400,1700,0
23221,1876,359,544603,1517,0
23233,1876,359,544603,1517,0
23239,1583,310,394630,1273,0
23258,778,163,100245,615,0
23268,337,74,19462,263,0
23299,976,180,143280,796,0
23300,1342,282,298920,1060,0
23303,174,36,4968,138,0
23310,932,168,128352,764,0
23322,77,12,780,65,0
23343,534,102,44064,432,0
23358,700,128,73216,572,0
23359,1541,306,377910,1235,0
23378,2102,402,683400,1700,0
23418,122,25,2425,97,0
23420,1829,353,521028,1476,0
23426,1934,345,548205,1589,0
23432,819,152,101384,667,0
23459,714,137,79049,577,0
23460,174,36,4968,138,0
23472,1078,198,174240,880,0
23482,1583,310,394630,1273,0
23485,836,151,103435,685,0
23497,1262,259,259777,1003,0
23500,771,137,86858,634,0
23511,14,3,33,11,0
23528,1541,306,377910,1235,0
23545,595,121,57354,474,0
23548,20,4,64,16,0
23554,70,12,696,58,0
23578,865,167,116566,698,0
23583,659,132,69928,527,0
23586,1204,251,239203,953,0
23592,1181,246,230010,935,0
23594,395,72,23256,323,0
23595,1558,313,389685,1245,0
23603,535,94,41454,441,0
23605,1558,313,389685,1245,0
23622,1296,252,263088,1044,0
23654,819,152,101384,667,0
23660,1558,313,389685,1245,0
23677,21,3,54,18,0
23693,714,137,79049,577,0
23700,252,45,9315,207,0
23710,1331,255,274380,1076,0
23713,539,101,44238,438,0
23719,1583,310,394630,1273,0
23728,185,36,5364,149,0
23733,1078,198,174240,880,0
23757,1296,252,263088,1044,0
23776,395,72,23256,323,0
23797,535,94,41454,441,0
23817,821,143,96954,678,0
23819,54,14,560,40,0
23831,148,24,2976,124,0
23838,1262,259,259777,1003,0
23843,156,34,4148,122,0
23845,1411,281,317530,1130,0
23849,700,128,73216,572,0
23880,97,22,1650,75,0
23896,395,72,23256,323,0
23898,1541,306,377910,1235,0
23921,1181,246,230010,935,0
23927,1411,281,317530,1130,0
23938,360,66,19404,294,0
23966,321,54,14418,267,0
23973,548,102,45492,446,0
24004,401,77,24948,324,0
24013,1657,315,422730,1342,0
24016,714,137,79049,577,0
24031,2102,402,683400,1700,0
24049,27,3,72,24,0
24056,1331,255,274380,1076,0
24091,380,76,23104,304,0
24100,1541,306,377910,1235,0
24103,1552,299,374647,1253,0
24105,1342,282,298920,1060,0
24108,1829,353,521028,1476,0
24125,155,27,3456,128,0
24130,1280,232,243136,1048,0
24138,572,130,57460,442,0
24150,1558,313,389685,1245,0
24157,1583,310,394630,1273,0
24166,976,180,143280,796,0
24175,971,184,144808,787,0
24203,410,76,25384,334,0
24229,68,12,672,56,0
24239,836,151,103435,685,0
24262,714,137,79049,577,0
24265,273,58,12470,215,0
24270,971,184,144808,787,0
24277,516,103,42539,413,0
24284,174,36,4968,138,0
24291,324,67,17219,257,0
24324,2102,402,683400,1700,0
24327,1280,232,243136,1048,0
24356,121,27,2538,94,0
24375,595,121,57354,474,0
24384,1025,201,165624,824,0
24390,819,152,101384,667,0
24407,516,103,42539,413,0
24409,1342,282,298920,1060,0
24418,18,2,32,16,0
24425,1876,359,544603,1517,0
24426,865,167,116566,698,0
24431,380,76,23104,304,0
24436,1541,306,377910,1235,0
24443,1657,315,422730,1342,0
24445,571,114,52098,457,0
24455,1331,255,274380,1076,0
24485,620,121,60379,499,0
24523,58,15,645,43,0
24564,236,50,9300,186,0
24572,380,76,23104,304,0
24600,950,193,146101,757,0
24618,778,163,100245,615,0
24632,821,171,111150,650,0
24643,821,171,111150,650,0
24644,1876,359,544603,1517,0
24649,36,6,180,30,0
24654,88,17,1207,71,0
24705,44,10,340,34,0
24726,1204,251,239203,953,0
24743,193,39,6006,154,0
24747,75,19,1064,56,0
24766,1541,306,377910,1235,0
24769,821,143,96954,678,0
24814,160,32,4096,128,0
24819,1583,310,394630,1273,0
24820,819,152,101384,667,0
24821,88,17,1207,71,0
24830,659,132,69928,527,0
24832,2102,402,683400,1700,0
24833,1411,281,317530,1130,0
24845,1876,359,544603,1517,0
24873,1280,232,243136,1048,0
24887,415,75,25500,340,0
24904,572,130,57460,442,0
24925,1657,315,422730,1342,0
24937,932,168,128352,764,0
24938,1829,353,521028,1476,0
24951,1552,299,374647,1253,0
24954,714,137,79049,577,0
24958,793,158,100330,635,0
24969,821,143,96954,678,0
24984,107,19,1672,88,0
25030,72,17,935,55,0
25048,552,113,49607,439,0
25060,171,35,4760,136,0
25087,6,1,5,5,0
25088,1558,313,389685,1245,0
25091,217,44,7612,173,0
25100,124,28,2688,96,0
25115,317,63,16002,254,0
25120,778,163,100245,615,0
25132,778,163,100245,615,0
25136,97,22,1650,75,0
25139,1204,251,239203,953,0
25143,516,103,42539,413,0
25158,227,44,8052,183,0
25161,1876,359,544603,1517,0
25163,360,66,19404,294,0
25180,568,114,51756,454,0
25199,571,114,52098,457,0
25207,568,114,51756,454,0
25210,15,3,36,12,0
25215,976,180,143280,796,0
25217,102,20,1640,82,0
25229,1262,259,259777,1003,0
25235,252,45,9315,207,0
25243,821,143,96954,678,0
25248,144,29,3335,115,0
25249,971,184,144808,787,0
25262,1181,246,230010,935,0
25268,1078,198,174240,880,0
25281,548,102,45492,446,0
25292,976,180,143280,796,0
25328,366,70,20720,296,0
25361,42,5,185,37,0
25362,976,180,143280,796,0
25374,641,131,66810,510,0
25382,185,36,5364,149,0
25384,1583,310,394630,1273,0
25388,571,114,52098,457,0
25400,950,193,146101,757,0
25403,821,143,96954,678,0
25412,819,152,101384,667,0
25449,71,15,840,56,0
25473,1876,359,544603,1517,0
25475,146,34,3808,112,0
25488,1296,252,263088,1044,0
25495,1262,259,259777,1003,0
25523,365,74,21534,291,0
25524,1657,315,422730,1342,0
25527,88,17,1207,71,0
25535,659,132,69928,527,0
25546,315,56,14504,259,0
25558,548,102,45492,446,0
25568,595,120,57000,475,0
25588,976,180,143280,796,0
25599,1541,306,377910,1235,0
25600,380,76,23104,304,0
25614,1829,353,521028,1476,0
25626,1552,299,374647,1253,0
25650,1558,313,389685,1245,0
25653,2102,402,683400,1700,0
25660,595,120,57000,475,0
25663,595,120,57000,475,0
25690,401,77,24948,324,0
25691,571,114,52098,457,0
25697,821,171,111150,650,0
25722,971,184,144808,787,0
25731,950,193,146101,757,0
25757,12,3,27,9,0
25792,107,18,1602,89,0
25795,113,20,1860,93,0
25804,401,77,24948,324,0
25812,1558,313,389685,1245,0
25825,207,41,6806,166,0
25830,395,72,23256,323,0
25857,28,7,147,21,0
25862,198,43,6665,155,0
25865,122,22,2200,100,0
25867,767,144,89712,623,0
25877,1657,315,422730,1342,0
25880,89,15,1110,74,0
25887,137,25,2800,112,0
25900,1876,359,544603,1517,0
25902,8,1,7,7,0
25903,821,171,111150,650,0
25907,1025,201,165624,824,0
25921,539,101,44238,438,0
25932,950,193,146101,757,0
25936,360,66,19404,294,0
25943,771,137,86858,634,0
25950,1657,315,422730,1342,0
25965,1558,313,389685,1245,0
25969,337,74,19462,263,0
25981,793,158,100330,635,0
26000,37,5,160,32,0
26002,1181,246,230010,935,0
26019,1541,306,377910,1235,0
26041,535,94,41454,441,0
26045,1296,252,263088,1044,0
26052,60,12,576,48,0
26057,379,65,20410,314,0
26062,1829,353,521028,1476,0
26086,1829,353,521028,1476,0
26087,2102,402,683400,1700,0
26090,700,128,73216,572,0
26117,110,27,2241,83,0
26125,89,15,1110,74,0
26131,463,83,31540,380,0
26138,1829,353,521028,1476,0
26150,401,77,24948,324,0
26151,2102,402,683400,1700,0
26162,1411,281,317530,1130,0
26163,1829,353,521028,1476,0
26166,495,87,35496,408,0
26169,156,34,4148,122,0
26183,1876,359,544603,1517,0
26190,535,94,41454,441,0
26193,950,193,146101,757,0
26204,793,158,100330,635,0
26208,821,171,111150,650,0
26212,385,71,22294,314,0
26215,305,70,16450,235,0
26231,950,193,146101,757,0
26232,1342,282,298920,1060,0
26238,1541,306,377910,1235,0
26252,793,158,100330,635,0
26255,1558,313,389685,1245,0
26259,571,114,52098,457,0
26270,1541,306,377910,1235,0
26274,771,137,86858,634,0
26276,1541,306,377910,1235,0
26287,366,70,20720,296,0
26301,44,9,315,35,0
26311,1558,313,389685,1245,0
26327,37,10,270,27,0
26346,950,193,146101,757,0
26356,821,171,111150,650,0
26362,1025,201,165624,824,0
26369,1876,359,544603,1517,0
26392,131,25,2650,106,0
26405,65,13,676,52,0
26423,1262,259,259777,1003,0
26424,1342,282,298920,1060,0
26437,535,94,41454,441,0
26440,1583,310,394630,1273,0
26457,620,121,60379,499,0
26459,1411,281,317530,1130,0
26495,193,39,6006,154,0
26499,1583,310,394630,1273,0
26504,2102,402,683400,1700,0
26508,1876,359,544603,1517,0
26510,571,114,52098,457,0
26531,1411,281,317530,1130,0
26545,821,171,111150,650,0
26555,44,10,340,34,0
26557,2102,402,683400,1700,0
26559,714,137,79049,577,0
26562,119,25,2350,94,0
26579,2102,402,683400,1700,0
26588,568,114,51756,454,0
26602,568,114,51756,454,0
26608,365,74,21534,291,0
26609,8,2,12,6,0
26618,346,76,20520,270,0
26619,1411,281,317530,1130,0
26631,1342,282,298920,1060,0
26652,534,102,44064,432,0
26657,1078,198,174240,880,0
26660,155,34,4114,121,0
26669,315,56,14504,259,0
26682,767,144,89712,623,0
26685,497,97,38800,400,0
26689,1541,306,377910,1235,0
26697,821,143,96954,678,0
26707,1331,255,274380,1076,0
26708,1262,259,259777,1003,0
26712,198,43,6665,155,0
26716,1025,201,165624,824,0
26725,1411,281,317530,1130,0
26744,548,102,45492,446,0
26750,373,74,22126,299,0
26756,362,69,20217,293,0
26760,1411,281,317530,1130,0
26778,52,10,420,42,0
26779,1583,310,394630,1273,0
26786,1552,299,374647,1253,0
26795,155,27,3456,128,0
26798,61,14,658,47,0
26815,236,50,9300,186,0
26831,551,102,45798,449,0
26834,175,29,4234,146,0
26841,119,25,2350,94,0
26845,548,102,45492,446,0
26847,1583,310,394630,1273,0
26897,415,75,25500,340,0
26899,1342,282,298920,1060,0
26916,793,158,100330,635,0
26917,47,11,396,36,0
26923,548,102,45492,446,0
26925,7,2,10,5,0
26943,252,45,9315,207,0
26953,976,180,143280,796,0
26954,2102,402,683400,1700,0
26957,122,25,2425,97,0
26958,379,65,20410,314,0
26967,28,7,147,21,0
26976,495,87,35496,408,0
26985,548,102,45492,446,0
27020,89,15,1110,74,0
27025,548,102,45492,446,0
27028,71,15,840,56,0
27034,124,28,2688,96,0
27039,1280,232,243136,1048,0
27068,1934,345,548205,1589,0
27084,360,66,19404,294,0
27102,1181,246,230010,935,0
27111,1829,353,521028,1476,0
27126,793,158,100330,635,0
27133,821,171,111150,650,0
27142,55,10,450,45,0
27163,131,25,2650,106,0
27170,385,71,22294,314,0
27178,1552,299,374647,1253,0
27179,778,163,100245,615,0
27182,595,121,57354,474,0
27184,1934,345,548205,1589,0
27195,1558,313,389685,1245,0
27196,836,151,103435,685,0
27219,620,121,60379,499,0
27221,659,132,69928,527,0
27230,315,56,14504,259,0
27231,1876,359,544603,1517,0
27261,135,30,3150,105,0
27296,405,82,26486,323,0
27297,2102,402,683400,1700,0
27305,1583,310,394630,1273,0
27306,571,114,52098,457,0
27317,950,193,146101,757,0
27348,1331,255,274380,1076,0
27354,2102,402,683400,1700,0
27379,1078,198,174240,880,0
27381,1078,198,174240,880,0
27422,2102,402,683400,1700,0
27426,1331,255,274380,1076,0
27435,62,16,736,46,0
27452,11,2,18,9,0
27481,552,113,49607,439,0
27482,819,152,101384,667,0
27485,1552,299,374647,1253,0
27507,1657,315,422730,1342,0
27539,15,4,44,11,0
27544,1025,201,165624,824,0
27546,144,29,3335,115,0
27552,821,143,96954,678,0
27571,401,77,24948,324,0
27585,2102,402,683400,1700,0
27588,70,12,696,58,0
27622,112,18,1692,94,0
27630,1829,353,521028,1476,0
27634,551,102,45798,449,0
27644,534,102,44064,432,0
27686,778,163,100245,615,0
27698,346,76,20520,270,0
27722,101,20,1620,81,0
27723,365,74,21534,291,0
27735,105,16,1424,89,0
27736,89,15,1110,74,0
27743,52,10,420,42,0
27768,122,25,2425,97,0
27770,144,29,3335,115,0
27774,1331,255,274380,1076,0
27797,41,8,264,33,0
27799,516,103,42539,413,0
27807,1829,353,521028,1476,0
27819,24,2,44,22,0
27829,1078,198,174240,880,0
27833,160,29,3799,131,0
27852,1583,310,394630,1273,0
27860,72,17,935,55,0
27874,217,44,7612,173,0
27880,714,137,79049,577,0
27890,1934,345,548205,1589,0
27919,337,74,19462,263,0
27920,534,102,44064,432,0
27921,1342,282,298920,1060,0
27936,171,35,4760,136,0
27944,124,28,2688,96,0
27950,771,137,86858,634,0
27960,40,9,279,31,0
27968,69,14,770,55,0
27970,1342,282,298920,1060,0
27982,1078,198,174240,880,0
27984,198,43,6665,155,0
28001,1657,315,422730,1342,0
28006,1078,198,174240,880,0
28012,61,13,624,48,0
28013,778,163,100245,615,0
28021,380,76,23104,304,0
28029,324,67,17219,257,0
28035,1204,251,239203,953,0
28045,144,29,3335,115,0
28067,373,74,22126,299,0
28084,1876,359,544603,1517,0
28114,1025,201,165624,824,0
28127,1876,359,544603,1517,0
28133,495,87,35496,408,0
28151,401,77,24948,324,0
28158,1876,359,544603,1517,0
28160,1342,282,298920,1060,0
28180,146,34,3808,112,0
28195,1181,246,230010,935,0
28203,571,114,52098,457,0
28210,1262,259,259777,1003,0
28226,819,152,101384,667,0
28232,321,54,14418,267,0
28236,88,17,1207,71,0
28240,194,39,6045,155,0
28242,401,77,24948,324,0
28251,714,137,79049,577,0
28298,976,180,143280,796,0
28303,1411,281,317530,1130,0
28310,60,12,576,48,0
28315,346,76,20520,270,0
28333,1262,259,259777,1003,0
28349,1558,313,389685,1245,0
28361,186,35,5285,151,0
28377,324,67,17219,257,0
28388,495,87,35496,408,0
28409,1552,299,374647,1253,0
28414,976,180,143280,796,0
28416,273,58,12470,215,0
28424,767,144,89712,623,0
28425,767,144,89712,623,0
28444,252,45,9315,207,0
28453,971,184,144808,787,0
28457,1296,252,263088,1044,0
28464,236,50,9300,186,0
28465,1829,353,521028,1476,0
28514,1934,345,548205,1589,0
28553,379,65,20410,314,0
28565,1552,299,374647,1253,0
28566,1541,306,377910,1235,0
28574,767,144,89712,623,0
28575,70,15,825,55,0
28578,659,132,69928,527,0
28583,1181,246,230010,935,0
28591,1876,359,544603,1517,0
28593,821,143,96954,678,0
28598,2102,402,683400,1700,0
28600,207,41,6806,166,0
28609,20,5,75,15,0
28622,1552,299,374647,1253,0
28633,1876,359,544603,1517,0
28634,1934,345,548205,1589,0
28645,932,168,128352,764,0
28650,620,121,60379,499,0
28651,1342,282,298920,1060,0
28653,64,16,768,48,0
28658,273,58,12470,215,0
28660,534,102,44064,432,0
28663,22,6,96,16,0
28676,217,44,7612,173,0
28678,1181,246,230010,935,0
28679,932,168,128352,764,0
28681,778,163,100245,615,0
28683,1342,282,298920,1060,0
28684,1181,246,230010,935,0
28752,595,120,57000,475,0
28755,1181,246,230010,935,0
28818,971,184,144808,787,0
28839,236,50,9300,186,0
28850,107,19,1672,88,0
28884,495,87,35496,408,0
28888,1331,255,274380,1076,0
28897,175,29,4234,146,0
28899,971,184,144808,787,0
28917,1558,313,389685,1245,0
28920,54,14,560,40,0
28922,1876,359,544603,1517,0
28963,534,102,44064,432,0
28968,1829,353,521028,1476,0
28969,1876,359,544603,1517,0
28974,2102,402,683400,1700,0
29014,497,97,38800,400,0
29025,7,2,10,5,0
29033,1876,359,544603,1517,0
29060,463,83,31540,380,0
29063,1541,306,377910,1235,0
29076,108,17,1547,91,0
29082,1280,232,243136,1048,0
29085,1025,201,165624,824,0
29105,1181,246,230010,935,0
29106,61,9,468,52,0
29130,1262,259,259777,1003,0
29136,771,137,86858,634,0
29149,1078,198,174240,880,0
29154,1541,306,377910,1235,0
29158,61,11,550,50,0
29159,315,56,14504,259,0
29161,1558,313,389685,1245,0
29169,714,137,79049,577,0
29172,1078,198,174240,880,0
29184,641,131,66810,510,0
29201,660,133,69928,527,0
29221,362,69,20217,293,0
29226,2102,402,683400,1700,0
29241,497,97,38800,400,0
29247,1181,246,230010,935,0
29259,1552,299,374647,1253,0
29271,1078,198,174240,880,0
29272,415,75,25500,340,0
29275,1280,232,243136,1048,0
29278,194,39,6045,155,0
29294,1876,359,544603,1517,0
29295,1876,359,544603,1517,0
29301,976,180,143280,796,0
29306,2102,402,683400,1700,0
29342,1411,281,317530,1130,0
29359,395,72,23256,323,0
29370,495,87,35496,408,0
29371,976,180,143280,796,0
29379,771,137,86858,634,0
29409,767,144,89712,623,0
29418,346,76,20520,270,0
29424,395,72,23256,323,0
29431,548,102,45492,446,0
29432,1296,252,263088,1044,0
29435,227,44,8052,183,0
29436,1876,359,544603,1517,0
29438,1541,306,377910,1235,0
29447,660,133,69928,527,0
29451,976,180,143280,796,0
29458,324,67,17219,257,0
29466,595,121,57354,474,0
29473,443,85,30430,358,0
29475,771,137,86858,634,0
29476,6,2,8,4,0
29482,1558,313,389685,1245,0
29490,865,167,116566,698,0
29501,321,54,14418,267,0
29512,185,36,5364,149,0
29518,495,87,35496,408,0
29536,836,151,103435,685,0
29556,1204,251,239203,953,0
29594,227,44,8052,183,0
29597,44,10,340,34,0
29623,1829,353,521028,1476,0
29630,819,152,101384,667,0
29652,273,58,12470,215,0
29653,1583,310,394630,1273,0
29659,1342,282,298920,1060,0
29670,1342,282,298920,1060,0
29673,1181,246,230010,935,0
29687,819,152,101384,667,0
29692,771,137,86858,634,0
29704,185,36,5364,149,0
29719,821,171,111150,650,0
29729,97,22,1650,75,0
29741,700,128,73216,572,0
29743,160,32,4096,128,0
29746,971,184,144808,787,0
29755,1876,359,544603,1517,0
29767,1934,345,548205,1589,0
29769,2102,402,683400,1700,0
29772,771,137,86858,634,0
29783,1541,306,377910,1235,0
29796,1934,345,548205,1589,0
29816,1331,255,274380,1076,0
29822,534,102,44064,432,0
29833,401,77,24948,324,0
29835,2102,402,683400,1700,0
29842,360,66,19404,294,0
29854,1657,315,422730,1342,0
29871,819,152,101384,667,0
29888,1262,259,259777,1003,0
29892,305,70,16450,235,0
29907,1262,259,259777,1003,0
29909,771,137,86858,634,0
29945,1331,255,274380,1076,0
29957,971,184,144808,787,0
29962,156,34,4148,122,0
30003,23,5,90,18,0
30021,1829,353,521028,1476,0
30032,274,57,12369,217,0
30035,61,13,624,48,0
30090,155,35,4200,120,0
30110,443,85,30430,358,0
30111,932,168,128352,764,0
30113,1342,282,298920,1060,0
30125,1025,201,165624,824,0
30136,836,151,103435,685,0
30152,1280,232,243136,1048,0
30156,932,168,128352,764,0
30159,282,50,11600,232,0
30165,1411,281,317530,1130,0
30167,1262,259,259777,1003,0
30168,595,121,57354,474,0
30169,1934,345,548205,1589,0
30170,950,193,146101,757,0
30203,714,137,79049,577,0
30205,48,10,380,38,0
30209,1204,251,239203,953,0
30232,122,20,2040,102,0
30243,700,128,73216,572,0
30256,1331,255,274380,1076,0
30280,1541,306,377910,1235,0
30282,323,55,14740,268,0
30294,156,34,4148,122,0
30322,495,87,35496,408,0
30325,135,30,3150,105,0
30335,18,3,45,15,0
30341,1541,306,377910,1235,0
30343,819,152,101384,667,0
30351,1657,315,422730,1342,0
30355,659,132,69928,527,0
30374,516,103,42539,413,0
30384,362,69,20217,293,0
30386,463,83,31540,380,0
30387,595,121,57354,474,0
30393,60,12,576,48,0
30400,274,57,12369,217,0
30407,1558,313,389685,1245,0
30417,52,10,420,42,0
30421,1204,251,239203,953,0
30424,1078,198,174240,880,0
30429,548,102,45492,446,0
30437,700,128,73216,572,0
30438,28,7,147,21,0
30480,1541,306,377910,1235,0
30482,1541,306,377910,1235,0
30494,395,72,23256,323,0
30516,539,101,44238,438,0
30518,932,168,128352,764,0
30524,535,94,41454,441,0
30550,660,133,69928,527,0
30552,595,120,57000,475,0
30554,69,14,770,55,0
30557,410,76,25384,334,0
30574,1552,299,374647,1253,0
30587,75,19,1064,56,0
30592,1296,252,263088,1044,0
30625,932,168,128352,764,0
30635,1657,315,422730,1342,0
30637,534,102,44064,432,0
30639,595,120,57000,475,0
30654,1657,315,422730,1342,0
30664,821,171,111150,650,0
30672,1657,315,422730,1342,0
30683,2102,402,683400,1700,0
30684,1876,359,544603,1517,0
30699,1181,246,230010,935,0
30721,836,151,103435,685,0
30729,324,67,17219,257,0
30738,1934,345,548205,1589,0
30753,1025,201,165624,824,0
30760,373,74,22126,299,0
30763,793,158,100330,635,0
30767,1583,310,394630,1273,0
30780,1078,198,174240,880,0
30783,145,23,2806,122,0
30785,821,143,96954,678,0
30788,535,94,41454,441,0
30793,534,102,44064,432,0
30798,185,36,5364,149,0
30813,620,121,60379,499,0
30815,1331,255,274380,1076,0
30818,568,114,51756,454,0
30830,1876,359,544603,1517,0
30831,571,114,52098,457,0
30836,932,168,128352,764,0
30864,137,25,2800,112,0
30872,821,171,111150,650,0
30874,1025,201,165624,824,0
30891,1558,313,389685,1245,0
30897,1558,313,389685,1245,0
30899,2102,402,683400,1700,0
30902,1934,345,548205,1589,0
30904,41,8,264,33,0
30920,793,158,100330,635,0
30925,821,143,96954,678,0
30931,1829,353,521028,1476,0
30932,1558,313,389685,1245,0
30956,767,144,89712,623,0
30966,659,132,69928,527,0
30967,571,114,52098,457,0
30970,836,151,103435,685,0
30976,1342,282,298920,1060,0
30984,552,113,49607,439,0
31010,1331,255,274380,1076,0
31012,821,143,96954,678,0
31031,778,163,100245,615,0
31033,1280,232,243136,1048,0
31048,1541,306,377910,1235,0
31071,497,97,38800,400,0
31135,85,18,1206,67,0
31141,305,70,16450,235,0
31146,548,102,45492,446,0
31152,11,3,24,8,0
31161,714,137,79049,577,0
31199,324,67,17219,257,0
31204,1280,232,243136,1048,0
31205,1657,315,422730,1342,0
31211,360,66,19404,294,0
31216,552,113,49607,439,0
31219,1657,315,422730,1342,0
31236,119,25,2350,94,0
31239,572,130,57460,442,0
31251,1934,345,548205,1589,0
31255,1583,310,394630,1273,0
31273,362,69,20217,293,0
31295,1296,252,263088,1044,0
31311,135,30,3150,105,0
31313,767,144,89712,623,0
31333,194,39,6045,155,0
31336,30,6,144,24,0
31346,836,151,103435,685,0
31361,70,15,825,55,0
31369,156,34,4148,122,0
31391,68,14,756,54,0
31392,1025,201,165624,824,0
31396,146,34,3808,112,0
31407,194,39,6045,155,0
31408,771,137,86858,634,0
31436,415,75,25500,340,0
31452,186,35,5285,151,0
31458,1296,252,263088,1044,0
31462,551,102,45798,449,0
31469,373,74,22126,299,0
31474,77,19,1102,58,0
31484,2102,402,683400,1700,0
31486,714,137,79049,577,0
31504,976,180,143280,796,0
31547,337,74,19462,263,0
31554,360,66,19404,294,0
31560,1181,246,230010,935,0
31570,1342,282,298920,1060,0
31595,865,167,116566,698,0
31602,323,55,14740,268,0
31658,2102,402,683400,1700,0
31659,620,121,60379,499,0
31687,976,180,143280,796,0
31693,1558,313,389685,1245,0
31695,321,54,14418,267,0
31696,1552,299,374647,1253,0
31715,1934,345,548205,1589,0
31731,106,19,1653,87,0
31744,932,168,128352,764,0
31756,2102,402,683400,1700,0
31765,282,50,11600,232,0
31782,1829,353,521028,1476,0
31797,865,167,116566,698,0
31799,401,77,24948,324,0
31810,660,133,69928,527,0
31817,821,171,111150,650,0
31819,516,103,42539,413,0
31831,516,103,42539,413,0
31850,2102,402,683400,1700,0
31858,463,83,31540,380,0
31870,401,77,24948,324,0
31875,714,137,79049,577,0
31882,641,131,66810,510,0
31895,1411,281,317530,1130,0
31917,1411,281,317530,1130,0
31925,282,50,11600,232,0
31933,1411,281,317530,1130,0
31966,1552,299,374647,1253,0
31972,236,50,9300,186,0
31987,1262,259,259777,1003,0
31995,1342,282,298920,1060,0
32017,1342,282,298920,1060,0
32019,1411,281,317530,1130,0
32072,819,152,101384,667,0
32098,75,19,1064,56,0
32100,1876,359,544603,1517,0
32110,568,114,51756,454,0
32126,819,152,101384,667,0
32128,365,74,21534,291,0
32131,1025,201,165624,824,0
32136,568,114,51756,454,0
32166,120,24,2304,96,0
32167,193,39,6006,154,0
32173,660,133,69928,527,0
32190,1558,313,389685,1245,0
32192,1541,306,377910,1235,0
32196,35,6,174,29,0
32206,1876,359,544603,1517,0
32211,495,87,35496,408,0
32223,410,76,25384,334,0
32227,410,76,25384,334,0
32245,551,102,45798,449,0
32251,1331,255,274380,1076,0
32309,1934,345,548205,1589,0
32333,155,35,4200,120,0
32358,771,137,86858,634,0
32376,1829,353,521028,1476,0
32405,534,102,44064,432,0
32407,778,163,100245,615,0
32418,793,158,100330,635,0
32426,932,168,128352,764,0
32443,463,83,31540,380,0
32446,35,8,216,27,0
32448,68,12,672,56,0
32453,18,2,32,16,0
32462,821,143,96954,678,0
32467,1934,345,548205,1589,0
32478,1025,201,165624,824,0
32490,1657,315,422730,1342,0
32493,1411,281,317530,1130,0
32503,1876,359,544603,1517,0
32512,1331,255,274380,1076,0
32534,793,158,100330,635,0
32541,976,180,143280,796,0
32592,821,171,111150,650,0
32597,620,121,60379,499,0
32606,110,18,1656,92,0
32607,700,128,73216,572,0
32609,401,77,24948,324,0
32612,1296,252,263088,1044,0
32613,346,76,20520,270,0
32615,1204,251,239203,953,0
32634,1583,310,394630,1273,0
32640,410,76,25384,334,0
32641,1331,255,274380,1076,0
32653,56,13,559,43,0
32674,110,27,2241,83,0
32675,315,56,14504,259,0
32679,227,44,8052,183,0
32702,380,76,23104,304,0
32712,568,114,51756,454,0
32717,366,70,20720,296,0
32719,324,67,17219,257,0
32723,1558,313,389685,1245,0
32729,1657,315,422730,1342,0
32730,595,120,57000,475,0
32763,950,193,146101,757,0
32764,778,163,100245,615,0
32784,305,70,16450,235,0
32787,1583,310,394630,1273,0
32812,236,50,9300,186,0
32828,571,114,52098,457,0
32830,620,121,60379,499,0
32856,2102,402,683400,1700,0
32862,1829,353,521028,1476,0
32863,1025,201,165624,824,0
32877,836,151,103435,685,0
32879,131,21,2310,110,0
32926,516,103,42539,413,0
32939,551,102,45798,449,0
32940,105,22,1826,83,0
32953,135,30,3150,105,0
32962,819,152,101384,667,0
32965,497,97,38800,400,0
32972,571,114,52098,457,0
32973,443,85,30430,358,0
32975,1541,306,377910,1235,0
33002,495,87,35496,408,0
33022,1657,315,422730,1342,0
33041,58,15,645,43,0
33042,47,8,312,39,0
33063,1657,315,422730,1342,0
33072,2102,402,683400,1700,0
33079,1025,201,165624,824,0
33087,175,29,4234,146,0
33097,337,74,19462,263,0
33099,495,87,35496,408,0
33103,1583,310,394630,1273,0
33107,1342,282,298920,1060,0
33115,33,8,200,25,0
33117,976,180,143280,796,0
33122,620,121,60379,499,0
33170,198,43,6665,155,0
33183,1181,246,230010,935,0
33190,1934,345,548205,1589,0
33196,1411,281,317530,1130,0
33198,25,5,100,20,0
33199,572,130,57460,442,0
33214,35,7,196,28,0
33240,1934,345,548205,1589,0
33243,1558,313,389685,1245,0
33249,1331,255,274380,1076,0
33258,1934,345,548205,1589,0
33273,660,133,69928,527,0
33276,362,69,20217,293,0
33277,1552,299,374647,1253,0
33288,198,43,6665,155,0
33323,119,22,2134,97,0
33330,198,43,6665,155,0
33340,971,184,144808,787,0
33351,1331,255,274380,1076,0
33356,323,55,14740,268,0
33368,58,12,552,46,0
33371,568,114,51756,454,0
33374,1078,198,174240,880,0
33382,572,130,57460,442,0
33391,1558,313,389685,1245,0
33424,1829,353,521028,1476,0
33430,1078,198,174240,880,0
33435,1181,246,230010,935,0
33444,2102,402,683400,1700,0
33445,321,54,14418,267,0
33462,1657,315,422730,1342,0
33516,2102,402,683400,1700,0
33517,380,76,23104,304,0
33525,55,11,484,44,0
33536,535,94,41454,441,0
33545,102,20,1640,82,0
33548,25,5,100,20,0
33564,1280,232,243136,1048,0
33570,1558,313,389685,1245,0
33571,1583,310,394630,1273,0
33577,836,151,103435,685,0
33584,105,16,1424,89,0
33589,1657,315,422730,1342,0
33596,395,72,23256,323,0
33609,572,130,57460,442,0
33610,1934,345,548205,1589,0
33621,443,85,30430,358,0
33625,1181,246,230010,935,0
33646,401,77,24948,324,0
33672,1657,315,422730,1342,0
33676,659,132,69928,527,0
33684,821,171,111150,650,0
33687,1411,281,317530,1130,0
33694,836,151,103435,685,0
33697,771,137,86858,634,0
33707,1552,299,374647,1253,0
33711,1657,315,422730,1342,0
33720,137,25,2800,112,0
33730,1558,313,389685,1245,0
33742,185,36,5364,149,0
33745,595,120,57000,475,0
33747,1552,299,374647,1253,0
33751,1934,345,548205,1589,0
33760,1934,345,548205,1589,0
33764,1411,281,317530,1130,0
33775,1552,299,374647,1253,0
33782,379,65,20410,314,0
33798,217,44,7612,173,0
33815,58,11,517,47,0
33830,865,167,116566,698,0
33842,552,113,49607,439,0
33845,305,70,16450,235,0
33848,15,3,36,12,0
33865,1262,259,259777,1003,0
33887,207,41,6806,166,0
33920,1331,255,274380,1076,0
33924,1552,299,374647,1253,0
33930,1552,299,374647,1253,0
33933,1411,281,317530,1130,0
33951,1552,299,374647,1253,0
33987,64,15,735,49,0
33999,1025,201,165624,824,0
34002,31,9,198,22,0
34028,2102,402,683400,1700,0
34045,1204,251,239203,953,0
34061,714,137,79049,577,0
34080,1657,315,422730,1342,0
34091,1934,345,548205,1589,0
34099,236,50,9300,186,0
34127,1541,306,377910,1235,0
34135,495,87,35496,408,0
34138,1280,232,243136,1048,0
34152,778,163,100245,615,0
34156,26,6,120,20,0
34170,1934,345,548205,1589,0
34174,89,15,1110,74,0
34176,778,163,100245,615,0
34207,1558,313,389685,1245,0
34220,819,152,101384,667,0
34245,793,158,100330,635,0
34256,410,76,25384,334,0
34257,1342,282,298920,1060,0
34263,379,65,20410,314,0
34265,819,152,101384,667,0
34268,337,74,19462,263,0
34293,1181,246,230010,935,0
34313,539,101,44238,438,0
34314,971,184,144808,787,0
34324,1583,310,394630,1273,0
34330,836,151,103435,685,0
34331,110,27,2241,83,0
34336,1411,281,317530,1130,0
34344,227,44,8052,183,0
34347,395,72,23256,323,0
34348,1262,259,259777,1003,0
34368,1876,359,544603,1517,0
34390,976,180,143280,796,0
34392,1583,310,394630,1273,0
34409,836,151,103435,685,0
34411,932,168,128352,764,0
34413,534,102,44064,432,0
34418,819,152,101384,667,0
34435,443,85,30430,358,0
34438,1657,315,422730,1342,0
34440,1280,232,243136,1048,0
34450,33,5,140,28,0
34452,865,167,116566,698,0
34453,324,67,17219,257,0
34466,1181,246,230010,935,0
34497,595,121,57354,474,0
34498,32,7,175,25,0
34540,373,74,22126,299,0
34541,865,167,116566,698,0
34546,1876,359,544603,1517,0
34551,193,39,6006,154,0
34553,1181,246,230010,935,0
34554,778,163,100245,615,0
34566,48,10,380,38,0
34568,20,3,51,17,0
34578,185,36,5364,149,0
34584,2102,402,683400,1700,0
34604,1296,252,263088,1044,0
34606,620,121,60379,499,0
34612,401,77,24948,324,0
34620,865,167,116566,698,0
34633,120,24,2304,96,0
34638,1558,313,389685,1245,0
34639,1181,246,230010,935,0
34647,1583,310,394630,1273,0
34648,1558,313,389685,1245,0
34659,1280,232,243136,1048,0
34660,134,30,3120,104,0
34673,1204,251,239203,953,0
34682,1934,345,548205,1589,0
34692,366,70,20720,296,0
34695,1934,345,548205,1589,0
34696,1541,306,377910,1235,0
34706,1583,310,394630,1273,0
34713,548,102,45492,446,0
34719,620,121,60379,499,0
34738,1558,313,389685,1245,0
34741,551,102,45798,449,0
34752,1876,359,544603,1517,0
34757,950,193,146101,757,0
34758,1934,345,548205,1589,0
34773,767,144,89712,623,0
34790,58,12,552,46,0
34791,595,120,57000,475,0
34801,337,74,19462,263,0
34807,1876,359,544603,1517,0
34810,641,131,66810,510,0
34811,1181,246,230010,935,0
34824,821,171,111150,650,0
34831,1078,198,174240,880,0
34851,1829,353,521028,1476,0
34879,1331,255,274380,1076,0
34887,164,34,4420,130,0
34899,1829,353,521028,1476,0
34919,1342,282,298920,1060,0
34927,1025,201,165624,824,0
34931,1262,259,259777,1003,0
34935,15,3,36,12,0
34940,950,193,146101,757,0
34942,1583,310,394630,1273,0
34966,1934,345,548205,1589,0
34970,105,15,1350,90,0
34978,1657,315,422730,1342,0
35002,273,58,12470,215,0
35032,714,137,79049,577,0
35038,778,163,100245,615,0
35039,1934,345,548205,1589,0
35049,551,102,45798,449,0
35050,321,54,14418,267,0
35068,1296,252,263088,1044,0
35071,552,113,49607,439,0
35083,1558,313,389685,1245,0
35088,836,151,103435,685,0
35095,1552,299,374647,1253,0
35106,793,158,100330,635,0
35108,932,168,128352,764,0
35129,539,101,44238,438,0
35133,1331,255,274380,1076,0
35135,1411,281,317530,1130,0
35156,1025,201,165624,824,0
35157,595,121,57354,474,0
35175,1583,310,394630,1273,0
35178,160,32,4096,128,0
35179,1876,359,544603,1517,0
35190,1558,313,389685,1245,0
35191,315,56,14504,259,0
35192,360,66,19404,294,0
35194,1411,281,317530,1130,0
35217,58,15,645,43,0
35219,1342,282,298920,1060,0
35220,572,130,57460,442,0
35249,1296,252,263088,1044,0
35252,410,76,25384,334,0
35255,539,101,44238,438,0
35262,497,97,38800,400,0
35268,1552,299,374647,1253,0
35270,976,180,143280,796,0
35277,164,34,4420,130,0
35278,595,120,57000,475,0
35280,317,63,16002,254,0
35294,1934,345,548205,1589,0
35298,620,121,60379,499,0
35301,14,4,40,10,0
35302,155,35,4200,120,0
35309,2102,402,683400,1700,0
35314,61,11,550,50,0
35323,1934,345,548205,1589,0
35326,1541,306,377910,1235,0
35328,1331,255,274380,1076,0
35343,373,74,22126,299,0
35348,1296,252,263088,1044,0
35376,1204,251,239203,953,0
35383,821,143,96954,678,0
35386,1296,252,263088,1044,0
35407,516,103,42539,413,0
35408,360,66,19404,294,0
35409,1078,198,174240,880,0
35411,346,76,20520,270,0
35432,1204,251,239203,953,0
35433,1657,315,422730,1342,0
35437,1296,252,263088,1044,0
35472,793,158,100330,635,0
35474,539,101,44238,438,0
35475,366,70,20720,296,0
35476,122,25,2425,97,0
35524,121,27,2538,94,0
35527,571,114,52098,457,0
35536,415,75,25500,340,0
35549,227,44,8052,183,0
35551,1541,306,377910,1235,0
35553,1876,359,544603,1517,0
35574,323,55,14740,268,0
35589,1583,310,394630,1273,0
35598,821,143,96954,678,0
35599,1657,315,422730,1342,0
35610,1296,252,263088,1044,0
35615,714,137,79049,577,0
35618,27,5,110,22,0
35620,193,39,6006,154,0
35642,156,34,4148,122,0
35650,21,6,90,15,0
35651,1342,282,298920,1060,0
35658,551,102,45798,449,0
35663,568,114,51756,454,0
35664,72,14,812,58,0
35671,976,180,143280,796,0
35675,971,184,144808,787,0
35679,324,67,17219,257,0
35700,1583,310,394630,1273,0
35703,821,143,96954,678,0
35712,1296,252,263088,1044,0
35713,771,137,86858,634,0
35726,1552,299,374647,1253,0
35751,771,137,86858,634,0
35758,1558,313,389685,1245,0
35783,362,69,20217,293,0
35785,395,72,23256,323,0
35798,26,4,88,22,0
35799,2102,402,683400,1700,0
35812,700,128,73216,572,0
35834,1342,282,298920,1060,0
35841,1558,313,389685,1245,0
35842,865,167,116566,698,0
35844,155,27,3456,128,0
35850,793,158,100330,635,0
35854,1411,281,317530,1130,0
35867,1411,281,317530,1130,0
35879,1583,310,394630,1273,0
35887,932,168,128352,764,0
35916,778,163,100245,615,0
35922,1204,251,239203,953,0
35941,821,143,96954,678,0
35950,778,163,100245,615,0
35955,134,30,3120,104,0
35978,19,1,18,18,0
35988,58,11,517,47,0
35989,932,168,128352,764,0
35996,264,56,11648,208,0
36005,778,163,100245,615,0
36010,1829,353,521028,1476,0
36014,932,168,128352,764,0
36018,401,77,24948,324,0
36027,1558,313,389685,1245,0
36034,1025,201,165624,824,0
36036,2102,402,683400,1700,0
36037,69,12,684,57,0
36041,415,75,25500,340,0
36086,1657,315,422730,1342,0
36116,227,44,8052,183,0
36118,1078,198,174240,880,0
36120,1025,201,165624,824,0
36130,1204,251,239203,953,0
36137,1262,259,259777,1003,0
36139,33,7,182,26,0
36142,33,5,140,28,0
36144,1181,246,230010,935,0
36146,113,20,1860,93,0
36154,1342,282,298920,1060,0
36156,65,13,676,52,0
36187,976,180,143280,796,0
36192,113,24,2136,89,0
36194,1181,246,230010,935,0
36196,362,69,20217,293,0
36205,552,113,49607,439,0
36215,551,102,45798,449,0
36223,932,168,128352,764,0
36267,20,3,51,17,0
36272,1934,345,548205,1589,0
36295,595,120,57000,475,0
36313,534,102,44064,432,0
36316,595,120,57000,475,0
36331,572,130,57460,442,0
36332,1657,315,422730,1342,0
36346,65,13,676,52,0
36347,317,63,16002,254,0
36355,1583,310,394630,1273,0
36357,1558,313,389685,1245,0
36361,385,71,22294,314,0
36378,24,6,108,18,0
36414,778,163,100245,615,0
36417,1934,345,548205,1589,0
36421,146,34,3808,112,0
36427,535,94,41454,441,0
36434,61,9,468,52,0
36456,1296,252,263088,1044,0
36470,119,22,2134,97,0
36477,976,180,143280,796,0
36485,1411,281,317530,1130,0
36494,11,3,24,8,0
36495,317,63,16002,254,0
36510,971,184,144808,787,0
36514,131,21,2310,110,0
36515,1541,306,377910,1235,0
36517,1280,232,243136,1048,0
36529,207,41,6806,166,0
36547,865,167,116566,698,0
36551,135,30,3150,105,0
36563,1876,359,544603,1517,0
36580,1025,201,165624,824,0
36584,155,34,4114,121,0
36593,950,193,146101,757,0
36615,1876,359,544603,1517,0
36622,1280,232,243136,1048,0
36629,323,55,14740,268,0
36643,373,74,22126,299,0
36647,821,171,111150,650,0
36661,1541,306,377910,1235,0
36664,595,121,57354,474,0
36676,148,24,2976,124,0
36684,1558,313,389685,1245,0
36715,793,158,100330,635,0
36736,47,11,396,36,0
36737,1558,313,389685,1245,0
36744,821,171,111150,650,0
36745,1934,345,548205,1589,0
36748,865,167,116566,698,0
36753,1541,306,377910,1235,0
36757,2102,402,683400,1700,0
36760,119,22,2134,97,0
36788,821,171,111150,650,0
36790,1411,281,317530,1130,0
36791,144,29,3335,115,0
36809,1583,310,394630,1273,0
36825,366,70,20720,296,0
36829,793,158,100330,635,0
36832,217,44,7612,173,0
36844,70,15,825,55,0
36854,2102,402,683400,1700,0
36893,198,43,6665,155,0
36897,793,158,100330,635,0
36909,2102,402,683400,1700,0
36919,1262,259,259777,1003,0
36923,463,83,31540,380,0
36930,127,29,2842,98,0
36935,1204,251,239203,953,0
36944,22,6,96,16,0
36947,1541,306,377910,1235,0
36967,1280,232,243136,1048,0
36987,366,70,20720,296,0
36989,950,193,146101,757,0
36992,1934,345,548205,1589,0
36995,1541,306,377910,1235,0
37007,110,18,1656,92,0
37009,1934,345,548205,1589,0
37011,89,15,1110,74,0
37012,819,152,101384,667,0
37050,548,102,45492,446,0
37058,1876,359,544603,1517,0
37086,1876,359,544603,1517,0
37091,1583,310,394630,1273,0
37099,65,17,816,48,0
37113,85,18,1206,67,0
37118,410,76,25384,334,0
37121,373,74,22126,299,0
37124,1204,251,239203,953,0
37139,18,2,32,16,0
37163,317,63,16002,254,0
37176,107,19,1672,88,0
37180,1025,201,165624,824,0
37181,1558,313,389685,1245,0
37198,1262,259,259777,1003,0
37207,976,180,143280,796,0
37208,1411,281,317530,1130,0
37243,193,39,6006,154,0
37244,274,57,12369,217,0
37266,1876,359,544603,1517,0
37269,767,144,89712,623,0
37279,836,151,103435,685,0
37283,865,167,116566,698,0
37292,793,158,100330,635,0
37311,443,85,30430,358,0
37327,821,171,111150,650,0
37331,1342,282,298920,1060,0
37346,23,6,102,17,0
37387,1078,198,174240,880,0
37420,1342,282,298920,1060,0
37425,2102,402,683400,1700,0
37432,1262,259,259777,1003,0
37441,1296,252,263088,1044,0
37446,1262,259,259777,1003,0
37457,568,114,51756,454,0
37459,495,87,35496,408,0
37460,1657,315,422730,1342,0
37479,659,132,69928,527,0
37510,836,151,103435,685,0
37519,1204,251,239203,953,0
37524,1558,313,389685,1245,0
37562,971,184,144808,787,0
37584,2102,402,683400,1700,0
37592,324,67,17219,257,0
37607,572,130,57460,442,0
37612,65,17,816,48,0
37638,1025,201,165624,824,0
37657,174,36,4968,138,0
37698,1829,353,521028,1476,0
37724,415,75,25500,340,0
37728,122,22,2200,100,0
37732,252,45,9315,207,0
37753,571,114,52098,457,0
37757,495,87,35496,408,0
37766,700,128,73216,572,0
37776,950,193,146101,757,0
37796,58,11,517,47,0
37799,395,72,23256,323,0
37805,821,171,111150,650,0
37827,56,13,559,43,0
37831,1657,315,422730,1342,0
37887,274,57,12369,217,0
37918,31,9,198,22,0
37930,175,29,4234,146,0
37959,1296,252,263088,1044,0
37972,1262,259,259777,1003,0
37981,8,4,16,4,0
37983,346,76,20520,270,0
37990,11,3,24,8,0
37996,1829,353,521028,1476,0
38000,236,50,9300,186,0
38001,1829,353,521028,1476,0
38012,1280,232,243136,1048,0
38025,1829,353,521028,1476,0
38044,1411,281,317530,1130,0
38045,227,44,8052,183,0
38048,497,97,38800,400,0
38060,1078,198,174240,880,0
38089,1552,299,374647,1253,0
38124,821,171,111150,650,0
38127,1262,259,259777,1003,0
38134,539,101,44238,438,0
38139,950,193,146101,757,0
38142,819,152,101384,667,0
38149,194,39,6045,155,0
38150,1552,299,374647,1253,0
38156,31,8,184,23,0
38162,1296,252,263088,1044,0
38180,1583,310,394630,1273,0
38185,535,94,41454,441,0
38210,1934,345,548205,1589,0
38213,365,74,21534,291,0
38265,714,137,79049,577,0
38284,1558,313,389685,1245,0
38287,595,121,57354,474,0
38304,2102,402,683400,1700,0
38329,971,184,144808,787,0
38330,1342,282,298920,1060,0
38336,346,76,20520,270,0
38379,324,67,17219,257,0
38380,495,87,35496,408,0
38390,821,171,111150,650,0
38402,641,131,66810,510,0
38403,497,97,38800,400,0
38409,44,10,340,34,0
38410,401,77,24948,324,0
38417,771,137,86858,634,0
38433,1411,281,317530,1130,0
38445,346,76,20520,270,0
38481,62,16,736,46,0
38497,714,137,79049,577,0
38501,1331,255,274380,1076,0
38505,217,44,7612,173,0
38529,2102,402,683400,1700,0
38536,1331,255,274380,1076,0
38555,14,3,33,11,0
38560,1025,201,165624,824,0
38583,155,34,4114,121,0
38591,443,85,30430,358,0
38612,305,70,16450,235,0
38622,771,137,86858,634,0
38624,124,28,2688,96,0
38629,1934,345,548205,1589,0
38652,595,121,57354,474,0
38660,1934,345,548205,1589,0
38682,714,137,79049,577,0
38692,836,151,103435,685,0
38694,366,70,20720,296,0
38698,405,82,26486,323,0
38711,174,36,4968,138,0
38716,156,34,4148,122,0
38717,700,128,73216,572,0
38746,1296,252,263088,1044,0
38755,2102,402,683400,1700,0
38760,33,7,182,26,0
38773,317,63,16002,254,0
38826,767,144,89712,623,0
38830,548,102,45492,446,0
38838,1552,299,374647,1253,0
38851,572,130,57460,442,0
38855,1876,359,544603,1517,0
38868,976,180,143280,796,0
38874,950,193,146101,757,0
38883,119,25,2350,94,0
38886,1876,359,544603,1517,0
38892,1876,359,544603,1517,0
38906,25,3,66,22,0
38910,771,137,86858,634,0
38944,395,72,23256,323,0
38945,324,67,17219,257,0
38947,1657,315,422730,1342,0
38948,61,14,658,47,0
38956,9,1,8,8,0
38968,1552,299,374647,1253,0
38981,1078,198,174240,880,0
39010,1934,345,548205,1589,0
39019,950,193,146101,757,0
39037,1411,281,317530,1130,0
39046,548,102,45492,446,0
39054,1876,359,544603,1517,0
39063,1181,246,230010,935,0
39087,1411,281,317530,1130,0
39089,595,121,57354,474,0
39100,821,171,111150,650,0
39103,1411,281,317530,1130,0
39111,1583,310,394630,1273,0
39123,1552,299,374647,1253,0
39124,1583,310,394630,1273,0
39132,497,97,38800,400,0
39151,69,14,770,55,0
39155,135,30,3150,105,0
39159,1078,198,174240,880,0
39167,362,69,20217,293,0
39205,40,9,279,31,0
39228,174,36,4968,138,0
39230,595,121,57354,474,0
39241,1558,313,389685,1245,0
39248,148,24,2976,124,0
39275,821,171,111150,650,0
39278,1583,310,394630,1273,0
39281,1876,359,544603,1517,0
39295,1829,353,521028,1476,0
39330,552,113,49607,439,0
39349,1181,246,230010,935,0
39350,1280,232,243136,1048,0
39371,85,18,1206,67,0
39375,1331,255,274380,1076,0
39387,1934,345,548205,1589,0
39410,865,167,116566,698,0
39414,2102,402,683400,1700,0
39417,1411,281,317530,1130,0
39419,1078,198,174240,880,0
39424,821,171,111150,650,0
39456,819,152,101384,667,0
39470,1296,252,263088,1044,0
39474,535,94,41454,441,0
39480,1876,359,544603,1517,0
39483,836,151,103435,685,0
39498,52,10,420,42,0
39534,32,6,156,26,0
39564,2102,402,683400,1700,0
39574,315,56,14504,259,0
39575,714,137,79049,577,0
39597,273,58,12470,215,0
39601,1552,299,374647,1253,0
39621,362,69,20217,293,0
39625,620,121,60379,499,0
39626,1876,359,544603,1517,0
39634,1552,299,374647,1253,0
39636,200,40,6400,160,0
39668,323,55,14740,268,0
39682,44,10,340,34,0
39705,1411,281,317530,1130,0
39730,1657,315,422730,1342,0
39747,1280,232,243136,1048,0
39750,193,39,6006,154,0
39773,571,114,52098,457,0
39775,2102,402,683400,1700,0
39777,1583,310,394630,1273,0
39799,548,102,45492,446,0
39810,164,34,4420,130,0
39824,135,30,3150,105,0
39828,1331,255,274380,1076,0
39831,1280,232,243136,1048,0
39866,767,144,89712,623,0
39868,25,5,100,20,0
39880,155,35,4200,120,0
39906,932,168,128352,764,0
39922,366,70,20720,296,0
39928,198,43,6665,155,0
39939,105,15,1350,90,0
39968,1829,353,521028,1476,0
39988,1296,252,263088,1044,0
40012,1078,198,174240,880,0
40016,1204,251,239203,953,0
40027,1552,299,374647,1253,0
40031,778,163,100245,615,0
40064,1657,315,422730,1342,0
40066,1876,359,544603,1517,0
40075,1181,246,230010,935,0
40078,568,114,51756,454,0
40086,700,128,73216,572,0
40096,1583,310,394630,1273,0
40108,264,56,11648,208,0
40111,380,76,23104,304,0
40115,321,54,14418,267,0
40116,186,35,5285,151,0
40129,164,34,4420,130,0
40135,207,41,6806,166,0
40136,61,7,378,54,0
40145,113,24,2136,89,0
40148,660,133,69928,527,0
40152,47,8,312,39,0
40159,548,102,45492,446,0
40160,1583,310,394630,1273,0
40189,1541,306,377910,1235,0
40190,971,184,144808,787,0
40203,2102,402,683400,1700,0
40225,380,76,23104,304,0
40246,36,6,180,30,0
40256,1558,313,389685,1245,0
40266,1331,255,274380,1076,0
40274,62,16,736,46,0
40300,620,121,60379,499,0
40331,1583,310,394630,1273,0
40343,1583,310,394630,1273,0
40354,379,65,20410,314,0
40359,17,4,52,13,0
40362,778,163,100245,615,0
40379,379,65,20410,314,0
40386,819,152,101384,667,0
40389,1558,313,389685,1245,0
40391,198,43,6665,155,0
40395,971,184,144808,787,0
40428,48,10,380,38,0
40459,61,11,550,50,0
40466,535,94,41454,441,0
40473,346,76,20520,270,0
40478,1558,313,389685,1245,0
40487,1296,252,263088,1044,0
40498,405,82,26486,323,0
40504,105,15,1350,90,0
40523,134,30,3120,104,0
40562,2102,402,683400,1700,0
40565,1657,315,422730,1342,0
40604,620,121,60379,499,0
40606,641,131,66810,510,0
40614,198,43,6665,155,0
40631,20,3,51,17,0
40643,700,128,73216,572,0
40647,146,34,3808,112,0
40652,1583,310,394630,1273,0
40660,1296,252,263088,1044,0
40664,865,167,116566,698,0
40684,1876,359,544603,1517,0
40699,535,94,41454,441,0
40702,156,34,4148,122,0
40716,714,137,79049,577,0
40727,1541,306,377910,1235,0
40742,72,14,812,58,0
40749,23,2,42,21,0
40754,1296,252,263088,1044,0
40756,1558,313,389685,1245,0
40831,102,20,1640,82,0
40834,1411,281,317530,1130,0
40841,778,163,100245,615,0
40860,595,121,57354,474,0
40861,385,71,22294,314,0
40876,595,121,57354,474,0
40878,932,168,128352,764,0
40886,443,85,30430,358,0
40888,700,128,73216,572,0
40904,1558,313,389685,1245,0
40909,315,56,14504,259,0
40922,21,6,90,15,0
40928,714,137,79049,577,0
40934,1583,310,394630,1273,0
40944,865,167,116566,698,0
40953,1583,310,394630,1273,0
40961,620,121,60379,499,0
40979,1541,306,377910,1235,0
40984,1558,313,389685,1245,0
40998,767,144,89712,623,0
41001,366,70,20720,296,0
41014,595,120,57000,475,0
41022,1552,299,374647,1253,0
41028,49,9,360,40,0
41033,976,180,143280,796,0
41036,595,120,57000,475,0
41045,1078,198,174240,880,0
41049,1583,310,394630,1273,0
41055,865,167,116566,698,0
41073,1552,299,374647,1253,0
41093,1876,359,544603,1517,0
41112,14,3,33,11,0
41115,821,171,111150,650,0
41117,971,184,144808,787,0
41137,1204,251,239203,953,0
41151,778,163,100245,615,0
41174,415,75,25500,340,0
41191,793,158,100330,635,0
41193,1411,281,317530,1130,0
41201,1331,255,274380,1076,0
41217,2102,402,683400,1700,0
41226,401,77,24948,324,0
41229,950,193,146101,757,0
41233,1342,282,298920,1060,0
41235,410,76,25384,334,0
41245,236,50,9300,186,0
41258,77,19,1102,58,0
41259,1296,252,263088,1044,0
41267,971,184,144808,787,0
41281,660,133,69928,527,0
41289,1552,299,374647,1253,0
41305,1657,315,422730,1342,0
41311,315,56,14504,259,0
41343,568,114,51756,454,0
41354,595,120,57000,475,0
41366,380,76,23104,304,0
41375,23,6,102,17,0
41403,568,114,51756,454,0
41414,778,163,100245,615,0
41417,324,67,17219,257,0
41430,976,180,143280,796,0
41431,25,5,100,20,0
41438,1411,281,317530,1130,0
41464,1342,282,298920,1060,0
41466,950,193,146101,757,0
41482,60,12,576,48,0
41503,321,54,14418,267,0
41515,227,44,8052,183,0
41523,971,184,144808,787,0
41525,1280,232,243136,1048,0
41536,27,3,72,24,0
41538,1541,306,377910,1235,0
41547,1296,252,263088,1044,0
41557,463,83,31540,380,0
41565,932,168,128352,764,0
41578,571,114,52098,457,0
41583,950,193,146101,757,0
41587,1552,299,374647,1253,0
41607,1583,310,394630,1273,0
41609,1583,310,394630,1273,0
41617,315,56,14504,259,0
41645,595,121,57354,474,0
41647,1934,345,548205,1589,0
41650,516,103,42539,413,0
41665,1204,251,239203,953,0
41667,274,57,12369,217,0
41671,1296,252,263088,1044,0
41676,2102,402,683400,1700,0
41679,821,171,111150,650,0
41683,305,70,16450,235,0
41684,1876,359,544603,1517,0
41701,34,7,189,27,0
41707,1078,198,174240,880,0
41711,1558,313,389685,1245,0
41712,317,63,16002,254,0
41725,2102,402,683400,1700,0
41726,207,41,6806,166,0
41732,227,44,8052,183,0
41737,1657,315,422730,1342,0
41741,539,101,44238,438,0
41749,950,193,146101,757,0
41756,1204,251,239203,953,0
41758,23,6,102,17,0
41770,236,50,9300,186,0
41786,7,1,6,6,0
41788,535,94,41454,441,0
41805,1583,310,394630,1273,0
41823,1025,201,165624,824,0
41836,34,7,189,27,0
41841,107,19,1672,88,0
41842,950,193,146101,757,0
41844,323,55,14740,268,0
41876,595,121,57354,474,0
41888,415,75,25500,340,0
41891,1876,359,544603,1517,0
41895,950,193,146101,757,0
41910,516,103,42539,413,0
41911,1558,313,389685,1245,0
41915,2102,402,683400,1700,0
41937,207,41,6806,166,0
41945,568,114,51756,454,0
41955,2102,402,683400,1700,0
41957,572,130,57460,442,0
41958,395,72,23256,323,0
41969,497,97,38800,400,0
41973,2102,402,683400,1700,0
41983,137,25,2800,112,0
41985,108,17,1547,91,0
41988,69,12,684,57,0
42007,58,11,517,47,0
42017,1934,345,548205,1589,0
42019,571,114,52098,457,0
42021,324,67,17219,257,0
42027,64,16,768,48,0
42037,971,184,144808,787,0
42040,395,72,23256,323,0
42050,463,83,31540,380,0
42071,52,10,420,42,0
42075,1552,299,374647,1253,0
42083,48,10,380,38,0
42096,1411,281,317530,1130,0
42105,1657,315,422730,1342,0
42107,65,17,816,48,0
42108,135,30,3150,105,0
42113,1583,310,394630,1273,0
42120,1025,201,165624,824,0
42130,595,121,57354,474,0
42140,1078,198,174240,880,0
42151,273,58,12470,215,0
42165,463,83,31540,380,0
42171,976,180,143280,796,0
42181,1558,313,389685,1245,0
42197,1829,353,521028,1476,0
42222,75,19,1064,56,0
42234,821,143,96954,678,0
42240,65,13,676,52,0
42249,1583,310,394630,1273,0
42283,1657,315,422730,1342,0
42300,1829,353,521028,1476,0
42306,539,101,44238,438,0
42316,516,103,42539,413,0
42324,552,113,49607,439,0
42331,1558,313,389685,1245,0
42338,1829,353,521028,1476,0
42340,164,34,4420,130,0
42345,305,70,16450,235,0
42372,551,102,45798,449,0
42394,976,180,143280,796,0
42419,535,94,41454,441,0
42427,61,14,658,47,0
42434,821,143,96954,678,0
42443,1262,259,259777,1003,0
42448,821,171,111150,650,0
42458,395,72,23256,323,0
42467,1411,281,317530,1130,0
42469,1583,310,394630,1273,0
42490,1078,198,174240,880,0
42503,1558,313,389685,1245,0
42515,1280,232,243136,1048,0
42530,1934,345,548205,1589,0
42559,14,3,33,11,0
42565,35,5,150,30,0
42587,88,17,1207,71,0
42593,1541,306,377910,1235,0
42598,1552,299,374647,1253,0
42600,1829,353,521028,1476,0
42603,37,10,270,27,0
42610,552,113,49607,439,0
42623,1558,313,389685,1245,0
42628,324,67,17219,257,0
42631,516,103,42539,413,0
42634,108,17,1547,91,0
42657,1558,313,389685,1245,0
42663,1078,198,174240,880,0
42670,497,97,38800,400,0
42678,1876,359,544603,1517,0
42679,217,44,7612,173,0
42695,1280,232,243136,1048,0
42711,32,5,135,27,0
42719,366,70,20720,296,0
42720,198,43,6665,155,0
42726,778,163,100245,615,0
42749,1829,353,521028,1476,0
42769,119,25,2350,94,0
42785,315,56,14504,259,0
42786,971,184,144808,787,0
42799,976,180,143280,796,0
42804,264,56,11648,208,0
42808,443,85,30430,358,0
42812,366,70,20720,296,0
42819,1280,232,243136,1048,0
42825,1829,353,521028,1476,0
42835,535,94,41454,441,0
42843,1078,198,174240,880,0
42846,1934,345,548205,1589,0
42851,836,151,103435,685,0
42854,463,83,31540,380,0
42870,160,29,3799,131,0
42893,200,40,6400,160,0
42926,1876,359,544603,1517,0
42927,1280,232,243136,1048,0
42941,1411,281,317530,1130,0
42950,971,184,144808,787,0
42951,539,101,44238,438,0
42956,595,121,57354,474,0
42963,714,137,79049,577,0
42970,821,143,96954,678,0
42981,539,101,44238,438,0
42985,1411,281,317530,1130,0
42998,1583,310,394630,1273,0
43026,64,16,768,48,0
43048,821,171,111150,650,0
43062,771,137,86858,634,0
43071,1262,259,259777,1003,0
43073,976,180,143280,796,0
43085,539,101,44238,438,0
43086,535,94,41454,441,0
43096,101,20,1620,81,0
43100,1829,353,521028,1476,0
43103,1657,315,422730,1342,0
43105,1552,299,374647,1253,0
43122,865,167,116566,698,0
43134,102,20,1640,82,0
43162,1280,232,243136,1048,0
43164,60,12,576,48,0
43176,568,114,51756,454,0
43187,47,8,312,39,0
43188,821,143,96954,678,0
43202,1934,345,548205,1589,0
43215,1331,255,274380,1076,0
43223,1934,345,548205,1589,0
43229,2102,402,683400,1700,0
43232,1204,251,239203,953,0
43234,1541,306,377910,1235,0
43238,539,101,44238,438,0
43260,2102,402,683400,1700,0
43271,227,44,8052,183,0
43275,463,83,31540,380,0
43278,463,83,31540,380,0
43294,1296,252,263088,1044,0
43308,373,74,22126,299,0
43309,767,144,89712,623,0
43311,793,158,100330,635,0
43329,27,4,92,23,0
43331,821,171,111150,650,0
43339,1552,299,374647,1253,0
43363,1541,306,377910,1235,0
43377,252,45,9315,207,0
43424,932,168,128352,764,0
43433,1078,198,174240,880,0
43437,443,85,30430,358,0
43442,571,114,52098,457,0
43446,337,74,19462,263,0
43461,346,76,20520,270,0
43464,1342,282,298920,1060,0
43470,539,101,44238,438,0
43473,1934,345,548205,1589,0
43489,1342,282,298920,1060,0
43495,60,12,576,48,0
43500,1280,232,243136,1048,0
43511,160,32,4096,128,0
43514,46,9,333,37,0
43528,1934,345,548205,1589,0
43529,620,121,60379,499,0
43532,252,45,9315,207,0
43536,1657,315,422730,1342,0
43554,950,193,146101,757,0
43559,568,114,51756,454,0
43568,1583,310,394630,1273,0
43588,20,3,51,17,0
43612,105,22,1826,83,0
43615,865,167,116566,698,0
43622,1296,252,263088,1044,0
43629,1181,246,230010,935,0
43640,366,70,20720,296,0
43653,1876,359,544603,1517,0
43660,497,97,38800,400,0
43685,950,193,146101,757,0
43688,1181,246,230010,935,0
43689,971,184,144808,787,0
43707,71,15,840,56,0
43716,819,152,101384,667,0
43729,360,66,19404,294,0
43745,819,152,101384,667,0
43765,2102,402,683400,1700,0
43780,324,67,17219,257,0
43785,1552,299,374647,1253,0
43796,410,76,25384,334,0
43797,324,67,17219,257,0
43805,2102,402,683400,1700,0
43821,771,137,86858,634,0
43822,1876,359,544603,1517,0
43854,415,75,25500,340,0
43878,1204,251,239203,953,0
43879,1296,252,263088,1044,0
43893,535,94,41454,441,0
43902,463,83,31540,380,0
43909,1934,345,548205,1589,0
43915,1934,345,548205,1589,0
43924,1296,252,263088,1044,0
43930,819,152,101384,667,0
43940,401,77,24948,324,0
43969,572,130,57460,442,0
43976,1876,359,544603,1517,0
43986,362,69,20217,293,0
44002,1280,232,243136,1048,0
44004,16,4,48,12,0
44009,1829,353,521028,1476,0
44030,1181,246,230010,935,0
44058,105,22,1826,83,0
44074,551,102,45798,449,0
44112,700,128,73216,572,0
44125,778,163,100245,615,0
44141,395,72,23256,323,0
44142,641,131,66810,510,0
44153,1541,306,377910,1235,0
44158,793,158,100330,635,0
44166,77,19,1102,58,0
44167,1934,345,548205,1589,0
44193,274,57,12369,217,0
44198,1078,198,174240,880,0
44200,571,114,52098,457,0
44206,1342,282,298920,1060,0
44209,836,151,103435,685,0
44217,1411,281,317530,1130,0
44234,950,193,146101,757,0
44235,535,94,41454,441,0
44237,315,56,14504,259,0
44285,264,56,11648,208,0
44319,1934,345,548205,1589,0
44320,571,114,52098,457,0
44359,366,70,20720,296,0
44360,1342,282,298920,1060,0
44361,415,75,25500,340,0
44364,539,101,44238,438,0
44366,401,77,24948,324,0
44368,160,29,3799,131,0
44371,362,69,20217,293,0
44392,1204,251,239203,953,0
44399,976,180,143280,796,0
44448,836,151,103435,685,0
44461,1181,246,230010,935,0
44466,175,29,4234,146,0
44477,22,6,96,16,0
44478,346,76,20520,270,0
44487,1558,313,389685,1245,0
44494,1657,315,422730,1342,0
44495,160,29,3799,131,0
44498,516,103,42539,413,0
44499,1558,313,389685,1245,0
44509,315,56,14504,259,0
44517,112,18,1692,94,0
44523,395,72,23256,323,0
44539,2102,402,683400,1700,0
44560,1876,359,544603,1517,0
44567,1829,353,521028,1476,0
44587,274,57,12369,217,0
44615,1181,246,230010,935,0
44629,2102,402,683400,1700,0
44687,551,102,45798,449,0
44744,971,184,144808,787,0
44751,1876,359,544603,1517,0
44759,108,17,1547,91,0
44765,41,8,264,33,0
44791,1657,315,422730,1342,0
44802,346,76,20520,270,0
44804,516,103,42539,413,0
44818,595,121,57354,474,0
44832,836,151,103435,685,0
44846,793,158,100330,635,0
44855,865,167,116566,698,0
44871,771,137,86858,634,0
44881,1934,345,548205,1589,0
44896,552,113,49607,439,0
44931,305,70,16450,235,0
44932,463,83,31540,380,0
44966,1541,306,377910,1235,0
44969,821,171,111150,650,0
44990,252,45,9315,207,0
44997,120,24,2304,96,0
44998,1876,359,544603,1517,0
45008,1204,251,239203,953,0
45011,1262,259,259777,1003,0
45018,771,137,86858,634,0
45020,1876,359,544603,1517,0
45028,1181,246,230010,935,0
45036,160,29,3799,131,0
45037,1934,345,548205,1589,0
45048,1204,251,239203,953,0
45050,778,163,100245,615,0
45069,385,71,22294,314,0
45079,1829,353,521028,1476,0
45103,821,143,96954,678,0
45125,1583,310,394630,1273,0
45141,1876,359,544603,1517,0
45145,1934,345,548205,1589,0
45152,366,70,20720,296,0
45160,821,143,96954,678,0
45161,194,39,6045,155,0
45182,463,83,31540,380,0
45183,976,180,143280,796,0
45186,1411,281,317530,1130,0
45192,700,128,73216,572,0
45206,1541,306,377910,1235,0
45207,1657,315,422730,1342,0
45210,337,74,19462,263,0
45239,2102,402,683400,1700,0
45242,793,158,100330,635,0
45245,1342,282,298920,1060,0
45247,323,55,14740,268,0
45249,1829,353,521028,1476,0
45250,793,158,100330,635,0
45251,274,57,12369,217,0
45253,1181,246,230010,935,0
45259,217,44,7612,173,0
45274,1411,281,317530,1130,0
45278,950,193,146101,757,0
45279,61,11,550,50,0
45294,534,102,44064,432,0
45300,1181,246,230010,935,0
45306,58,15,645,43,0
45311,35,6,174,29,0
45312,1025,201,165624,824,0
45343,1541,306,377910,1235,0
45346,1204,251,239203,953,0
45351,185,36,5364,149,0
45358,317,63,16002,254,0
45383,1296,252,263088,1044,0
45386,950,193,146101,757,0
45387,323,55,14740,268,0
45418,1025,201,165624,824,0
45502,13,3,30,10,0
45533,5,1,4,4,0
45534,1558,313,389685,1245,0
45550,950,193,146101,757,0
45556,380,76,23104,304,0
45559,131,25,2650,106,0
45561,778,163,100245,615,0
45564,1262,259,259777,1003,0
45568,1296,252,263088,1044,0
45595,207,41,6806,166,0
45597,146,34,3808,112,0
45602,1829,353,521028,1476,0
45606,568,114,51756,454,0
45620,1181,246,230010,935,0
45632,131,25,2650,106,0
45636,497,97,38800,400,0
45637,1296,252,263088,1044,0
45641,1262,259,259777,1003,0
45667,1078,198,174240,880,0
45671,771,137,86858,634,0
45706,105,16,1424,89,0
45712,1025,201,165624,824,0
45720,1411,281,317530,1130,0
45725,2102,402,683400,1700,0
45732,1934,345,548205,1589,0
45736,497,97,38800,400,0
45740,198,43,6665,155,0
45761,54,14,560,40,0
45804,2102,402,683400,1700,0
45809,185,36,5364,149,0
45812,539,101,44238,438,0
45814,113,24,2136,89,0
45817,932,168,128352,764,0
45828,380,76,23104,304,0
45887,821,143,96954,678,0
45914,305,70,16450,235,0
45947,65,17,816,48,0
45950,1342,282,298920,1060,0
45954,1583,310,394630,1273,0
45955,2102,402,683400,1700,0
45981,443,85,30430,358,0
45988,620,121,60379,499,0
46001,1025,201,165624,824,0
46008,568,114,51756,454,0
46009,105,16,1424,89,0
46011,1657,315,422730,1342,0
46017,516,103,42539,413,0
46027,568,114,51756,454,0
46032,551,102,45798,449,0
46042,572,130,57460,442,0
46058,495,87,35496,408,0
46062,1876,359,544603,1517,0
46068,337,74,19462,263,0
46075,660,133,69928,527,0
46088,767,144,89712,623,0
46108,836,151,103435,685,0
46118,571,114,52098,457,0
46119,1583,310,394630,1273,0
46127,1583,310,394630,1273,0
46129,1262,259,259777,1003,0
46137,1181,246,230010,935,0
46138,1552,299,374647,1253,0
46139,950,193,146101,757,0
46142,1181,246,230010,935,0
46148,1262,259,259777,1003,0
46161,31,10,210,21,0
46170,641,131,66810,510,0
46174,620,121,60379,499,0
46193,1204,251,239203,953,0
46228,1342,282,298920,1060,0
46229,767,144,89712,623,0
46240,1262,259,259777,1003,0
46253,323,55,14740,268,0
46254,131,25,2650,106,0
46259,659,132,69928,527,0
46268,1181,246,230010,935,0
46270,714,137,79049,577,0
46276,497,97,38800,400,0
46286,193,39,6006,154,0
46295,595,121,57354,474,0
46301,105,22,1826,83,0
46313,1331,255,274380,1076,0
46320,568,114,51756,454,0
46321,227,44,8052,183,0
46337,2102,402,683400,1700,0
46341,360,66,19404,294,0
46348,200,40,6400,160,0
46363,1934,345,548205,1589,0
46371,819,152,101384,667,0
46372,1552,299,374647,1253,0
46378,767,144,89712,623,0
46384,1280,232,243136,1048,0
46435,1204,251,239203,953,0
46452,174,36,4968,138,0
46456,548,102,45492,446,0
46465,264,56,11648,208,0
46470,595,120,57000,475,0
46511,2102,402,683400,1700,0
46524,385,71,22294,314,0
46530,185,36,5364,149,0
46531,767,144,89712,623,0
46545,641,131,66810,510,0
46553,1558,313,389685,1245,0
46558,405,82,26486,323,0
46569,620,121,60379,499,0
46570,1541,306,377910,1235,0
46582,1552,299,374647,1253,0
46593,1204,251,239203,953,0
46605,1552,299,374647,1253,0
46607,950,193,146101,757,0
46624,1541,306,377910,1235,0
46630,1262,259,259777,1003,0
46635,1280,232,243136,1048,0
46662,1552,299,374647,1253,0
46665,976,180,143280,796,0
46666,61,14,658,47,0
46672,595,121,57354,474,0
46687,61,13,624,48,0
46700,865,167,116566,698,0
46710,64,15,735,49,0
46717,1876,359,544603,1517,0
46748,1657,315,422730,1342,0
46750,660,133,69928,527,0
46761,932,168,128352,764,0
46793,1411,281,317530,1130,0
46803,362,69,20217,293,0
46804,366,70,20720,296,0
46815,1280,232,243136,1048,0
46848,660,133,69928,527,0
46855,463,83,31540,380,0
46862,819,152,101384,667,0
46863,552,113,49607,439,0
46870,1558,313,389685,1245,0
46907,193,39,6006,154,0
46909,282,50,11600,232,0
46912,88,17,1207,71,0
46961,572,130,57460,442,0
46967,21,4,68,17,0
46970,463,83,31540,380,0
46973,1296,252,263088,1044,0
46984,1331,255,274380,1076,0
46989,2102,402,683400,1700,0
46996,1558,313,389685,1245,0
47002,1829,353,521028,1476,0
47007,793,158,100330,635,0
47019,61,8,424,53,0
47039,1181,246,230010,935,0
47043,1657,315,422730,1342,0
47055,1280,232,243136,1048,0
47088,24,6,108,18,0
47093,700,128,73216,572,0
47100,1552,299,374647,1253,0
47111,595,121,57354,474,0
47135,362,69,20217,293,0
47170,821,171,111150,650,0
47172,185,36,5364,149,0
47173,1342,282,298920,1060,0
47176,976,180,143280,796,0
47182,595,120,57000,475,0
47188,70,15,825,55,0
47193,714,137,79049,577,0
47198,821,171,111150,650,0
47199,1181,246,230010,935,0
47202,1025,201,165624,824,0
47211,700,128,73216,572,0
47226,1657,315,422730,1342,0
47227,771,137,86858,634,0
47241,950,193,146101,757,0
47256,186,35,5285,151,0
47280,410,76,25384,334,0
47299,1583,310,394630,1273,0
47301,595,120,57000,475,0
47319,1181,246,230010,935,0
47322,1331,255,274380,1076,0
47349,207,41,6806,166,0
47353,767,144,89712,623,0
47371,1342,282,298920,1060,0
47383,1876,359,544603,1517,0
47394,124,28,2688,96,0
47400,1583,310,394630,1273,0
47408,12,3,27,9,0
47432,18,3,45,15,0
47456,1657,315,422730,1342,0
47500,443,85,30430,358,0
47515,405,82,26486,323,0
47519,119,22,2134,97,0
47526,24,6,108,18,0
47531,950,193,146101,757,0
47540,1541,306,377910,1235,0
47562,1078,198,174240,880,0
47567,1657,315,422730,1342,0
47585,1025,201,165624,824,0
47596,207,41,6806,166,0
47626,1331,255,274380,1076,0
47627,1280,232,243136,1048,0
47628,1583,310,394630,1273,0
47636,535,94,41454,441,0
47641,821,171,111150,650,0
47663,77,17,1020,60,0
47664,771,137,86858,634,0
47670,572,130,57460,442,0
47698,571,114,52098,457,0
47699,1411,281,317530,1130,0
47700,155,34,4114,121,0
47709,61,7,378,54,0
47720,2102,402,683400,1700,0
47735,146,34,3808,112,0
47741,185,36,5364,149,0
47748,185,36,5364,149,0
47753,324,67,17219,257,0
47757,932,168,128352,764,0
47761,1876,359,544603,1517,0
47774,1342,282,298920,1060,0
47783,379,65,20410,314,0
47791,551,102,45798,449,0
47828,405,82,26486,323,0
47836,1204,251,239203,953,0
47850,595,121,57354,474,0
47862,1296,252,263088,1044,0
47870,1552,299,374647,1253,0
47877,1657,315,422730,1342,0
47906,595,121,57354,474,0
47908,56,13,559,43,0
47912,315,56,14504,259,0
47916,1262,259,259777,1003,0
47947,1262,259,259777,1003,0
47953,1280,232,243136,1048,0
47960,145,23,2806,122,0
47971,379,65,20410,314,0
47984,2102,402,683400,1700,0
47992,31,8,184,23,0
47996,793,158,100330,635,0
47997,415,75,25500,340,0
48006,821,143,96954,678,0
48018,193,39,6006,154,0
48020,1025,201,165624,824,0
48029,315,56,14504,259,0
48075,971,184,144808,787,0
48076,174,36,4968,138,0
48084,641,131,66810,510,0
48095,1541,306,377910,1235,0
48107,305,70,16450,235,0
48118,1280,232,243136,1048,0
48123,410,76,25384,334,0
48149,1411,281,317530,1130,0
48159,1541,306,377910,1235,0
48160,1541,306,377910,1235,0
48163,252,45,9315,207,0
48173,227,44,8052,183,0
48175,1558,313,389685,1245,0
48183,976,180,143280,796,0
48185,1025,201,165624,824,0
48209,865,167,116566,698,0
48224,11,2,18,9,0
48239,793,158,100330,635,0
48243,52,11,451,41,0
48248,950,193,146101,757,0
48253,337,74,19462,263,0
48262,1657,315,422730,1342,0
48272,1541,306,377910,1235,0
48286,620,121,60379,499,0
48296,198,43,6665,155,0
48305,548,102,45492,446,0
48317,373,74,22126,299,0
48341,1025,201,165624,824,0
48343,395,72,23256,323,0
48348,2102,402,683400,1700,0
48430,1331,255,274380,1076,0
48441,572,130,57460,442,0
48449,1583,310,394630,1273,0
48456,1829,353,521028,1476,0
48462,1583,310,394630,1273,0
48464,122,20,2040,102,0
48468,160,32,4096,128,0
48479,1262,259,259777,1003,0
48508,463,83,31540,380,0
48514,1181,246,230010,935,0
48532,821,171,111150,650,0
48534,11,2,18,9,0
48537,548,102,45492,446,0
48552,37,11,286,26,0
48553,1541,306,377910,1235,0
48578,1331,255,274380,1076,0
48583,1078,198,174240,880,0
48593,620,121,60379,499,0
48596,1262,259,259777,1003,0
48616,273,58,12470,215,0
48622,1280,232,243136,1048,0
48650,1204,251,239203,953,0
48653,1541,306,377910,1235,0
48665,1181,246,230010,935,0
48683,120,24,2304,96,0
48691,185,36,5364,149,0
48702,1552,299,374647,1253,0
48707,1541,306,377910,1235,0
48737,819,152,101384,667,0
48747,1296,252,263088,1044,0
48749,572,130,57460,442,0
48750,264,56,11648,208,0
48755,1934,345,548205,1589,0
48760,274,57,12369,217,0
48792,1331,255,274380,1076,0
48801,539,101,44238,438,0
48821,105,15,1350,90,0
48838,1280,232,243136,1048,0
48845,1280,232,243136,1048,0
48856,1876,359,544603,1517,0
48861,976,180,143280,796,0
48863,164,34,4420,130,0
48868,1583,310,394630,1273,0
48871,1262,259,259777,1003,0
48884,1829,353,521028,1476,0
48891,1657,315,422730,1342,0
48894,516,103,42539,413,0
48898,971,184,144808,787,0
48912,836,151,103435,685,0
48937,146,34,3808,112,0
48947,1541,306,377910,1235,0
48963,1541,306,377910,1235,0
48968,1657,315,422730,1342,0
48989,463,83,31540,380,0
48990,113,20,1860,93,0
48994,27,5,110,22,0
49006,1552,299,374647,1253,0
49023,463,83,31540,380,0
49033,113,20,1860,93,0
49055,568,114,51756,454,0
49068,950,193,146101,757,0
49091,236,50,9300,186,0
49093,821,171,111150,650,0
49103,1025,201,165624,824,0
49130,595,121,57354,474,0
49145,385,71,22294,314,0
49155,821,143,96954,678,0
49158,865,167,116566,698,0
49160,700,128,73216,572,0
49165,2102,402,683400,1700,0
49167,821,171,111150,650,0
49175,932,168,128352,764,0
49179,227,44,8052,183,0
49181,365,74,21534,291,0
49197,836,151,103435,685,0
49198,1541,306,377910,1235,0
49206,1558,313,389685,1245,0
49208,68,14,756,54,0
49210,1876,359,544603,1517,0
49225,69,12,684,57,0
49228,1657,315,422730,1342,0
49231,1331,255,274380,1076,0
49235,932,168,128352,764,0
49248,137,25,2800,112,0
49256,767,144,89712,623,0
49279,552,113,49607,439,0
49283,321,54,14418,267,0
49293,1296,252,263088,1044,0
49299,175,29,4234,146,0
49302,1331,255,274380,1076,0
49305,700,128,73216,572,0
49306,551,102,45798,449,0
49308,865,167,116566,698,0
49387,1342,282,298920,1060,0
49390,700,128,73216,572,0
49397,20,4,64,16,0
49430,497,97,38800,400,0
49467,1078,198,174240,880,0
49474,175,29,4234,146,0
49489,61,11,550,50,0
49495,1829,353,521028,1476,0
49499,1342,282,298920,1060,0
49515,793,158,100330,635,0
49527,380,76,23104,304,0
49529,976,180,143280,796,0
49536,443,85,30430,358,0
49537,1552,299,374647,1253,0
49538,535,94,41454,441,0
49548,572,130,57460,442,0
49578,976,180,143280,796,0
49580,1025,201,165624,824,0
49597,1204,251,239203,953,0
49608,1876,359,544603,1517,0
49614,1411,281,317530,1130,0
49655,135,30,3150,105,0
49656,1934,345,548205,1589,0
49658,1342,282,298920,1060,0
49661,552,113,49607,439,0
49662,1331,255,274380,1076,0
49672,1262,259,259777,1003,0
49694,932,168,128352,764,0
49695,976,180,143280,796,0
49719,2102,402,683400,1700,0
49751,1342,282,298920,1060,0
49778,1934,345,548205,1589,0
49783,1583,310,394630,1273,0
49796,1262,259,259777,1003,0
49803,107,19,1672,88,0
49840,620,121,60379,499,0
49847,324,67,17219,257,0
49858,1829,353,521028,1476,0
49870,767,144,89712,623,0
49873,324,67,17219,257,0
49882,971,184,144808,787,0
49906,315,56,14504,259,0
49923,1296,252,263088,1044,0
49948,37,11,286,26,0
49950,72,13,767,59,0
49983,1296,252,263088,1044,0
49984,107,19,1672,88,0
49994,64,16,768,48,0
50001,572,130,57460,442,0
50029,185,36,5364,149,0
50030,552,113,49607,439,0
50031,207,41,6806,166,0
50037,1296,252,263088,1044,0
50064,264,56,11648,208,0
50116,16,3,39,13,0
50123,380,76,23104,304,0
50126,274,57,12369,217,0
50138,57,7,350,50,0
50172,385,71,22294,314,0
50192,1829,353,521028,1476,0
50223,366,70,20720,296,0
50239,41,8,264,33,0
50246,821,143,96954,678,0
50255,135,30,3150,105,0
50261,950,193,146101,757,0
50271,821,171,111150,650,0
50272,1262,259,259777,1003,0
50275,932,168,128352,764,0
50293,552,113,49607,439,0
50309,1583,310,394630,1273,0
50316,52,11,451,41,0
50324,380,76,23104,304,0
50346,1552,299,374647,1253,0
50358,497,97,38800,400,0
50360,1342,282,298920,1060,0
50365,1829,353,521028,1476,0
50374,1181,246,230010,935,0
50391,1583,310,394630,1273,0
50424,572,130,57460,442,0
50427,932,168,128352,764,0
50429,282,50,11600,232,0
50449,77,17,1020,60,0
50459,641,131,66810,510,0
50465,1342,282,298920,1060,0
50491,443,85,30430,358,0
50497,1541,306,377910,1235,0
50498,572,130,57460,442,0
50508,1583,310,394630,1273,0
50532,273,58,12470,215,0
50533,373,74,22126,299,0
50542,865,167,116566,698,0
50567,2102,402,683400,1700,0
50569,1552,299,374647,1253,0
50576,767,144,89712,623,0
50594,1657,315,422730,1342,0
50599,1583,310,394630,1273,0
50602,1876,359,544603,1517,0
50617,108,17,1547,91,0
50630,819,152,101384,667,0
50633,819,152,101384,667,0
50636,410,76,25384,334,0
50644,821,171,111150,650,0
50650,1876,359,544603,1517,0
50653,373,74,22126,299,0
50656,495,87,35496,408,0
50663,463,83,31540,380,0
50666,821,171,111150,650,0
50672,113,20,1860,93,0
50677,950,193,146101,757,0
50679,595,120,57000,475,0
50681,2102,402,683400,1700,0
50702,1204,251,239203,953,0
50712,380,76,23104,304,0
50727,535,94,41454,441,0
50733,1411,281,317530,1130,0
50734,620,121,60379,499,0
50736,1204,251,239203,953,0
50745,380,76,23104,304,0
50746,337,74,19462,263,0
50753,2102,402,683400,1700,0
50758,778,163,100245,615,0
50783,819,152,101384,667,0
50814,124,28,2688,96,0
50827,61,11,550,50,0
50836,110,18,1656,92,0
50877,405,82,26486,323,0
50881,793,158,100330,635,0
50893,1262,259,259777,1003,0
50900,1552,299,374647,1253,0
50931,836,151,103435,685,0
50934,1552,299,374647,1253,0
50939,366,70,20720,296,0
50945,1280,232,243136,1048,0
50953,156,34,4148,122,0
50979,1078,198,174240,880,0
50982,380,76,23104,304,0
50989,793,158,100330,635,0
50996,236,50,9300,186,0
51016,317,63,16002,254,0
51023,1262,259,259777,1003,0
51026,2102,402,683400,1700,0
51043,145,23,2806,122,0
51047,174,36,4968,138,0
51049,641,131,66810,510,0
51051,379,65,20410,314,0
51052,1829,353,521028,1476,0
51067,1280,232,243136,1048,0
51068,31,10,210,21,0
51086,1411,281,317530,1130,0
51101,200,40,6400,160,0
51102,2102,402,683400,1700,0
51109,31,10,210,21,0
51122,362,69,20217,293,0
51135,121,27,2538,94,0
51146,1552,299,374647,1253,0
51149,976,180,143280,796,0
51167,1934,345,548205,1589,0
51177,971,184,144808,787,0
51192,1296,252,263088,1044,0
51193,28,7,147,21,0
51194,1829,353,521028,1476,0
51204,700,128,73216,572,0
51233,1657,315,422730,1342,0
51248,932,168,128352,764,0
51251,1296,252,263088,1044,0
51263,1331,255,274380,1076,0
51267,1280,232,243136,1048,0
51268,1331,255,274380,1076,0
51279,1934,345,548205,1589,0
51301,34,7,189,27,0
51324,26,6,120,20,0
51328,700,128,73216,572,0
51332,1558,313,389685,1245,0
51347,410,76,25384,334,0
51349,1181,246,230010,935,0
51360,207,41,6806,166,0
51374,1296,252,263088,1044,0
51395,821,143,96954,678,0
51404,185,36,5364,149,0
51435,1078,198,174240,880,0
51446,321,54,14418,267,0
51449,264,56,11648,208,0
51452,836,151,103435,685,0
51455,595,121,57354,474,0
51456,1204,251,239203,953,0
51479,950,193,146101,757,0
51482,11,4,28,7,0
51488,395,72,23256,323,0
51493,1025,201,165624,824,0
51497,1296,252,263088,1044,0
51511,793,158,100330,635,0
51512,1876,359,544603,1517,0
51513,324,67,17219,257,0
51544,1181,246,230010,935,0
51563,35,8,216,27,0
51566,932,168,128352,764,0
51579,401,77,24948,324,0
51613,1934,345,548205,1589,0
51620,1181,246,230010,935,0
51636,110,27,2241,83,0
51658,174,36,4968,138,0
51662,35,9,234,26,0
51669,160,29,3799,131,0
51671,1411,281,317530,1130,0
51676,1934,345,548205,1589,0
51687,1934,345,548205,1589,0
51690,2102,402,683400,1700,0
51695,534,102,44064,432,0
51722,620,121,60379,499,0
51745,131,21,2310,110,0
51775,778,163,100245,615,0
51777,61,11,550,50,0
51798,1342,282,298920,1060,0
51809,252,45,9315,207,0
51811,1876,359,544603,1517,0
51827,1934,345,548205,1589,0
51834,865,167,116566,698,0
51836,551,102,45798,449,0
51837,535,94,41454,441,0
51838,700,128,73216,572,0
51850,185,36,5364,149,0
51857,1181,246,230010,935,0
51860,1296,252,263088,1044,0
51865,49,9,360,40,0
51870,548,102,45492,446,0
51876,58,12,552,46,0
51885,1078,198,174240,880,0
51902,282,50,11600,232,0
51914,64,15,735,49,0
51925,932,168,128352,764,0
51929,72,13,767,59,0
51960,714,137,79049,577,0
51983,1296,252,263088,1044,0
51985,865,167,116566,698,0
51986,1342,282,298920,1060,0
51987,337,74,19462,263,0
52019,516,103,42539,413,0
52037,227,44,8052,183,0
52045,821,143,96954,678,0
52049,1552,299,374647,1253,0
52053,571,114,52098,457,0
52058,865,167,116566,698,0
52060,836,151,103435,685,0
52062,660,133,69928,527,0
52094,1280,232,243136,1048,0
52096,1583,310,394630,1273,0
52102,865,167,116566,698,0
52126,1280,232,243136,1048,0
52133,1552,299,374647,1253,0
52159,793,158,100330,635,0
52163,1583,310,394630,1273,0
52164,305,70,16450,235,0
52172,1342,282,298920,1060,0
52188,1558,313,389685,1245,0
52195,2102,402,683400,1700,0
52201,1280,232,243136,1048,0
52203,821,143,96954,678,0
52208,932,168,128352,764,0
52217,976,180,143280,796,0
52225,1280,232,243136,1048,0
52228,1280,232,243136,1048,0
52230,89,15,1110,74,0
52240,1331,255,274380,1076,0
52272,1280,232,243136,1048,0
52273,1541,306,377910,1235,0
52297,365,74,21534,291,0
52329,793,158,100330,635,0
52346,1552,299,374647,1253,0
52381,134,30,3120,104,0
52392,5,1,4,4,0
52394,767,144,89712,623,0
52398,1541,306,377910,1235,0
52401,324,67,17219,257,0
52411,305,70,16450,235,0
52413,405,82,26486,323,0
52419,1541,306,377910,1235,0
52423,595,120,57000,475,0
52426,1411,281,317530,1130,0
52428,821,143,96954,678,0
52434,415,75,25500,340,0
52441,572,130,57460,442,0
52450,1181,246,230010,935,0
52452,305,70,16450,235,0
52453,767,144,89712,623,0
52455,119,25,2350,94,0
52458,1829,353,521028,1476,0
52461,366,70,20720,296,0
52508,14,3,33,11,0
52512,1181,246,230010,935,0
52524,1829,353,521028,1476,0
52536,714,137,79049,577,0
52543,148,24,2976,124,0
52545,534,102,44064,432,0
52554,1876,359,544603,1517,0
52582,767,144,89712,623,0
52589,535,94,41454,441,0
52591,771,137,86858,634,0
52597,1331,255,274380,1076,0
52600,65,17,816,48,0
52609,463,83,31540,380,0
52616,155,34,4114,121,0
52668,767,144,89712,623,0
52678,821,171,111150,650,0
52694,700,128,73216,572,0
52729,379,65,20410,314,0
52732,1025,201,165624,824,0
52750,1583,310,394630,1273,0
52761,1657,315,422730,1342,0
52764,1331,255,274380,1076,0
52787,1583,310,394630,1273,0
52790,865,167,116566,698,0
52810,107,19,1672,88,0
52822,821,171,111150,650,0
52823,65,17,816,48,0
52826,821,171,111150,650,0
52830,551,102,45798,449,0
52847,821,171,111150,650,0
52854,1342,282,298920,1060,0
52884,1583,310,394630,1273,0
52886,976,180,143280,796,0
52903,1296,252,263088,1044,0
52910,1342,282,298920,1060,0
52913,33,7,182,26,0
52916,236,50,9300,186,0
52924,321,54,14418,267,0
52942,700,128,73216,572,0
52957,568,114,51756,454,0
52961,660,133,69928,527,0
52963,26,6,120,20,0
52993,641,131,66810,510,0
53004,148,24,2976,124,0
53022,1296,252,263088,1044,0
53026,572,130,57460,442,0
53039,1262,259,259777,1003,0
53048,282,50,11600,232,0
53057,568,114,51756,454,0
53078,155,35,4200,120,0
53079,534,102,44064,432,0
53090,395,72,23256,323,0
53107,164,34,4420,130,0
53116,185,36,5364,149,0
53120,1552,299,374647,1253,0
53143,10,2,16,8,0
53149,1331,255,274380,1076,0
53153,58,12,552,46,0
53161,1181,246,230010,935,0
53166,62,16,736,46,0
53180,315,56,14504,259,0
53183,108,17,1547,91,0
53188,373,74,22126,299,0
53198,976,180,143280,796,0
53200,405,82,26486,323,0
53214,274,57,12369,217,0
53224,495,87,35496,408,0
53227,317,63,16002,254,0
53232,714,137,79049,577,0
53235,415,75,25500,340,0
53252,405,82,26486,323,0
53263,819,152,101384,667,0
53281,865,167,116566,698,0
53294,714,137,79049,577,0
53310,595,121,57354,474,0
53321,1025,201,165624,824,0
53338,2102,402,683400,1700,0
53349,819,152,101384,667,0
53367,19,4,60,15,0
53370,2102,402,683400,1700,0
53377,35,9,234,26,0
53392,595,121,57354,474,0
53399,620,121,60379,499,0
53401,971,184,144808,787,0
53408,568,114,51756,454,0
53411,1204,251,239203,953,0
53417,2102,402,683400,1700,0
53440,865,167,116566,698,0
53485,121,27,2538,94,0
53493,124,28,2688,96,0
53502,1934,345,548205,1589,0
53504,976,180,143280,796,0
53514,1829,353,521028,1476,0
53526,1342,282,298920,1060,0
53530,971,184,144808,787,0
53553,1583,310,394630,1273,0
53557,134,30,3120,104,0
53565,33,7,182,26,0
53584,1583,310,394630,1273,0
53621,373,74,22126,299,0
53641,164,34,4420,130,0
53643,950,193,146101,757,0
53645,64,16,768,48,0
53659,1342,282,298920,1060,0
53678,1342,282,298920,1060,0
53683,379,65,20410,314,0
53712,1552,299,374647,1253,0
53732,571,114,52098,457,0
53737,1583,310,394630,1273,0
53740,595,121,57354,474,0
53742,793,158,100330,635,0
53757,137,25,2800,112,0
53763,15,3,36,12,0
53782,346,76,20520,270,0
53784,1280,232,243136,1048,0
53788,380,76,23104,304,0
53792,1583,310,394630,1273,0
53794,360,66,19404,294,0
53797,1331,255,274380,1076,0
53810,836,151,103435,685,0
53821,346,76,20520,270,0
53828,23,5,90,18,0
53846,976,180,143280,796,0
53854,110,27,2241,83,0
53864,821,171,111150,650,0
53887,415,75,25500,340,0
53889,1583,310,394630,1273,0
53897,1657,315,422730,1342,0
53901,1181,246,230010,935,0
53906,405,82,26486,323,0
53909,155,34,4114,121,0
53911,207,41,6806,166,0
53955,641,131,66810,510,0
53960,321,54,14418,267,0
53962,819,152,101384,667,0
53964,1025,201,165624,824,0
53966,1934,345,548205,1589,0
54008,1280,232,243136,1048,0
54028,207,41,6806,166,0
54073,932,168,128352,764,0
54076,236,50,9300,186,0
54089,26,6,120,20,0
54099,641,131,66810,510,0
54102,1181,246,230010,935,0
54125,1204,251,239203,953,0
54128,1541,306,377910,1235,0
54130,1541,306,377910,1235,0
54140,971,184,144808,787,0
54154,714,137,79049,577,0
54167,1558,313,389685,1245,0
54185,1541,306,377910,1235,0
54197,252,45,9315,207,0
54201,1296,252,263088,1044,0
54202,1657,315,422730,1342,0
54206,217,44,7612,173,0
54217,1829,353,521028,1476,0
54225,1262,259,259777,1003,0
54232,1280,232,243136,1048,0
54234,971,184,144808,787,0
54238,1583,310,394630,1273,0
54240,535,94,41454,441,0
54247,104,16,1408,88,0
54261,175,29,4234,146,0
54275,595,121,57354,474,0
54280,1583,310,394630,1273,0
54285,1876,359,544603,1517,0
54310,1583,310,394630,1273,0
54317,793,158,100330,635,0
54324,836,151,103435,685,0
54334,2102,402,683400,1700,0
54365,595,120,57000,475,0
54379,595,121,57354,474,0
54391,1541,306,377910,1235,0
54393,380,76,23104,304,0
54409,380,76,23104,304,0
54416,207,41,6806,166,0
54420,595,120,57000,475,0
54434,1296,252,263088,1044,0
54439,714,137,79049,577,0
54440,595,121,57354,474,0
54444,373,74,22126,299,0
54446,793,158,100330,635,0
54447,1876,359,544603,1517,0
54455,932,168,128352,764,0
54458,932,168,128352,764,0
54467,395,72,23256,323,0
54525,778,163,100245,615,0
54568,1296,252,263088,1044,0
54577,385,71,22294,314,0
54615,819,152,101384,667,0
54617,1280,232,243136,1048,0
54621,1829,353,521028,1476,0
54622,1934,345,548205,1589,0
54629,595,121,57354,474,0
54633,105,22,1826,83,0
54639,122,22,2200,100,0
54640,124,28,2688,96,0
54642,185,36,5364,149,0
54643,1262,259,259777,1003,0
54644,495,87,35496,408,0
54662,641,131,66810,510,0
54670,1657,315,422730,1342,0
54678,552,113,49607,439,0
54682,52,10,420,42,0
54685,17,2,30,15,0
54693,821,171,111150,650,0
54741,1558,313,389685,1245,0
54754,217,44,7612,173,0
54763,1876,359,544603,1517,0
54766,778,163,100245,615,0
54777,1657,315,422730,1342,0
54778,321,54,14418,267,0
54799,89,15,1110,74,0
54827,821,143,96954,678,0
54835,821,143,96954,678,0
54848,821,171,111150,650,0
54860,595,121,57354,474,0
54864,2102,402,683400,1700,0
54899,1296,252,263088,1044,0
54914,1411,281,317530,1130,0
54922,113,24,2136,89,0
54949,1411,281,317530,1130,0
54955,1262,259,259777,1003,0
54965,534,102,44064,432,0
54995,572,130,57460,442,0
55008,548,102,45492,446,0
55014,405,82,26486,323,0
55021,1342,282,298920,1060,0
55027,186,35,5285,151,0
55035,127,29,2842,98,0
55037,207,41,6806,166,0
55038,1262,259,259777,1003,0
55039,1296,252,263088,1044,0
55048,551,102,45798,449,0
55065,1934,345,548205,1589,0
55066,1181,246,230010,935,0
55086,1541,306,377910,1235,0
55095,552,113,49607,439,0
55098,595,121,57354,474,0
55102,401,77,24948,324,0
55103,571,114,52098,457,0
55118,274,57,12369,217,0
55119,1934,345,548205,1589,0
55124,40,6,204,34,0
55143,321,54,14418,267,0
55148,568,114,51756,454,0
55150,395,72,23256,323,0
55181,1342,282,298920,1060,0
55184,1934,345,548205,1589,0
55188,75,19,1064,56,0
55204,1558,313,389685,1245,0
55215,714,137,79049,577,0
55217,1204,251,239203,953,0
55242,55,11,484,44,0
55248,113,24,2136,89,0
55254,976,180,143280,796,0
55255,70,15,825,55,0
55267,1181,246,230010,935,0
55271,24,6,108,18,0
55273,1181,246,230010,935,0
55275,17,6,66,11,0
55277,516,103,42539,413,0
55290,31,8,184,23,0
55316,72,14,812,58,0
55320,1342,282,298920,1060,0
55321,70,12,696,58,0
55328,568,114,51756,454,0
55333,539,101,44238,438,0
55334,1657,315,422730,1342,0
55345,25,3,66,22,0
55352,595,121,57354,474,0
55355,40,9,279,31,0
55374,365,74,21534,291,0
55406,104,16,1408,88,0
55411,1280,232,243136,1048,0
55445,1181,246,230010,935,0
55452,1204,251,239203,953,0
55463,950,193,146101,757,0
55471,1411,281,317530,1130,0
55483,551,102,45798,449,0
55516,198,43,6665,155,0
55522,865,167,116566,698,0
55535,1657,315,422730,1342,0
55543,534,102,44064,432,0
55554,105,16,1424,89,0
55563,380,76,23104,304,0
55577,1829,353,521028,1476,0
55580,164,34,4420,130,0
55584,793,158,100330,635,0
55589,58,12,552,46,0
55599,365,74,21534,291,0
55624,1583,310,394630,1273,0
55649,571,114,52098,457,0
55650,25,2,46,23,0
55652,595,120,57000,475,0
55654,44,10,340,34,0
55667,274,57,12369,217,0
55679,771,137,86858,634,0
55696,932,168,128352,764,0
55700,1025,201,165624,824,0
55706,950,193,146101,757,0
55740,767,144,89712,623,0
55763,1411,281,317530,1130,0
55776,373,74,22126,299,0
55780,1558,313,389685,1245,0
55782,821,171,111150,650,0
55804,1876,359,544603,1517,0
55814,595,120,57000,475,0
55817,495,87,35496,408,0
55834,497,97,38800,400,0
55836,1558,313,389685,1245,0
55847,155,27,3456,128,0
55850,174,36,4968,138,0
55857,171,35,4760,136,0
55876,317,63,16002,254,0
55884,113,20,1860,93,0
55890,516,103,42539,413,0
55907,932,168,128352,764,0
55938,1829,353,521028,1476,0
55948,2102,402,683400,1700,0
55957,950,193,146101,757,0
55968,714,137,79049,577,0
55974,18,4,56,14,0
55981,778,163,100245,615,0
55982,323,55,14740,268,0
55988,88,17,1207,71,0
55998,2102,402,683400,1700,0
56010,1078,198,174240,880,0
56016,1829,353,521028,1476,0
56040,821,171,111150,650,0
56054,198,43,6665,155,0
56057,1657,315,422730,1342,0
56060,1262,259,259777,1003,0
56065,35,7,196,28,0
56089,1078,198,174240,880,0
56091,1025,201,165624,824,0
56100,379,65,20410,314,0
56102,1829,353,521028,1476,0
56111,1876,359,544603,1517,0
56142,1280,232,243136,1048,0
56145,1583,310,394630,1273,0
56161,68,14,756,54,0
56163,15,4,44,11,0
56169,198,43,6665,155,0
56172,146,34,3808,112,0
56186,819,152,101384,667,0
56189,65,13,676,52,0
56201,50,8,336,42,0
56206,1829,353,521028,1476,0
56213,97,22,1650,75,0
56214,49,8,328,41,0
56221,1934,345,548205,1589,0
56235,1262,259,259777,1003,0
56243,2102,402,683400,1700,0
56244,1552,299,374647,1253,0
56247,252,45,9315,207,0
56253,155,34,4114,121,0
56257,119,22,2134,97,0
56261,1829,353,521028,1476,0
56271,1552,299,374647,1253,0
56272,865,167,116566,698,0
56277,323,55,14740,268,0
56292,380,76,23104,304,0
56296,88,17,1207,71,0
56297,198,43,6665,155,0
56298,365,74,21534,291,0
56328,175,29,4234,146,0
56330,548,102,45492,446,0
56394,112,18,1692,94,0
56448,771,137,86858,634,0
56529,932,168,128352,764,0
56537,1342,282,298920,1060,0
56547,595,120,57000,475,0
56562,1331,255,274380,1076,0
56570,836,151,103435,685,0
56576,1558,313,389685,1245,0
56588,865,167,116566,698,0
56590,171,35,4760,136,0
56611,207,41,6806,166,0
56616,714,137,79049,577,0
56643,40,6,204,34,0
56646,641,131,66810,510,0
56660,1657,315,422730,1342,0
56665,145,23,2806,122,0
56683,534,102,44064,432,0
56688,1411,281,317530,1130,0
56695,315,56,14504,259,0
56697,337,74,19462,263,0
56702,932,168,128352,764,0
56727,321,54,14418,267,0
56754,127,29,2842,98,0
56758,1583,310,394630,1273,0
56763,1934,345,548205,1589,0
56801,20,5,75,15,0
56817,148,24,2976,124,0
56832,137,25,2800,112,0
56834,373,74,22126,299,0
56844,568,114,51756,454,0
56871,72,17,935,55,0
56884,497,97,38800,400,0
56923,410,76,25384,334,0
56940,700,128,73216,572,0
56946,155,34,4114,121,0
56975,595,121,57354,474,0
56987,552,113,49607,439,0
56988,1552,299,374647,1253,0
56997,1657,315,422730,1342,0
57000,22,6,96,16,0
57021,836,151,103435,685,0
57052,595,121,57354,474,0
57054,771,137,86858,634,0
57074,1583,310,394630,1273,0
57082,236,50,9300,186,0
57096,61,13,624,48,0
57101,1583,310,394630,1273,0
57112,264,56,11648,208,0
57113,88,17,1207,71,0
57121,1829,353,521028,1476,0
57127,950,193,146101,757,0
57131,932,168,128352,764,0
57132,534,102,44064,432,0
57143,2102,402,683400,1700,0
57167,534,102,44064,432,0
57185,155,27,3456,128,0
57202,55,11,484,44,0
57227,821,143,96954,678,0
57250,932,168,128352,764,0
57264,548,102,45492,446,0
57268,1262,259,259777,1003,0
57280,1411,281,317530,1130,0
57302,641,131,66810,510,0
57311,148,24,2976,124,0
57319,274,57,12369,217,0
57328,1583,310,394630,1273,0
57360,1541,306,377910,1235,0
57411,1934,345,548205,1589,0
57424,1280,232,243136,1048,0
57453,1558,313,389685,1245,0
57467,821,143,96954,678,0
57484,1331,255,274380,1076,0
57491,379,65,20410,314,0
57502,21,6,90,15,0
57528,1541,306,377910,1235,0
57532,865,167,116566,698,0
57536,552,113,49607,439,0
57543,1541,306,377910,1235,0
57557,395,72,23256,323,0
57570,976,180,143280,796,0
57579,1876,359,544603,1517,0
57581,362,69,20217,293,0
57585,324,67,17219,257,0
57608,1342,282,298920,1060,0
57627,194,39,6045,155,0
57628,366,70,20720,296,0
57634,1262,259,259777,1003,0
57638,572,130,57460,442,0
57646,1342,282,298920,1060,0
57651,18,4,56,14,0
57654,1876,359,544603,1517,0
57662,548,102,45492,446,0
57675,305,70,16450,235,0
57700,971,184,144808,787,0
57705,571,114,52098,457,0
57712,174,36,4968,138,0
57726,1331,255,274380,1076,0
57742,1280,232,243136,1048,0
57756,323,55,14740,268,0
57759,124,28,2688,96,0
57767,714,137,79049,577,0
57774,145,23,2806,122,0
57779,146,34,3808,112,0
57781,1558,313,389685,1245,0
57786,1262,259,259777,1003,0
57792,379,65,20410,314,0
57803,1280,232,243136,1048,0
57805,122,25,2425,97,0
57821,534,102,44064,432,0
57827,137,25,2800,112,0
57833,337,74,19462,263,0
57835,700,128,73216,572,0
57849,8,3,15,5,0
57862,932,168,128352,764,0
57872,171,35,4760,136,0
57878,497,97,38800,400,0
57882,932,168,128352,764,0
57884,620,121,60379,499,0
57885,160,29,3799,131,0
57910,1876,359,544603,1517,0
57911,971,184,144808,787,0
57922,1558,313,389685,1245,0
57929,700,128,73216,572,0
57963,778,163,100245,615,0
57982,1025,201,165624,824,0
58011,1411,281,317530,1130,0
58017,1876,359,544603,1517,0
58018,105,22,1826,83,0
58024,137,25,2800,112,0
58070,72,13,767,59,0
58082,119,25,2350,94,0
58103,323,55,14740,268,0
58109,1541,306,377910,1235,0
58110,821,143,96954,678,0
58128,1829,353,521028,1476,0
58139,315,56,14504,259,0
58147,771,137,86858,634,0
58175,252,45,9315,207,0
58180,385,71,22294,314,0
58184,700,128,73216,572,0
58188,1331,255,274380,1076,0
58196,317,63,16002,254,0
58199,971,184,144808,787,0
58202,200,40,6400,160,0
58203,1558,313,389685,1245,0
58244,700,128,73216,572,0
58246,641,131,66810,510,0
58258,620,121,60379,499,0
58263,385,71,22294,314,0
58264,77,12,780,65,0
58294,20,5,75,15,0
58297,61,8,424,53,0
58300,641,131,66810,510,0
58307,1876,359,544603,1517,0
58308,122,22,2200,100,0
58318,1280,232,243136,1048,0
58337,1541,306,377910,1235,0
58339,836,151,103435,685,0
58342,77,18,1062,59,0
58344,107,18,1602,89,0
58355,317,63,16002,254,0
58356,1541,306,377910,1235,0
58365,33,8,200,25,0
58370,971,184,144808,787,0
58372,552,113,49607,439,0
58375,1558,313,389685,1245,0
58384,821,143,96954,678,0
58427,819,152,101384,667,0
58434,1558,313,389685,1245,0
58452,976,180,143280,796,0
58455,976,180,143280,796,0
58470,571,114,52098,457,0
58485,135,30,3150,105,0
58507,1657,315,422730,1342,0
58516,700,128,73216,572,0
58518,7,1,6,6,0
58536,365,74,21534,291,0
58564,274,57,12369,217,0
58577,1181,246,230010,935,0
58592,131,21,2310,110,0
58610,321,54,14418,267,0
58615,821,143,96954,678,0
58621,950,193,146101,757,0
58625,516,103,42539,413,0
58638,360,66,19404,294,0
58644,315,56,14504,259,0
58662,620,121,60379,499,0
58663,1025,201,165624,824,0
58678,362,69,20217,293,0
58696,767,144,89712,623,0
58736,1558,313,389685,1245,0
58742,324,67,17219,257,0
58746,21,6,90,15,0
58771,194,39,6045,155,0
58775,552,113,49607,439,0
58781,568,114,51756,454,0
58786,660,133,69928,527,0
58789,534,102,44064,432,0
58799,37,5,160,32,0
58846,1934,345,548205,1589,0
58875,85,18,1206,67,0
58879,19,4,60,15,0
58891,821,171,111150,650,0
58898,1181,246,230010,935,0
58908,1541,306,377910,1235,0
58934,595,121,57354,474,0
58940,1280,232,243136,1048,0
58951,700,128,73216,572,0
58952,971,184,144808,787,0
58953,1829,353,521028,1476,0
58957,865,167,116566,698,0
58969,539,101,44238,438,0
58979,821,143,96954,678,0
58986,778,163,100245,615,0
58992,1078,198,174240,880,0
58995,145,23,2806,122,0
59003,58,12,552,46,0
59011,771,137,86858,634,0
59015,1552,299,374647,1253,0
59017,1181,246,230010,935,0
59027,971,184,144808,787,0
59050,714,137,79049,577,0
59053,127,29,2842,98,0
59054,362,69,20217,293,0
59060,932,168,128352,764,0
59108,185,36,5364,149,0
59144,1657,315,422730,1342,0
59168,198,43,6665,155,0
59180,865,167,116566,698,0
59181,1558,313,389685,1245,0
59187,58,12,552,46,0
59191,346,76,20520,270,0
59193,155,27,3456,128,0
59212,415,75,25500,340,0
59237,1829,353,521028,1476,0
59245,385,71,22294,314,0
59258,52,10,420,42,0
59267,44,10,340,34,0
59270,767,144,89712,623,0
59279,1331,255,274380,1076,0
59299,1262,259,259777,1003,0
59303,227,44,8052,183,0
59314,401,77,24948,324,0
59316,32,5,135,27,0
59324,836,151,103435,685,0
59355,1829,353,521028,1476,0
59357,107,19,1672,88,0
59361,1541,306,377910,1235,0
59368,1342,282,298920,1060,0
59370,971,184,144808,787,0
59386,552,113,49607,439,0
59392,1829,353,521028,1476,0
59400,1829,353,521028,1476,0
59414,836,151,103435,685,0
59430,778,163,100245,615,0
59457,539,101,44238,438,0
59472,105,16,1424,89,0
59476,1078,198,174240,880,0
59488,380,76,23104,304,0
59499,55,10,450,45,0
59511,148,24,2976,124,0
59512,535,94,41454,441,0
59513,131,25,2650,106,0
59533,264,56,11648,208,0
59535,932,168,128352,764,0
59555,37,11,286,26,0
59564,110,27,2241,83,0
59579,1262,259,259777,1003,0
59592,1280,232,243136,1048,0
59597,186,35,5285,151,0
59621,516,103,42539,413,0
59635,971,184,144808,787,0
59639,1558,313,389685,1245,0
59651,108,17,1547,91,0
59655,379,65,20410,314,0
59658,365,74,21534,291,0
59661,401,77,24948,324,0
59665,1411,281,317530,1130,0
59670,641,131,66810,510,0
59677,35,7,196,28,0
59678,323,55,14740,268,0
59684,714,137,79049,577,0
59686,659,132,69928,527,0
59696,1657,315,422730,1342,0
59709,641,131,66810,510,0
59723,134,30,3120,104,0
59724,415,75,25500,340,0
59732,321,54,14418,267,0
59734,52,10,420,42,0
59735,264,56,11648,208,0
59760,1657,315,422730,1342,0
59768,714,137,79049,577,0
59772,1934,345,548205,1589,0
59785,1541,306,377910,1235,0
59799,819,152,101384,667,0
59821,552,113,49607,439,0
59823,1411,281,317530,1130,0
59829,821,171,111150,650,0
59832,1296,252,263088,1044,0
59835,1657,315,422730,1342,0
59838,793,158,100330,635,0
59844,865,167,116566,698,0
59851,595,120,57000,475,0
59865,198,43,6665,155,0
59921,252,45,9315,207,0
59935,1342,282,298920,1060,0
59937,1204,251,239203,953,0
59946,778,163,100245,615,0
59948,700,128,73216,572,0
59962,64,16,768,48,0
59968,148,24,2976,124,0
59973,976,180,143280,796,0
60022,1204,251,239203,953,0
60037,572,130,57460,442,0
60051,264,56,11648,208,0
60060,380,76,23104,304,0
60080,1829,353,521028,1476,0
60081,2102,402,683400,1700,0
60083,1829,353,521028,1476,0
60100,971,184,144808,787,0
60104,217,44,7612,173,0
60114,976,180,143280,796,0
60117,1296,252,263088,1044,0
60122,534,102,44064,432,0
60129,971,184,144808,787,0
60132,535,94,41454,441,0
60135,1078,198,174240,880,0
60137,1829,353,521028,1476,0
60144,572,130,57460,442,0
60148,236,50,9300,186,0
60152,620,121,60379,499,0
60153,1280,232,243136,1048,0
60157,950,193,146101,757,0
60161,660,133,69928,527,0
60180,323,55,14740,268,0
60181,105,15,1350,90,0
60187,950,193,146101,757,0
60191,535,94,41454,441,0
60197,495,87,35496,408,0
60203,1876,359,544603,1517,0
60204,1204,251,239203,953,0
60214,495,87,35496,408,0
60239,28,7,147,21,0
60243,120,24,2304,96,0
60257,2102,402,683400,1700,0
60260,43,7,252,36,0
60288,976,180,143280,796,0
60298,1829,353,521028,1476,0
60326,767,144,89712,623,0
60349,1558,313,389685,1245,0
60370,194,39,6045,155,0
60383,70,12,696,58,0
60391,155,34,4114,121,0
60396,1331,255,274380,1076,0
60416,360,66,19404,294,0
60422,534,102,44064,432,0
60438,264,56,11648,208,0
60447,155,27,3456,128,0
60453,1262,259,259777,1003,0
60471,198,43,6665,155,0
60472,1331,255,274380,1076,0
60479,1583,310,394630,1273,0
60491,497,97,38800,400,0
60504,70,15,825,55,0
60511,110,27,2241,83,0
60521,1583,310,394630,1273,0
60525,1296,252,263088,1044,0
60530,1262,259,259777,1003,0
60544,1541,306,377910,1235,0
60547,1078,198,174240,880,0
60564,1181,246,230010,935,0
60566,595,121,57354,474,0
60592,1331,255,274380,1076,0
60612,1411,281,317530,1130,0
60653,821,171,111150,650,0
60672,77,18,1062,59,0
60678,714,137,79049,577,0
60702,68,15,795,53,0
60713,1558,313,389685,1245,0
60714,186,35,5285,151,0
60729,1934,345,548205,1589,0
60755,1657,315,422730,1342,0
60762,1558,313,389685,1245,0
60789,346,76,20520,270,0
60794,836,151,103435,685,0
60807,1078,198,174240,880,0
60840,836,151,103435,685,0
60844,305,70,16450,235,0
60845,2102,402,683400,1700,0
60859,1411,281,317530,1130,0
60862,1342,282,298920,1060,0
60888,865,167,116566,698,0
60895,200,40,6400,160,0
60901,1296,252,263088,1044,0
60919,1342,282,298920,1060,0
60922,1876,359,544603,1517,0
60923,1829,353,521028,1476,0
60926,175,29,4234,146,0
60948,1331,255,274380,1076,0
60952,1558,313,389685,1245,0
60967,497,97,38800,400,0
60978,1411,281,317530,1130,0
60987,273,58,12470,215,0
60989,68,14,756,54,0
60991,365,74,21534,291,0
60994,317,63,16002,254,0
61000,1331,255,274380,1076,0
61004,362,69,20217,293,0
61005,155,35,4200,120,0
61015,321,54,14418,267,0
61024,932,168,128352,764,0
61033,1342,282,298920,1060,0
61052,1552,299,374647,1253,0
61053,1552,299,374647,1253,0
61079,571,114,52098,457,0
61085,346,76,20520,270,0
61099,971,184,144808,787,0
61103,171,35,4760,136,0
61117,360,66,19404,294,0
61119,61,14,658,47,0
61128,1552,299,374647,1253,0
61149,1181,246,230010,935,0
61156,106,19,1653,87,0
61164,865,167,116566,698,0
61165,1411,281,317530,1130,0
61181,323,55,14740,268,0
61194,1934,345,548205,1589,0
61198,252,45,9315,207,0
61202,700,128,73216,572,0
61203,2102,402,683400,1700,0
61209,552,113,49607,439,0
61237,2102,402,683400,1700,0
61244,572,130,57460,442,0
61247,405,82,26486,323,0
61253,2102,402,683400,1700,0
61258,932,168,128352,764,0
61263,55,10,450,45,0
61265,1552,299,374647,1253,0
61266,68,14,756,54,0
61274,1331,255,274380,1076,0
61279,534,102,44064,432,0
61282,1280,232,243136,1048,0
61291,1204,251,239203,953,0
61295,1331,255,274380,1076,0
61301,778,163,100245,615,0
61305,64,8,448,56,0
61315,1078,198,174240,880,0
61321,105,16,1424,89,0
61329,373,74,22126,299,0
61340,551,102,45798,449,0
61351,819,152,101384,667,0
61354,778,163,100245,615,0
61374,61,13,624,48,0
61377,1331,255,274380,1076,0
61397,443,85,30430,358,0
61424,1558,313,389685,1245,0
61448,137,25,2800,112,0
61450,1934,345,548205,1589,0
61455,200,40,6400,160,0
61477,1541,306,377910,1235,0
61481,160,32,4096,128,0
61482,1934,345,548205,1589,0
61491,1204,251,239203,953,0
61507,819,152,101384,667,0
61509,410,76,25384,334,0
61511,1411,281,317530,1130,0
61513,714,137,79049,577,0
61514,1552,299,374647,1253,0
61538,552,113,49607,439,0
61542,1181,246,230010,935,0
61549,950,193,146101,757,0
61557,305,70,16450,235,0
61562,395,72,23256,323,0
61565,865,167,116566,698,0
61572,401,77,24948,324,0
61580,1876,359,544603,1517,0
61599,1025,201,165624,824,0
61600,1078,198,174240,880,0
61602,1342,282,298920,1060,0
61607,102,20,1640,82,0
61614,1934,345,548205,1589,0
61624,539,101,44238,438,0
61641,50,8,336,42,0
61649,1025,201,165624,824,0
61663,1411,281,317530,1130,0
61665,1025,201,165624,824,0
61672,548,102,45492,446,0
61702,160,32,4096,128,0
61717,155,35,4200,120,0
61730,771,137,86858,634,0
61755,865,167,116566,698,0
61760,1280,232,243136,1048,0
61775,778,163,100245,615,0
61782,410,76,25384,334,0
61790,164,34,4420,130,0
61799,273,58,12470,215,0
61805,105,16,1424,89,0
61808,346,76,20520,270,0
61835,198,43,6665,155,0
61844,1934,345,548205,1589,0
61850,1657,315,422730,1342,0
61879,572,130,57460,442,0
61884,535,94,41454,441,0
61906,88,17,1207,71,0
61917,767,144,89712,623,0
61918,836,151,103435,685,0
61920,1558,313,389685,1245,0
61926,1181,246,230010,935,0
61928,89,15,1110,74,0
61932,1342,282,298920,1060,0
61937,193,39,6006,154,0
61941,155,35,4200,120,0
61951,568,114,51756,454,0
61958,77,19,1102,58,0
61970,198,43,6665,155,0
61971,317,63,16002,254,0
61973,1934,345,548205,1589,0
61982,2102,402,683400,1700,0
61984,185,36,5364,149,0
61993,976,180,143280,796,0
61996,548,102,45492,446,0
62018,1411,281,317530,1130,0
62029,385,71,22294,314,0
62030,264,56,11648,208,0
62041,1280,232,243136,1048,0
62045,463,83,31540,380,0
62051,1331,255,274380,1076,0
62055,1657,315,422730,1342,0
62060,1204,251,239203,953,0
62078,1552,299,374647,1253,0
62093,778,163,100245,615,0
62114,11,3,24,8,0
62138,415,75,25500,340,0
62154,120,24,2304,96,0
62183,1262,259,259777,1003,0
62200,2102,402,683400,1700,0
62203,793,158,100330,635,0
62211,971,184,144808,787,0
62226,659,132,69928,527,0
62238,200,40,6400,160,0
62243,1541,306,377910,1235,0
62254,380,76,23104,304,0
62259,821,143,96954,678,0
62271,72,13,767,59,0
62282,18,6,72,12,0
62288,32,6,156,26,0
62303,443,85,30430,358,0
62315,1342,282,298920,1060,0
62318,1552,299,374647,1253,0
62323,821,171,111150,650,0
62329,495,87,35496,408,0
62337,1331,255,274380,1076,0
62370,660,133,69928,527,0
62397,1583,310,394630,1273,0
62423,185,36,5364,149,0
62428,1181,246,230010,935,0
62429,1934,345,548205,1589,0
62430,1558,313,389685,1245,0
62435,264,56,11648,208,0
62438,1342,282,298920,1060,0
62469,19,4,60,15,0
62479,1296,252,263088,1044,0
62482,121,27,2538,94,0
62512,1025,201,165624,824,0
62516,1331,255,274380,1076,0
62528,1558,313,389685,1245,0
62538,950,193,146101,757,0
62540,36,10,260,26,0
62543,1078,198,174240,880,0
62557,571,114,52098,457,0
62563,1331,255,274380,1076,0
62578,23,6,102,17,0
62588,821,143,96954,678,0
62607,539,101,44238,438,0
62608,548,102,45492,446,0
62618,405,82,26486,323,0
62624,410,76,25384,334,0
62627,58,11,517,47,0
62633,443,85,30430,358,0
62670,122,20,2040,102,0
62681,976,180,143280,796,0
62713,551,102,45798,449,0
62721,175,29,4234,146,0
62729,395,72,23256,323,0
62734,365,74,21534,291,0
62741,1342,282,298920,1060,0
62742,552,113,49607,439,0
62749,595,121,57354,474,0
62752,1411,281,317530,1130,0
62753,1078,198,174240,880,0
62755,146,34,3808,112,0
62759,1331,255,274380,1076,0
62761,1204,251,239203,953,0
62787,410,76,25384,334,0
62795,1829,353,521028,1476,0
62796,700,128,73216,572,0
62814,443,85,30430,358,0
62818,932,168,128352,764,0
62820,70,12,696,58,0
62826,1552,299,374647,1253,0
62829,185,36,5364,149,0
62838,1829,353,521028,1476,0
62870,1331,255,274380,1076,0
62875,568,114,51756,454,0
62882,122,25,2425,97,0
62889,207,41,6806,166,0
62894,771,137,86858,634,0
62900,2102,402,683400,1700,0
62902,1934,345,548205,1589,0
62904,1934,345,548205,1589,0
62905,793,158,100330,635,0
62906,771,137,86858,634,0
62911,1331,255,274380,1076,0
62918,1181,246,230010,935,0
62920,714,137,79049,577,0
62928,52,10,420,42,0
62954,1541,306,377910,1235,0
62970,2102,402,683400,1700,0
62984,660,133,69928,527,0
62985,700,128,73216,572,0
63010,264,56,11648,208,0
63045,1583,310,394630,1273,0
63052,1411,281,317530,1130,0
63067,1934,345,548205,1589,0
63071,568,114,51756,454,0
63087,1280,232,243136,1048,0
63091,1342,282,298920,1060,0
63118,595,121,57354,474,0
63141,1296,252,263088,1044,0
63171,305,70,16450,235,0
63178,121,27,2538,94,0
63179,1829,353,521028,1476,0
63192,37,11,286,26,0
63200,1342,282,298920,1060,0
63220,264,56,11648,208,0
63235,146,34,3808,112,0
63255,70,15,825,55,0
63283,1331,255,274380,1076,0
63287,495,87,35496,408,0
63293,771,137,86858,634,0
63303,1552,299,374647,1253,0
63309,410,76,25384,334,0
63316,1583,310,394630,1273,0
63330,1411,281,317530,1130,0
63345,155,34,4114,121,0
63348,380,76,23104,304,0
63350,14,3,33,11,0
63355,1280,232,243136,1048,0
63394,366,70,20720,296,0
63399,252,45,9315,207,0
63442,495,87,35496,408,0
63443,571,114,52098,457,0
63445,767,144,89712,623,0
63465,171,35,4760,136,0
63476,1829,353,521028,1476,0
63477,595,120,57000,475,0
63488,1078,198,174240,880,0
63491,346,76,20520,270,0
63493,1829,353,521028,1476,0
63503,714,137,79049,577,0
63513,323,55,14740,268,0
63526,1262,259,259777,1003,0
63540,1342,282,298920,1060,0
63545,1411,281,317530,1130,0
63554,145,23,2806,122,0
63556,572,130,57460,442,0
63557,620,121,60379,499,0
63561,337,74,19462,263,0
63582,373,74,22126,299,0
63589,535,94,41454,441,0
63592,185,36,5364,149,0
63606,1558,313,389685,1245,0
63634,2102,402,683400,1700,0
63636,641,131,66810,510,0
63649,22,6,96,16,0
63663,26,8,144,18,0
63676,793,158,100330,635,0
63711,1411,281,317530,1130,0
63717,2102,402,683400,1700,0
63726,145,23,2806,122,0
63728,1558,313,389685,1245,0
63741,1262,259,259777,1003,0
63744,1204,251,239203,953,0
63748,641,131,66810,510,0
63750,317,63,16002,254,0
63756,360,66,19404,294,0
63763,660,133,69928,527,0
63769,1204,251,239203,953,0
63771,1342,282,298920,1060,0
63772,1829,353,521028,1476,0
63795,144,29,3335,115,0
63800,236,50,9300,186,0
63804,121,27,2538,94,0
63835,1876,359,544603,1517,0
63852,107,18,1602,89,0
63854,317,63,16002,254,0
63876,1558,313,389685,1245,0
63920,317,63,16002,254,0
63923,1342,282,298920,1060,0
63943,160,32,4096,128,0
63954,185,36,5364,149,0
63979,198,43,6665,155,0
63981,1657,315,422730,1342,0
64000,595,120,57000,475,0
64015,1411,281,317530,1130,0
64030,1411,281,317530,1130,0
64047,58,15,645,43,0
64049,1829,353,521028,1476,0
64052,700,128,73216,572,0
64064,1541,306,377910,1235,0
64065,1876,359,544603,1517,0
64083,18,3,45,15,0
64112,976,180,143280,796,0
64129,415,75,25500,340,0
64149,1657,315,422730,1342,0
64155,88,17,1207,71,0
64177,714,137,79049,577,0
64182,1876,359,544603,1517,0
64187,971,184,144808,787,0
64192,395,72,23256,323,0
64198,568,114,51756,454,0
64202,821,143,96954,678,0
64219,793,158,100330,635,0
64222,106,19,1653,87,0
64227,337,74,19462,263,0
64229,865,167,116566,698,0
64268,2102,402,683400,1700,0
64276,516,103,42539,413,0
64279,1181,246,230010,935,0
64288,24,4,80,20,0
64292,516,103,42539,413,0
64304,1411,281,317530,1130,0
64319,1558,313,389685,1245,0
64363,595,121,57354,474,0
64375,89,15,1110,74,0
64409,865,167,116566,698,0
64414,1204,251,239203,953,0
64418,385,71,22294,314,0
64422,119,22,2134,97,0
64423,2102,402,683400,1700,0
64430,714,137,79049,577,0
64436,401,77,24948,324,0
64448,1876,359,544603,1517,0
64483,2102,402,683400,1700,0
64493,1657,315,422730,1342,0
64499,1025,201,165624,824,0
64516,366,70,20720,296,0
64518,227,44,8052,183,0
64522,659,132,69928,527,0
64528,819,152,101384,667,0
64529,31,7,168,24,0
64532,315,56,14504,259,0
64548,1657,315,422730,1342,0
64549,1541,306,377910,1235,0
64595,1541,306,377910,1235,0
64602,1934,345,548205,1589,0
64603,264,56,11648,208,0
64609,362,69,20217,293,0
64611,568,114,51756,454,0
64616,821,171,111150,650,0
64620,122,20,2040,102,0
64624,1934,345,548205,1589,0
64627,60,12,576,48,0
64644,155,35,4200,120,0
64645,395,72,23256,323,0
64646,1829,353,521028,1476,0
64676,1204,251,239203,953,0
64678,379,65,20410,314,0
64696,1204,251,239203,953,0
64699,198,43,6665,155,0
64711,1331,255,274380,1076,0
64717,47,8,312,39,0
64722,405,82,26486,323,0
64744,305,70,16450,235,0
64749,315,56,14504,259,0
64750,282,50,11600,232,0
64751,164,34,4420,130,0
64753,1558,313,389685,1245,0
64800,551,102,45798,449,0
64814,252,45,9315,207,0
64831,1829,353,521028,1476,0
64833,1876,359,544603,1517,0
64839,620,121,60379,499,0
64844,767,144,89712,623,0
64865,60,12,576,48,0
64868,379,65,20410,314,0
64874,200,40,6400,160,0
64876,1078,198,174240,880,0
64896,415,75,25500,340,0
64910,1541,306,377910,1235,0
64921,1204,251,239203,953,0
64929,660,133,69928,527,0
64931,366,70,20720,296,0
64938,110,27,2241,83,0
64947,1342,282,298920,1060,0
64982,1934,345,548205,1589,0
64990,1342,282,298920,1060,0
64991,346,76,20520,270,0
64992,836,151,103435,685,0
64996,771,137,86858,634,0
64999,1829,353,521028,1476,0
65006,380,76,23104,304,0
65011,186,35,5285,151,0
65026,793,158,100330,635,0
65039,1262,259,259777,1003,0
65051,1541,306,377910,1235,0
65055,1934,345,548205,1589,0
65060,1552,299,374647,1253,0
65064,463,83,31540,380,0
65088,1558,313,389685,1245,0
65091,1296,252,263088,1044,0
65105,164,34,4420,130,0
65119,77,18,1062,59,0
65124,379,65,20410,314,0
65130,1204,251,239203,953,0
65136,778,163,100245,615,0
65143,551,102,45798,449,0
65172,539,101,44238,438,0
65175,778,163,100245,615,0
65177,1331,255,274380,1076,0
65179,64,15,735,49,0
65193,385,71,22294,314,0
65215,2102,402,683400,1700,0
65232,572,130,57460,442,0
65235,819,152,101384,667,0
65236,137,25,2800,112,0
65245,1296,252,263088,1044,0
65276,337,74,19462,263,0
65281,17,3,42,14,0
65295,1829,353,521028,1476,0
65300,102,20,1640,82,0
65309,700,128,73216,572,0
65325,380,76,23104,304,0
65327,793,158,100330,635,0
65360,64,8,448,56,0
65376,2102,402,683400,1700,0
65379,155,27,3456,128,0
65391,1296,252,263088,1044,0
65400,595,121,57354,474,0
65424,282,50,11600,232,0
65436,641,131,66810,510,0
65440,305,70,16450,235,0
65461,793,158,100330,635,0
65479,568,114,51756,454,0
65482,365,74,21534,291,0
65487,1934,345,548205,1589,0
65492,23,5,90,18,0
65495,1331,255,274380,1076,0
65506,1280,232,243136,1048,0
65535,405,82,26486,323,0
65539,1296,252,263088,1044,0
65545,1934,345,548205,1589,0
65550,568,114,51756,454,0
65553,1078,198,174240,880,0
65566,77,18,1062,59,0
65572,415,75,25500,340,0
65575,72,13,767,59,0
65578,2102,402,683400,1700,0
65583,305,70,16450,235,0
65584,819,152,101384,667,0
65595,1296,252,263088,1044,0
65604,1657,315,422730,1342,0
65606,771,137,86858,634,0
65618,410,76,25384,334,0
65630,44,9,315,35,0
65664,1583,310,394630,1273,0
65677,1829,353,521028,1476,0
65678,362,69,20217,293,0
65681,1541,306,377910,1235,0
65685,836,151,103435,685,0
65705,373,74,22126,299,0
65733,113,24,2136,89,0
65734,104,16,1408,88,0
65752,1558,313,389685,1245,0
65774,1262,259,259777,1003,0
65802,767,144,89712,623,0
65808,21,6,90,15,0
65810,1829,353,521028,1476,0
65819,89,15,1110,74,0
65822,252,45,9315,207,0
65827,516,103,42539,413,0
65844,1262,259,259777,1003,0
65855,1181,246,230010,935,0
65856,771,137,86858,634,0
65891,385,71,22294,314,0
65894,77,17,1020,60,0
65897,1657,315,422730,1342,0
65903,101,20,1620,81,0
65904,714,137,79049,577,0
65931,821,143,96954,678,0
65936,950,193,146101,757,0
65954,443,85,30430,358,0
65985,1583,310,394630,1273,0
65991,1876,359,544603,1517,0
66002,1296,252,263088,1044,0
66009,2102,402,683400,1700,0
66011,1541,306,377910,1235,0
66025,1876,359,544603,1517,0
66036,77,17,1020,60,0
66040,1657,315,422730,1342,0
66083,595,121,57354,474,0
66088,89,15,1110,74,0
66103,16,3,39,13,0
66105,865,167,116566,698,0
66151,44,10,340,34,0
66153,1552,299,374647,1253,0
66158,380,76,23104,304,0
66174,1583,310,394630,1273,0
66191,495,87,35496,408,0
66207,346,76,20520,270,0
66217,317,63,16002,254,0
66219,155,34,4114,121,0
66236,26,6,120,20,0
66241,88,17,1207,71,0
66249,28,7,147,21,0
66255,1657,315,422730,1342,0
66281,516,103,42539,413,0
66297,971,184,144808,787,0
66326,321,54,14418,267,0
66341,1552,299,374647,1253,0
66342,1541,306,377910,1235,0
66360,145,23,2806,122,0
66377,1411,281,317530,1130,0
66388,121,27,2538,94,0
66401,1552,299,374647,1253,0
66406,865,167,116566,698,0
66411,1934,345,548205,1589,0
66438,360,66,19404,294,0
66449,1876,359,544603,1517,0
66459,1829,353,521028,1476,0
66478,539,101,44238,438,0
66493,131,25,2650,106,0
66505,865,167,116566,698,0
66518,1657,315,422730,1342,0
66523,836,151,103435,685,0
66549,971,184,144808,787,0
66565,105,22,1826,83,0
66577,821,143,96954,678,0
66581,1583,310,394630,1273,0
66589,819,152,101384,667,0
66606,185,36,5364,149,0
66612,950,193,146101,757,0
66626,385,71,22294,314,0
66641,1342,282,298920,1060,0
66645,595,121,57354,474,0
66648,463,83,31540,380,0
66658,595,121,57354,474,0
66707,1025,201,165624,824,0
66725,1296,252,263088,1044,0
66737,198,43,6665,155,0
66755,2102,402,683400,1700,0
66756,1558,313,389685,1245,0
66761,535,94,41454,441,0
66764,1829,353,521028,1476,0
66770,1181,246,230010,935,0
66779,49,8,328,41,0
66781,836,151,103435,685,0
66784,1411,281,317530,1130,0
66790,110,27,2241,83,0
66794,405,82,26486,323,0
66798,1411,281,317530,1130,0
66799,1342,282,298920,1060,0
66818,552,113,49607,439,0
66832,641,131,66810,510,0
66838,932,168,128352,764,0
66853,15,4,44,11,0
66856,1657,315,422730,1342,0
66860,236,50,9300,186,0
66865,1280,232,243136,1048,0
66880,264,56,11648,208,0
66893,1181,246,230010,935,0
66902,1262,259,259777,1003,0
66904,1876,359,544603,1517,0
66907,26,5,105,21,0
66908,1558,313,389685,1245,0
66919,714,137,79049,577,0
66924,793,158,100330,635,0
66925,1552,299,374647,1253,0
66932,2102,402,683400,1700,0
66933,1829,353,521028,1476,0
67001,548,102,45492,446,0
67028,282,50,11600,232,0
67034,819,152,101384,667,0
67036,1657,315,422730,1342,0
67060,2102,402,683400,1700,0
67068,61,9,468,52,0
67069,15,1,14,14,0
67090,124,28,2688,96,0
67104,1331,255,274380,1076,0
67108,64,15,735,49,0
67113,1204,251,239203,953,0
67114,1342,282,298920,1060,0
67117,1552,299,374647,1253,0
67134,950,193,146101,757,0
67144,660,133,69928,527,0
67146,64,15,735,49,0
67147,18,4,56,14,0
67162,2102,402,683400,1700,0
67187,932,168,128352,764,0
67188,641,131,66810,510,0
67200,1204,251,239203,953,0
67206,305,70,16450,235,0
67215,572,130,57460,442,0
67263,1934,345,548205,1589,0
67270,144,29,3335,115,0
67281,61,11,550,50,0
67296,2102,402,683400,1700,0
67314,548,102,45492,446,0
67332,572,130,57460,442,0
67336,88,17,1207,71,0
67372,17,4,52,13,0
67383,1934,345,548205,1589,0
67388,405,82,26486,323,0
67398,821,171,111150,650,0
67413,534,102,44064,432,0
67414,1342,282,298920,1060,0
67417,1331,255,274380,1076,0
67426,819,152,101384,667,0
67429,77,19,1102,58,0
67444,548,102,45492,446,0
67446,60,12,576,48,0
67448,534,102,44064,432,0
67462,164,34,4420,130,0
67465,71,15,840,56,0
67498,68,12,672,56,0
67505,1342,282,298920,1060,0
67516,2102,402,683400,1700,0
67524,380,76,23104,304,0
67529,767,144,89712,623,0
67553,264,56,11648,208,0
67575,1552,299,374647,1253,0
67583,793,158,100330,635,0
67586,1558,313,389685,1245,0
67609,1552,299,374647,1253,0
67622,976,180,143280,796,0
67626,15,4,44,11,0
67643,1583,310,394630,1273,0
67649,976,180,143280,796,0
67674,2102,402,683400,1700,0
67685,1934,345,548205,1589,0
67697,1876,359,544603,1517,0
67707,1934,345,548205,1589,0
67724,185,36,5364,149,0
67731,1280,232,243136,1048,0
67735,323,55,14740,268,0
67737,1181,246,230010,935,0
67739,2102,402,683400,1700,0
67748,2102,402,683400,1700,0
67772,534,102,44064,432,0
67778,160,29,3799,131,0
67783,137,25,2800,112,0
67786,1829,353,521028,1476,0
67802,385,71,22294,314,0
67810,534,102,44064,432,0
67826,56,13,559,43,0
67833,121,27,2538,94,0
67834,1262,259,259777,1003,0
67844,107,19,1672,88,0
67863,572,130,57460,442,0
67864,495,87,35496,408,0
67868,108,17,1547,91,0
67875,1829,353,521028,1476,0
67881,72,17,935,55,0
67884,8,2,12,6,0
67890,373,74,22126,299,0
67891,61,13,624,48,0
67894,64,16,768,48,0
67905,700,128,73216,572,0
67907,821,143,96954,678,0
67915,1204,251,239203,953,0
67921,1204,251,239203,953,0
67924,1583,310,394630,1273,0
67931,155,35,4200,120,0
67942,660,133,69928,527,0
67944,1025,201,165624,824,0
67950,539,101,44238,438,0
67951,77,18,1062,59,0
67952,1411,281,317530,1130,0
67954,778,163,100245,615,0
67982,1331,255,274380,1076,0
67985,1181,246,230010,935,0
67989,1342,282,298920,1060,0
67994,1204,251,239203,953,0
68000,771,137,86858,634,0
68007,535,94,41454,441,0
68030,194,39,6045,155,0
68040,405,82,26486,323,0
68042,120,24,2304,96,0
68053,1342,282,298920,1060,0
68061,572,130,57460,442,0
68072,1078,198,174240,880,0
68093,200,40,6400,160,0
68100,1342,282,298920,1060,0
68106,48,10,380,38,0
68108,793,158,100330,635,0
68111,548,102,45492,446,0
68114,174,36,4968,138,0
68128,767,144,89712,623,0
68156,535,94,41454,441,0
68172,107,18,1602,89,0
68178,976,180,143280,796,0
68188,1876,359,544603,1517,0
68189,1078,198,174240,880,0
68193,443,85,30430,358,0
68202,104,16,1408,88,0
68208,60,12,576,48,0
68213,380,76,23104,304,0
68214,105,22,1826,83,0
68224,2102,402,683400,1700,0
68241,35,6,174,29,0
68262,160,32,4096,128,0
68276,551,102,45798,449,0
68312,124,28,2688,96,0
68316,932,168,128352,764,0
68327,155,27,3456,128,0
68344,146,34,3808,112,0
68345,1876,359,544603,1517,0
68348,121,27,2538,94,0
68356,198,43,6665,155,0
68358,571,114,52098,457,0
68383,1181,246,230010,935,0
68392,793,158,100330,635,0
68412,48,10,380,38,0
68461,61,13,624,48,0
68464,1876,359,544603,1517,0
68476,24,4,80,20,0
68492,1541,306,377910,1235,0
68496,1181,246,230010,935,0
68511,551,102,45798,449,0
68514,227,44,8052,183,0
68515,317,63,16002,254,0
68526,572,130,57460,442,0
68530,1411,281,317530,1130,0
68544,1583,310,394630,1273,0
68550,175,29,4234,146,0
68552,497,97,38800,400,0
68565,373,74,22126,299,0
68569,379,65,20410,314,0
68577,11,3,24,8,0
68587,315,56,14504,259,0
68600,385,71,22294,314,0
68608,1342,282,298920,1060,0
68611,55,11,484,44,0
68631,534,102,44064,432,0
68633,865,167,116566,698,0
68640,1078,198,174240,880,0
68654,568,114,51756,454,0
68660,155,35,4200,120,0
68661,1541,306,377910,1235,0
68674,1558,313,389685,1245,0
68676,1552,299,374647,1253,0
68679,700,128,73216,572,0
68685,1411,281,317530,1130,0
68698,819,152,101384,667,0
68712,405,82,26486,323,0
68716,1552,299,374647,1253,0
68727,1876,359,544603,1517,0
68737,1280,232,243136,1048,0
68743,2102,402,683400,1700,0
68744,217,44,7612,173,0
68746,1342,282,298920,1060,0
68764,1552,299,374647,1253,0
68774,821,143,96954,678,0
68780,534,102,44064,432,0
68785,1262,259,259777,1003,0
68824,1558,313,389685,1245,0
68825,865,167,116566,698,0
68826,497,97,38800,400,0
68829,1078,198,174240,880,0
68831,495,87,35496,408,0
68866,77,12,780,65,0
68881,443,85,30430,358,0
68885,865,167,116566,698,0
68890,21,4,68,17,0
68896,282,50,11600,232,0
68920,778,163,100245,615,0
68923,1411,281,317530,1130,0
68932,362,69,20217,293,0
68933,1262,259,259777,1003,0
68946,1558,313,389685,1245,0
68953,1552,299,374647,1253,0
68956,950,193,146101,757,0
68978,535,94,41454,441,0
68979,463,83,31540,380,0
68980,324,67,17219,257,0
68985,75,19,1064,56,0
68990,771,137,86858,634,0
68991,120,24,2304,96,0
68994,1296,252,263088,1044,0
68997,15,3,36,12,0
69002,819,152,101384,667,0
69013,548,102,45492,446,0
69019,1876,359,544603,1517,0
69020,127,29,2842,98,0
69046,641,131,66810,510,0
69057,35,7,196,28,0
69117,274,57,12369,217,0
69124,324,67,17219,257,0
69128,1262,259,259777,1003,0
69142,401,77,24948,324,0
69147,971,184,144808,787,0
69150,88,17,1207,71,0
69155,1181,246,230010,935,0
69161,1876,359,544603,1517,0
69165,35,8,216,27,0
69173,1541,306,377910,1235,0
69178,65,13,676,52,0
69191,571,114,52098,457,0
69202,1934,345,548205,1589,0
69215,595,121,57354,474,0
69245,1280,232,243136,1048,0
69271,1025,201,165624,824,0
69281,714,137,79049,577,0
69283,1583,310,394630,1273,0
69285,1331,255,274380,1076,0
69308,571,114,52098,457,0
69319,55,10,450,45,0
69320,1331,255,274380,1076,0
69321,1181,246,230010,935,0
69323,28,7,147,21,0
69325,1541,306,377910,1235,0
69337,1541,306,377910,1235,0
69356,415,75,25500,340,0
69359,1541,306,377910,1235,0
69362,1181,246,230010,935,0
69374,160,29,3799,131,0
69376,778,163,100245,615,0
69393,932,168,128352,764,0
69399,122,22,2200,100,0
69401,23,5,90,18,0
69410,1262,259,259777,1003,0
69419,1342,282,298920,1060,0
69421,156,34,4148,122,0
69425,72,13,767,59,0
69429,1829,353,521028,1476,0
69435,660,133,69928,527,0
69436,700,128,73216,572,0
69442,97,22,1650,75,0
69446,1181,246,230010,935,0
69454,2102,402,683400,1700,0
69455,113,20,1860,93,0
69467,135,30,3150,105,0
69469,516,103,42539,413,0
69472,767,144,89712,623,0
69492,2102,402,683400,1700,0
69499,1204,251,239203,953,0
69503,1558,313,389685,1245,0
69506,1280,232,243136,1048,0
69512,273,58,12470,215,0
69517,155,27,3456,128,0
69522,1934,345,548205,1589,0
69526,821,143,96954,678,0
69529,2102,402,683400,1700,0
69562,443,85,30430,358,0
69569,305,70,16450,235,0
69570,1829,353,521028,1476,0
69587,25,3,66,22,0
69595,1541,306,377910,1235,0
69621,120,24,2304,96,0
69641,71,15,840,56,0
69651,1829,353,521028,1476,0
69656,821,171,111150,650,0
69661,35,8,216,27,0
69666,28,7,147,21,0
69678,131,21,2310,110,0
69695,385,71,22294,314,0
69696,767,144,89712,623,0
69734,26,6,120,20,0
69758,595,121,57354,474,0
69783,365,74,21534,291,0
69814,227,44,8052,183,0
69815,1934,345,548205,1589,0
69820,1876,359,544603,1517,0
69845,8,2,12,6,0
69856,1296,252,263088,1044,0
69894,362,69,20217,293,0
69896,497,97,38800,400,0
69898,1181,246,230010,935,0
69922,836,151,103435,685,0
69937,337,74,19462,263,0
69948,1657,315,422730,1342,0
69968,571,114,52098,457,0
69972,193,39,6006,154,0
69974,1934,345,548205,1589,0
69986,61,7,378,54,0
70016,61,13,624,48,0
70028,539,101,44238,438,0
70032,1583,310,394630,1273,0
70046,6,2,8,4,0
70065,1331,255,274380,1076,0
70072,950,193,146101,757,0
70076,37,11,286,26,0
70081,771,137,86858,634,0
70087,516,103,42539,413,0
70094,282,50,11600,232,0
70108,1541,306,377910,1235,0
70120,793,158,100330,635,0
70136,821,143,96954,678,0
70147,535,94,41454,441,0
70149,1411,281,317530,1130,0
70167,551,102,45798,449,0
70194,865,167,116566,698,0
70199,33,5,140,28,0
70202,24,4,80,20,0
70234,516,103,42539,413,0
70239,1541,306,377910,1235,0
70241,405,82,26486,323,0
70244,415,75,25500,340,0
70245,360,66,19404,294,0
70254,950,193,146101,757,0
70256,7,2,10,5,0
70268,821,143,96954,678,0
70273,1558,313,389685,1245,0
70274,198,43,6665,155,0
70276,932,168,128352,764,0
70279,552,113,49607,439,0
70280,1657,315,422730,1342,0
70300,552,113,49607,439,0
70324,155,34,4114,121,0
70326,1411,281,317530,1130,0
70328,337,74,19462,263,0
70362,77,12,780,65,0
70372,1296,252,263088,1044,0
70374,362,69,20217,293,0
70375,55,11,484,44,0
70379,1411,281,317530,1130,0
70383,122,25,2425,97,0
70394,1296,252,263088,1044,0
70397,1552,299,374647,1253,0
70399,1934,345,548205,1589,0
70409,61,14,658,47,0
70411,932,168,128352,764,0
70415,1876,359,544603,1517,0
70427,572,130,57460,442,0
70486,932,168,128352,764,0
70501,1583,310,394630,1273,0
70513,976,180,143280,796,0
70515,365,74,21534,291,0
70516,360,66,19404,294,0
70537,1204,251,239203,953,0
70550,1829,353,521028,1476,0
70555,171,35,4760,136,0
70556,24,4,80,20,0
70557,385,71,22294,314,0
70560,1583,310,394630,1273,0
70576,568,114,51756,454,0
70581,620,121,60379,499,0
70582,2102,402,683400,1700,0
70584,21,4,68,17,0
70587,217,44,7612,173,0
70602,365,74,21534,291,0
70622,535,94,41454,441,0
70624,113,24,2136,89,0
70635,819,152,101384,667,0
70687,1025,201,165624,824,0
70689,127,29,2842,98,0
70703,385,71,22294,314,0
70721,1829,353,521028,1476,0
70732,548,102,45492,446,0
70735,44,10,340,34,0
70736,1552,299,374647,1253,0
70738,1829,353,521028,1476,0
70740,37,10,270,27,0
70743,534,102,44064,432,0
70748,516,103,42539,413,0
70754,34,7,189,27,0
70759,1025,201,165624,824,0
70764,551,102,45798,449,0
70769,568,114,51756,454,0
70786,1025,201,165624,824,0
70787,771,137,86858,634,0
70789,1657,315,422730,1342,0
70793,1876,359,544603,1517,0
70794,34,7,189,27,0
70799,385,71,22294,314,0
70849,171,35,4760,136,0
70864,1829,353,521028,1476,0
70891,771,137,86858,634,0
70896,836,151,103435,685,0
70930,1876,359,544603,1517,0
70936,200,40,6400,160,0
70937,185,36,5364,149,0
70938,365,74,21534,291,0
70945,1829,353,521028,1476,0
70948,60,12,576,48,0
70999,836,151,103435,685,0
71013,821,143,96954,678,0
71016,1280,232,243136,1048,0
71032,1934,345,548205,1589,0
71034,207,41,6806,166,0
71049,1262,259,259777,1003,0
71054,767,144,89712,623,0
71076,793,158,100330,635,0
71125,282,50,11600,232,0
71133,1876,359,544603,1517,0
71134,52,10,420,42,0
71152,2102,402,683400,1700,0
71160,1583,310,394630,1273,0
71170,551,102,45798,449,0
71187,1829,353,521028,1476,0
71200,122,25,2425,97,0
71204,156,34,4148,122,0
71208,821,171,111150,650,0
71216,714,137,79049,577,0
71224,156,34,4148,122,0
71226,274,57,12369,217,0
71230,1657,315,422730,1342,0
71241,620,121,60379,499,0
71265,1934,345,548205,1589,0
71274,1934,345,548205,1589,0
71276,836,151,103435,685,0
71281,534,102,44064,432,0
71287,568,114,51756,454,0
71299,778,163,100245,615,0
71302,1558,313,389685,1245,0
71314,595,120,57000,475,0
71329,217,44,7612,173,0
71330,317,63,16002,254,0
71334,1657,315,422730,1342,0
71337,1411,281,317530,1130,0
71360,373,74,22126,299,0
71368,236,50,9300,186,0
71375,700,128,73216,572,0
71381,1181,246,230010,935,0
71399,551,102,45798,449,0
71411,595,120,57000,475,0
71443,102,20,1640,82,0
71456,1876,359,544603,1517,0
71475,75,19,1064,56,0
71482,1876,359,544603,1517,0
71486,497,97,38800,400,0
71489,366,70,20720,296,0
71493,539,101,44238,438,0
71496,767,144,89712,623,0
71499,1876,359,544603,1517,0
71509,767,144,89712,623,0
71517,373,74,22126,299,0
71549,198,43,6665,155,0
71557,1829,353,521028,1476,0
71559,700,128,73216,572,0
71565,1558,313,389685,1245,0
71572,539,101,44238,438,0
71578,120,24,2304,96,0
71610,1342,282,298920,1060,0
71626,819,152,101384,667,0
71627,119,25,2350,94,0
71644,360,66,19404,294,0
71645,365,74,21534,291,0
71649,324,67,17219,257,0
71656,337,74,19462,263,0
71680,950,193,146101,757,0
71686,1829,353,521028,1476,0
71693,385,71,22294,314,0
71698,865,167,116566,698,0
71708,1583,310,394630,1273,0
71714,2102,402,683400,1700,0
71719,1558,313,389685,1245,0
71733,1181,246,230010,935,0
71738,595,120,57000,475,0
71744,121,27,2538,94,0
71747,976,180,143280,796,0
71754,274,57,12369,217,0
71783,771,137,86858,634,0
71789,771,137,86858,634,0
71797,58,12,552,46,0
71803,1657,315,422730,1342,0
71823,56,13,559,43,0
71826,58,12,552,46,0
71829,60,12,576,48,0
71842,1876,359,544603,1517,0
71855,495,87,35496,408,0
71891,1552,299,374647,1253,0
71893,415,75,25500,340,0
71914,2102,402,683400,1700,0
71961,155,34,4114,121,0
71965,106,19,1653,87,0
71969,324,67,17219,257,0
71981,13,3,30,10,0
71986,200,40,6400,160,0
71993,156,34,4148,122,0
71994,156,34,4148,122,0
72018,1262,259,259777,1003,0
72043,1876,359,544603,1517,0
72047,1829,353,521028,1476,0
72062,551,102,45798,449,0
72081,401,77,24948,324,0
72087,516,103,42539,413,0
72102,1558,313,389685,1245,0
72130,207,41,6806,166,0
72150,534,102,44064,432,0
72182,778,163,100245,615,0
72208,1583,310,394630,1273,0
72228,366,70,20720,296,0
72242,1876,359,544603,1517,0
72245,572,130,57460,442,0
72253,401,77,24948,324,0
72256,42,5,185,37,0
72257,1280,232,243136,1048,0
72266,415,75,25500,340,0
72285,767,144,89712,623,0
72287,1583,310,394630,1273,0
72296,1296,252,263088,1044,0
72303,305,70,16450,235,0
72308,2102,402,683400,1700,0
72314,207,41,6806,166,0
72321,1583,310,394630,1273,0
72348,1934,345,548205,1589,0
72356,572,130,57460,442,0
72360,1342,282,298920,1060,0
72363,971,184,144808,787,0
72367,778,163,100245,615,0
72373,49,9,360,40,0
72374,405,82,26486,323,0
72397,1204,251,239203,953,0
72400,548,102,45492,446,0
72412,68,14,756,54,0
72414,976,180,143280,796,0
72422,1829,353,521028,1476,0
72439,971,184,144808,787,0
72477,539,101,44238,438,0
72499,767,144,89712,623,0
72542,193,39,6006,154,0
72554,932,168,128352,764,0
72556,463,83,31540,380,0
72563,932,168,128352,764,0
72568,821,171,111150,650,0
72570,134,30,3120,104,0
72573,122,20,2040,102,0
72595,366,70,20720,296,0
72597,2102,402,683400,1700,0
72600,337,74,19462,263,0
72621,1583,310,394630,1273,0
72622,572,130,57460,442,0
72626,1876,359,544603,1517,0
72628,1541,306,377910,1235,0
72661,2102,402,683400,1700,0
72664,534,102,44064,432,0
72668,119,25,2350,94,0
72698,148,24,2976,124,0
72702,1331,255,274380,1076,0
72715,571,114,52098,457,0
72751,146,34,3808,112,0
72756,135,30,3150,105,0
72760,552,113,49607,439,0
72773,1262,259,259777,1003,0
72786,1552,299,374647,1253,0
72789,1262,259,259777,1003,0
72794,950,193,146101,757,0
72814,385,71,22294,314,0
72846,405,82,26486,323,0
72848,1342,282,298920,1060,0
72849,104,16,1408,88,0
72862,107,19,1672,88,0
72879,548,102,45492,446,0
72883,110,18,1656,92,0
72890,145,23,2806,122,0
72894,1331,255,274380,1076,0
72929,127,29,2842,98,0
72969,160,32,4096,128,0
73000,463,83,31540,380,0
73019,595,120,57000,475,0
73029,1078,198,174240,880,0
73039,793,158,100330,635,0
73044,1876,359,544603,1517,0
73056,1204,251,239203,953,0
73058,395,72,23256,323,0
73068,1657,315,422730,1342,0
73072,971,184,144808,787,0
73084,819,152,101384,667,0
73093,1078,198,174240,880,0
73097,497,97,38800,400,0
73107,641,131,66810,510,0
73110,1280,232,243136,1048,0
73149,551,102,45798,449,0
73167,821,143,96954,678,0
73172,107,19,1672,88,0
73174,2102,402,683400,1700,0
73198,144,29,3335,115,0
73200,122,22,2200,100,0
73208,97,22,1650,75,0
73217,950,193,146101,757,0
73228,971,184,144808,787,0
73233,865,167,116566,698,0
73234,1025,201,165624,824,0
73235,164,34,4420,130,0
73248,2102,402,683400,1700,0
73299,1541,306,377910,1235,0
73314,395,72,23256,323,0
73321,497,97,38800,400,0
73348,660,133,69928,527,0
73355,1181,246,230010,935,0
73357,401,77,24948,324,0
73374,1829,353,521028,1476,0
73389,337,74,19462,263,0
73390,164,34,4420,130,0
73401,77,17,1020,60,0
73421,1552,299,374647,1253,0
73423,1181,246,230010,935,0
73433,1204,251,239203,953,0
73443,415,75,25500,340,0
73451,778,163,100245,615,0
73463,836,151,103435,685,0
73472,1829,353,521028,1476,0
73486,2102,402,683400,1700,0
73524,552,113,49607,439,0
73528,443,85,30430,358,0
73531,112,18,1692,94,0
73534,32,5,135,27,0
73561,77,19,1102,58,0
73574,119,25,2350,94,0
73587,207,41,6806,166,0
73605,620,121,60379,499,0
73607,72,17,935,55,0
73624,659,132,69928,527,0
73631,124,28,2688,96,0
73641,1181,246,230010,935,0
73644,572,130,57460,442,0
73653,2102,402,683400,1700,0
73657,950,193,146101,757,0
73667,551,102,45798,449,0
73672,1411,281,317530,1130,0
73678,131,21,2310,110,0
73694,534,102,44064,432,0
73696,534,102,44064,432,0
73713,714,137,79049,577,0
73724,122,22,2200,100,0
73741,1657,315,422730,1342,0
73779,1552,299,374647,1253,0
73783,767,144,89712,623,0
73786,1025,201,165624,824,0
73817,1204,251,239203,953,0
73830,836,151,103435,685,0
73835,148,24,2976,124,0
73839,821,143,96954,678,0
73874,122,25,2425,97,0
73883,1934,345,548205,1589,0
73894,34,7,189,27,0
73934,1657,315,422730,1342,0
73944,620,121,60379,499,0
73971,401,77,24948,324,0
73973,119,25,2350,94,0
73980,976,180,143280,796,0
73996,1342,282,298920,1060,0
74007,950,193,146101,757,0
74011,641,131,66810,510,0
74026,771,137,86858,634,0
74059,971,184,144808,787,0
74067,821,143,96954,678,0
74073,135,30,3150,105,0
74076,700,128,73216,572,0
74093,305,70,16450,235,0
74096,836,151,103435,685,0
74100,175,29,4234,146,0
74104,641,131,66810,510,0
74109,1411,281,317530,1130,0
74125,346,76,20520,270,0
74145,1552,299,374647,1253,0
74157,175,29,4234,146,0
74176,568,114,51756,454,0
74180,1025,201,165624,824,0
74208,1204,251,239203,953,0
74215,1078,198,174240,880,0
74218,660,133,69928,527,0
74233,2102,402,683400,1700,0
74246,1657,315,422730,1342,0
74256,595,120,57000,475,0
74272,1552,299,374647,1253,0
74300,1934,345,548205,1589,0
74307,1204,251,239203,953,0
74310,194,39,6045,155,0
74311,2102,402,683400,1700,0
74314,37,10,270,27,0
74317,85,18,1206,67,0
74321,1262,259,259777,1003,0
74333,1181,246,230010,935,0
74371,380,76,23104,304,0
74373,836,151,103435,685,0
74374,395,72,23256,323,0
74380,198,43,6665,155,0
74395,52,10,420,42,0
74398,56,13,559,43,0
74413,366,70,20720,296,0
74417,1657,315,422730,1342,0
74418,641,131,66810,510,0
74423,534,102,44064,432,0
74478,120,24,2304,96,0
74480,36,6,180,30,0
74483,198,43,6665,155,0
74501,194,39,6045,155,0
74503,932,168,128352,764,0
74516,778,163,100245,615,0
74520,2102,402,683400,1700,0
74524,1657,315,422730,1342,0
74525,552,113,49607,439,0
74530,401,77,24948,324,0
74533,264,56,11648,208,0
74534,568,114,51756,454,0
74537,2102,402,683400,1700,0
74542,551,102,45798,449,0
74554,77,18,1062,59,0
74561,1411,281,317530,1130,0
74580,1204,251,239203,953,0
74606,821,143,96954,678,0
74619,595,120,57000,475,0
74667,1541,306,377910,1235,0
74672,548,102,45492,446,0
74679,1552,299,374647,1253,0
74689,1296,252,263088,1044,0
74691,362,69,20217,293,0
74702,620,121,60379,499,0
74735,68,12,672,56,0
74737,495,87,35496,408,0
74748,495,87,35496,408,0
74750,134,30,3120,104,0
74767,1876,359,544603,1517,0
74795,1078,198,174240,880,0
74800,539,101,44238,438,0
74801,516,103,42539,413,0
74831,821,171,111150,650,0
74837,2102,402,683400,1700,0
74844,1280,232,243136,1048,0
74852,778,163,100245,615,0
74860,865,167,116566,698,0
74883,836,151,103435,685,0
74887,14,3,33,11,0
74889,865,167,116566,698,0
74890,1280,232,243136,1048,0
74894,2102,402,683400,1700,0
74908,32,6,156,26,0
74924,1829,353,521028,1476,0
74931,2102,402,683400,1700,0
74934,31,8,184,23,0
74945,1552,299,374647,1253,0
74953,1181,246,230010,935,0
74955,2102,402,683400,1700,0
74956,1411,281,317530,1130,0
74970,1331,255,274380,1076,0
74979,2102,402,683400,1700,0
74980,2102,402,683400,1700,0
74990,700,128,73216,572,0
74991,101,20,1620,81,0
74995,1934,345,548205,1589,0
75029,572,130,57460,442,0
75032,1331,255,274380,1076,0
75067,552,113,49607,439,0
75098,346,76,20520,270,0
75103,1552,299,374647,1253,0
75125,548,102,45492,446,0
75144,57,7,350,50,0
75147,1181,246,230010,935,0
75158,1262,259,259777,1003,0
75167,317,63,16002,254,0
75183,198,43,6665,155,0
75184,1934,345,548205,1589,0
75201,379,65,20410,314,0
75205,865,167,116566,698,0
75223,1934,345,548205,1589,0
75230,145,23,2806,122,0
75238,174,36,4968,138,0
75274,395,72,23256,323,0
75280,932,168,128352,764,0
75316,535,94,41454,441,0
75344,971,184,144808,787,0
75347,572,130,57460,442,0
75384,1280,232,243136,1048,0
75400,836,151,103435,685,0
75407,35,8,216,27,0
75424,767,144,89712,623,0
75444,1541,306,377910,1235,0
75449,641,131,66810,510,0
75456,16,3,39,13,0
75476,11,2,18,9,0
75479,1657,315,422730,1342,0
75482,2102,402,683400,1700,0
75497,700,128,73216,572,0
75504,200,40,6400,160,0
75513,950,193,146101,757,0
75516,568,114,51756,454,0
75528,1829,353,521028,1476,0
75532,405,82,26486,323,0
75534,77,17,1020,60,0
75538,1342,282,298920,1060,0
75539,113,20,1860,93,0
75541,134,30,3120,104,0
75550,360,66,19404,294,0
75576,1331,255,274380,1076,0
75584,273,58,12470,215,0
75599,146,34,3808,112,0
75628,1583,310,394630,1273,0
75632,395,72,23256,323,0
75655,1934,345,548205,1589,0
75659,495,87,35496,408,0
75660,1541,306,377910,1235,0
75663,106,19,1653,87,0
75670,1583,310,394630,1273,0
75680,1204,251,239203,953,0
75687,1331,255,274380,1076,0
75689,534,102,44064,432,0
75708,571,114,52098,457,0
75715,1829,353,521028,1476,0
75723,1558,313,389685,1245,0
75729,2102,402,683400,1700,0
75738,379,65,20410,314,0
75740,1204,251,239203,953,0
75741,104,16,1408,88,0
75743,1934,345,548205,1589,0
75754,1342,282,298920,1060,0
75757,415,75,25500,340,0
75768,1262,259,259777,1003,0
75772,771,137,86858,634,0
75774,571,114,52098,457,0
75780,1552,299,374647,1253,0
75781,1181,246,230010,935,0
75787,17,6,66,11,0
75792,1331,255,274380,1076,0
75794,385,71,22294,314,0
75799,767,144,89712,623,0
75803,1280,232,243136,1048,0
75816,976,180,143280,796,0
75822,714,137,79049,577,0
75826,2102,402,683400,1700,0
75831,113,24,2136,89,0
75843,171,35,4760,136,0
75848,1876,359,544603,1517,0
75877,714,137,79049,577,0
75878,77,18,1062,59,0
75889,1078,198,174240,880,0
75900,2102,402,683400,1700,0
75907,571,114,52098,457,0
75926,1078,198,174240,880,0
75932,274,57,12369,217,0
75933,821,143,96954,678,0
75942,198,43,6665,155,0
75963,1181,246,230010,935,0
75970,821,143,96954,678,0
75972,548,102,45492,446,0
75979,1558,313,389685,1245,0
76004,200,40,6400,160,0
76005,1876,359,544603,1517,0
76017,110,27,2241,83,0
76018,821,171,111150,650,0
76046,1583,310,394630,1273,0
76078,1331,255,274380,1076,0
76089,516,103,42539,413,0
76095,497,97,38800,400,0
76118,198,43,6665,155,0
76128,21,3,54,18,0
76135,273,58,12470,215,0
76160,40,9,279,31,0
76171,700,128,73216,572,0
76173,1583,310,394630,1273,0
76201,534,102,44064,432,0
76208,236,50,9300,186,0
76221,1558,313,389685,1245,0
76229,1181,246,230010,935,0
76238,571,114,52098,457,0
76254,551,102,45798,449,0
76266,571,114,52098,457,0
76278,1025,201,165624,824,0
76283,595,121,57354,474,0
76296,1331,255,274380,1076,0
76301,1204,251,239203,953,0
76317,821,143,96954,678,0
76325,77,17,1020,60,0
76333,1829,353,521028,1476,0
76346,1829,353,521028,1476,0
76347,1342,282,298920,1060,0
76363,1204,251,239203,953,0
76368,164,34,4420,130,0
76380,323,55,14740,268,0
76383,1934,345,548205,1589,0
76386,68,14,756,54,0
76391,2102,402,683400,1700,0
76395,1411,281,317530,1130,0
76429,148,24,2976,124,0
76462,1829,353,521028,1476,0
76465,1280,232,243136,1048,0
76472,160,32,4096,128,0
76479,395,72,23256,323,0
76505,1657,315,422730,1342,0
76509,365,74,21534,291,0
76515,171,35,4760,136,0
76545,950,193,146101,757,0
76550,21,3,54,18,0
76551,1262,259,259777,1003,0
76552,2102,402,683400,1700,0
76558,373,74,22126,299,0
76559,660,133,69928,527,0
76574,819,152,101384,667,0
76588,1262,259,259777,1003,0
76602,932,168,128352,764,0
76604,1181,246,230010,935,0
76615,305,70,16450,235,0
76620,88,17,1207,71,0
76629,778,163,100245,615,0
76650,385,71,22294,314,0
76654,155,35,4200,120,0
76657,1657,315,422730,1342,0
76658,20,5,75,15,0
76707,373,74,22126,299,0
76710,1934,345,548205,1589,0
76721,819,152,101384,667,0
76726,821,171,111150,650,0
76771,1552,299,374647,1253,0
76779,64,16,768,48,0
76781,317,63,16002,254,0
76801,821,143,96954,678,0
76830,395,72,23256,323,0
76835,122,25,2425,97,0
76842,2102,402,683400,1700,0
76846,2102,402,683400,1700,0
76852,1829,353,521028,1476,0
76855,102,20,1640,82,0
76857,1583,310,394630,1273,0
76865,32,5,135,27,0
76868,41,8,264,33,0
76888,321,54,14418,267,0
76900,552,113,49607,439,0
76905,1558,313,389685,1245,0
76923,443,85,30430,358,0
76927,1411,281,317530,1130,0
76934,620,121,60379,499,0
76940,641,131,66810,510,0
76964,836,151,103435,685,0
76966,771,137,86858,634,0
76978,1876,359,544603,1517,0
76982,1342,282,298920,1060,0
77002,360,66,19404,294,0
77003,836,151,103435,685,0
77014,793,158,100330,635,0
77016,572,130,57460,442,0
77035,836,151,103435,685,0
77055,1829,353,521028,1476,0
77084,497,97,38800,400,0
77085,160,32,4096,128,0
77125,315,56,14504,259,0
77139,771,137,86858,634,0
77150,198,43,6665,155,0
77172,40,7,231,33,0
77173,971,184,144808,787,0
77177,21,4,68,17,0
77190,401,77,24948,324,0
77196,595,120,57000,475,0
77204,346,76,20520,270,0
77226,660,133,69928,527,0
77240,534,102,44064,432,0
77242,35,7,196,28,0
77273,1181,246,230010,935,0
77275,2102,402,683400,1700,0
77277,443,85,30430,358,0
77280,35,9,234,26,0
77296,1262,259,259777,1003,0
77302,46,9,333,37,0
77314,932,168,128352,764,0
77316,380,76,23104,304,0
77341,1204,251,239203,953,0
77351,793,158,100330,635,0
77366,124,28,2688,96,0
77378,1342,282,298920,1060,0
77380,110,27,2241,83,0
77396,767,144,89712,623,0
77409,1411,281,317530,1130,0
77419,443,85,30430,358,0
77421,463,83,31540,380,0
77431,1583,310,394630,1273,0
77436,595,121,57354,474,0
77437,571,114,52098,457,0
77443,1657,315,422730,1342,0
77458,1078,198,174240,880,0
77463,950,193,146101,757,0
77467,171,35,4760,136,0
77468,976,180,143280,796,0
77470,65,13,676,52,0
77483,305,70,16450,235,0
77506,1280,232,243136,1048,0
77515,107,19,1672,88,0
77536,1181,246,230010,935,0
77538,1342,282,298920,1060,0
77555,18,5,65,13,0
77560,1181,246,230010,935,0
77562,1025,201,165624,824,0
77565,97,22,1650,75,0
77576,11,4,28,7,0
77592,819,152,101384,667,0
77595,976,180,143280,796,0
77601,274,57,12369,217,0
77606,1558,313,389685,1245,0
77625,865,167,116566,698,0
77660,463,83,31540,380,0
77669,362,69,20217,293,0
77677,1829,353,521028,1476,0
77691,77,19,1102,58,0
77717,767,144,89712,623,0
77721,1558,313,389685,1245,0
77732,1181,246,230010,935,0
77733,1876,359,544603,1517,0
77739,2102,402,683400,1700,0
77740,1657,315,422730,1342,0
77752,1181,246,230010,935,0
77766,1829,353,521028,1476,0
77773,252,45,9315,207,0
77782,324,67,17219,257,0
77783,836,151,103435,685,0
77830,865,167,116566,698,0
77840,771,137,86858,634,0
77854,1552,299,374647,1253,0
77868,1262,259,259777,1003,0
77877,362,69,20217,293,0
77884,572,130,57460,442,0
77887,821,171,111150,650,0
77907,572,130,57460,442,0
77908,771,137,86858,634,0
77914,771,137,86858,634,0
77916,1541,306,377910,1235,0
77917,1552,299,374647,1253,0
77933,819,152,101384,667,0
77952,360,66,19404,294,0
77958,548,102,45492,446,0
77961,415,75,25500,340,0
77969,273,58,12470,215,0
77979,534,102,44064,432,0
77982,1934,345,548205,1589,0
77997,373,74,22126,299,0
78029,595,121,57354,474,0
78047,200,40,6400,160,0
78057,700,128,73216,572,0
78060,534,102,44064,432,0
78061,660,133,69928,527,0
78065,70,15,825,55,0
78067,54,14,560,40,0
78071,134,30,3120,104,0
78083,236,50,9300,186,0
78125,552,113,49607,439,0
78132,365,74,21534,291,0
78140,323,55,14740,268,0
78148,700,128,73216,572,0
78150,971,184,144808,787,0
78151,1829,353,521028,1476,0
78155,771,137,86858,634,0
78160,551,102,45798,449,0
78164,552,113,49607,439,0
78190,1541,306,377910,1235,0
78207,113,20,1860,93,0
78218,156,34,4148,122,0
78219,148,24,2976,124,0
78241,1411,281,317530,1130,0
78250,1829,353,521028,1476,0
78277,1262,259,259777,1003,0
78298,1204,251,239203,953,0
78307,1025,201,165624,824,0
78311,264,56,11648,208,0
78316,443,85,30430,358,0
78324,778,163,100245,615,0
78325,976,180,143280,796,0
78341,24,4,80,20,0
78343,821,171,111150,650,0
78344,971,184,144808,787,0
78371,539,101,44238,438,0
78374,77,12,780,65,0
78382,2102,402,683400,1700,0
78386,1204,251,239203,953,0
78395,1296,252,263088,1044,0
78403,1025,201,165624,824,0
78427,516,103,42539,413,0
78443,1829,353,521028,1476,0
78452,1934,345,548205,1589,0
78466,11,1,10,10,0
78476,2102,402,683400,1700,0
78485,771,137,86858,634,0
78498,1934,345,548205,1589,0
78527,1296,252,263088,1044,0
78536,323,55,14740,268,0
78539,1541,306,377910,1235,0
78541,778,163,100245,615,0
78555,552,113,49607,439,0
78559,932,168,128352,764,0
78571,1296,252,263088,1044,0
78576,1876,359,544603,1517,0
78614,932,168,128352,764,0
78641,571,114,52098,457,0
78656,865,167,116566,698,0
78665,971,184,144808,787,0
78680,1025,201,165624,824,0
78682,1876,359,544603,1517,0
78685,2102,402,683400,1700,0
78693,122,20,2040,102,0
78711,778,163,100245,615,0
78724,107,18,1602,89,0
78734,119,25,2350,94,0
78736,971,184,144808,787,0
78738,68,14,756,54,0
78741,1876,359,544603,1517,0
78753,976,180,143280,796,0
78755,865,167,116566,698,0
78756,535,94,41454,441,0
78763,1296,252,263088,1044,0
78766,659,132,69928,527,0
78768,11,2,18,9,0
78771,1558,313,389685,1245,0
78772,1342,282,298920,1060,0
78779,1025,201,165624,824,0
78809,1025,201,165624,824,0
78816,595,120,57000,475,0
78823,1552,299,374647,1253,0
78837,127,29,2842,98,0
78897,771,137,86858,634,0
78903,778,163,100245,615,0
78921,1078,198,174240,880,0
78939,819,152,101384,667,0
78946,1411,281,317530,1130,0
78950,360,66,19404,294,0
78954,1181,246,230010,935,0
78972,1411,281,317530,1130,0
78976,1541,306,377910,1235,0
78983,26,8,144,18,0
78984,2102,402,683400,1700,0
78987,551,102,45798,449,0
78992,346,76,20520,270,0
78996,52,10,420,42,0
78997,572,130,57460,442,0
78998,821,143,96954,678,0
79010,410,76,25384,334,0
79026,337,74,19462,263,0
79027,1541,306,377910,1235,0
79035,200,40,6400,160,0
79038,595,121,57354,474,0
79044,1552,299,374647,1253,0
79055,971,184,144808,787,0
79056,971,184,144808,787,0
79060,2102,402,683400,1700,0
79062,186,35,5285,151,0
79065,865,167,116566,698,0
79079,337,74,19462,263,0
79085,821,171,111150,650,0
79094,1876,359,544603,1517,0
79097,1296,252,263088,1044,0
79100,108,17,1547,91,0
79103,324,67,17219,257,0
79111,365,74,21534,291,0
79127,1078,198,174240,880,0
79128,660,133,69928,527,0
79131,976,180,143280,796,0
79157,1934,345,548205,1589,0
79170,571,114,52098,457,0
79175,1934,345,548205,1589,0
79182,107,19,1672,88,0
79197,793,158,100330,635,0
79240,1934,345,548205,1589,0
79248,659,132,69928,527,0
79259,324,67,17219,257,0
79263,700,128,73216,572,0
79293,2102,402,683400,1700,0
79294,793,158,100330,635,0
79333,305,70,16450,235,0
79342,156,34,4148,122,0
79344,1657,315,422730,1342,0
79351,778,163,100245,615,0
79360,1934,345,548205,1589,0
79378,401,77,24948,324,0
79384,273,58,12470,215,0
79392,1296,252,263088,1044,0
79406,1657,315,422730,1342,0
79408,548,102,45492,446,0
79415,1541,306,377910,1235,0
79419,767,144,89712,623,0
79424,950,193,146101,757,0
79449,2102,402,683400,1700,0
79452,572,130,57460,442,0
79455,365,74,21534,291,0
79464,5,1,4,4,0
79506,836,151,103435,685,0
79508,821,143,96954,678,0
79513,55,10,450,45,0
79528,89,15,1110,74,0
79547,127,29,2842,98,0
79575,1204,251,239203,953,0
79598,1552,299,374647,1253,0
79620,323,55,14740,268,0
79630,1204,251,239203,953,0
79639,346,76,20520,270,0
79643,821,171,111150,650,0
79644,1876,359,544603,1517,0
79660,217,44,7612,173,0
79666,44,10,340,34,0
79676,401,77,24948,324,0
79687,385,71,22294,314,0
79688,1829,353,521028,1476,0
79702,1541,306,377910,1235,0
79705,1331,255,274380,1076,0
79733,778,163,100245,615,0
79746,1876,359,544603,1517,0
79750,595,120,57000,475,0
79758,1342,282,298920,1060,0
79766,534,102,44064,432,0
79774,1552,299,374647,1253,0
79779,113,24,2136,89,0
79788,385,71,22294,314,0
79803,135,30,3150,105,0
79805,2102,402,683400,1700,0
79811,1934,345,548205,1589,0
79827,273,58,12470,215,0
79840,35,6,174,29,0
79847,1262,259,259777,1003,0
79864,122,25,2425,97,0
79881,2102,402,683400,1700,0
79892,337,74,19462,263,0
79895,273,58,12470,215,0
79896,1280,232,243136,1048,0
79906,135,30,3150,105,0
79918,1934,345,548205,1589,0
79933,1541,306,377910,1235,0
79935,68,14,756,54,0
79942,1296,252,263088,1044,0
79956,1829,353,521028,1476,0
79975,68,12,672,56,0
79981,516,103,42539,413,0
80005,1204,251,239203,953,0
80015,778,163,100245,615,0
80023,346,76,20520,270,0
80024,548,102,45492,446,0
80045,1657,315,422730,1342,0
80082,700,128,73216,572,0
80112,1657,315,422730,1342,0
80136,495,87,35496,408,0
80155,950,193,146101,757,0
80182,1583,310,394630,1273,0
80215,950,193,146101,757,0
80241,778,163,100245,615,0
80245,1657,315,422730,1342,0
80255,405,82,26486,323,0
80260,595,120,57000,475,0
80262,793,158,100330,635,0
80267,61,8,424,53,0
80279,321,54,14418,267,0
80303,819,152,101384,667,0
80304,1342,282,298920,1060,0
80311,1025,201,165624,824,0
80331,865,167,116566,698,0
80332,1342,282,298920,1060,0
80344,568,114,51756,454,0
80361,1829,353,521028,1476,0
80390,1280,232,243136,1048,0
80395,1552,299,374647,1253,0
80402,1025,201,165624,824,0
80407,2102,402,683400,1700,0
80418,1262,259,259777,1003,0
80419,1181,246,230010,935,0
80421,771,137,86858,634,0
80424,1583,310,394630,1273,0
80429,274,57,12369,217,0
80432,771,137,86858,634,0
80440,778,163,100245,615,0
80450,385,71,22294,314,0
80454,1552,299,374647,1253,0
80475,69,12,684,57,0
80476,227,44,8052,183,0
80491,362,69,20217,293,0
80498,1342,282,298920,1060,0
80505,1541,306,377910,1235,0
80514,660,133,69928,527,0
80568,2102,402,683400,1700,0
80570,6,2,8,4,0
80595,264,56,11648,208,0
80652,1025,201,165624,824,0
80654,771,137,86858,634,0
80676,75,19,1064,56,0
80688,819,152,101384,667,0
80697,1204,251,239203,953,0
80700,1934,345,548205,1589,0
80711,1583,310,394630,1273,0
80740,767,144,89712,623,0
80746,160,29,3799,131,0
80747,410,76,25384,334,0
80755,821,171,111150,650,0
80763,365,74,21534,291,0
80786,1829,353,521028,1476,0
80791,572,130,57460,442,0
80817,282,50,11600,232,0
80841,1280,232,243136,1048,0
80855,122,25,2425,97,0
80860,836,151,103435,685,0
80865,1829,353,521028,1476,0
80868,1583,310,394630,1273,0
80883,1558,313,389685,1245,0
80889,1934,345,548205,1589,0
80891,568,114,51756,454,0
80896,714,137,79049,577,0
80901,971,184,144808,787,0
80903,865,167,116566,698,0
80910,61,8,424,53,0
80913,61,13,624,48,0
80919,516,103,42539,413,0
80927,1411,281,317530,1130,0
80930,1342,282,298920,1060,0
80933,1829,353,521028,1476,0
80953,1934,345,548205,1589,0
80954,660,133,69928,527,0
80955,1296,252,263088,1044,0
80978,1583,310,394630,1273,0
80981,1541,306,377910,1235,0
80982,360,66,19404,294,0
80998,365,74,21534,291,0
81001,771,137,86858,634,0
81012,539,101,44238,438,0
81013,65,17,816,48,0
81029,227,44,8052,183,0
81062,1296,252,263088,1044,0
81075,821,171,111150,650,0
81086,1829,353,521028,1476,0
81087,1552,299,374647,1253,0
81088,1657,315,422730,1342,0
81089,1342,282,298920,1060,0
81097,55,10,450,45,0
81135,18,3,45,15,0
81138,11,4,28,7,0
81146,346,76,20520,270,0
81156,1262,259,259777,1003,0
81170,108,17,1547,91,0
81173,217,44,7612,173,0
81183,865,167,116566,698,0
81184,571,114,52098,457,0
81223,1296,252,263088,1044,0
81230,497,97,38800,400,0
81234,714,137,79049,577,0
81249,252,45,9315,207,0
81258,1342,282,298920,1060,0
81259,819,152,101384,667,0
81267,362,69,20217,293,0
81319,793,158,100330,635,0
81338,1411,281,317530,1130,0
81342,552,113,49607,439,0
81345,1541,306,377910,1235,0
81354,836,151,103435,685,0
81356,1296,252,263088,1044,0
81366,1552,299,374647,1253,0
81370,346,76,20520,270,0
81371,97,22,1650,75,0
81381,1181,246,230010,935,0
81387,620,121,60379,499,0
81391,324,67,17219,257,0
81397,52,11,451,41,0
81398,1876,359,544603,1517,0
81403,362,69,20217,293,0
81420,641,131,66810,510,0
81426,198,43,6665,155,0
81447,1296,252,263088,1044,0
81459,1262,259,259777,1003,0
81465,145,23,2806,122,0
81477,595,121,57354,474,0
81486,11,4,28,7,0
81496,19,3,48,16,0
81529,1657,315,422730,1342,0
81603,1558,313,389685,1245,0
81614,1829,353,521028,1476,0
81616,1583,310,394630,1273,0
81617,217,44,7612,173,0
81641,568,114,51756,454,0
81644,110,18,1656,92,0
81648,324,67,17219,257,0
81651,1934,345,548205,1589,0
81661,1558,313,389685,1245,0
81678,1583,310,394630,1273,0
81681,1262,259,259777,1003,0
81712,14,3,33,11,0
81724,405,82,26486,323,0
81746,346,76,20520,270,0
81762,1411,281,317530,1130,0
81790,410,76,25384,334,0
81794,571,114,52098,457,0
81804,714,137,79049,577,0
81805,539,101,44238,438,0
81812,119,22,2134,97,0
81814,443,85,30430,358,0
81819,1181,246,230010,935,0
81840,821,171,111150,650,0
81850,1204,251,239203,953,0
81879,365,74,21534,291,0
81896,1411,281,317530,1130,0
81901,771,137,86858,634,0
81905,1204,251,239203,953,0
81911,1934,345,548205,1589,0
81937,659,132,69928,527,0
81940,1280,232,243136,1048,0
81956,865,167,116566,698,0
81994,185,36,5364,149,0
82016,131,21,2310,110,0
82032,551,102,45798,449,0
82036,379,65,20410,314,0
82042,122,25,2425,97,0
82045,1280,232,243136,1048,0
82046,1558,313,389685,1245,0
82047,1829,353,521028,1476,0
82053,595,120,57000,475,0
82056,1025,201,165624,824,0
82070,193,39,6006,154,0
82084,42,5,185,37,0
82104,976,180,143280,796,0
82113,836,151,103435,685,0
82114,932,168,128352,764,0
82117,1280,232,243136,1048,0
82146,1296,252,263088,1044,0
82148,793,158,100330,635,0
82159,47,11,396,36,0
82167,58,12,552,46,0
82168,1934,345,548205,1589,0
82186,1558,313,389685,1245,0
82188,324,67,17219,257,0
82193,373,74,22126,299,0
82196,1876,359,544603,1517,0
82206,156,34,4148,122,0
82211,401,77,24948,324,0
82228,1829,353,521028,1476,0
82229,1541,306,377910,1235,0
82231,1331,255,274380,1076,0
82234,819,152,101384,667,0
82238,463,83,31540,380,0
82260,1583,310,394630,1273,0
82268,1204,251,239203,953,0
82281,932,168,128352,764,0
82301,793,158,100330,635,0
82305,568,114,51756,454,0
82365,1411,281,317530,1130,0
82372,131,25,2650,106,0
82375,360,66,19404,294,0
82378,58,12,552,46,0
82388,1541,306,377910,1235,0
82400,1025,201,165624,824,0
82417,548,102,45492,446,0
82424,971,184,144808,787,0
82468,793,158,100330,635,0
82494,865,167,116566,698,0
82511,1583,310,394630,1273,0
82513,836,151,103435,685,0
82539,548,102,45492,446,0
82549,659,132,69928,527,0
82551,58,15,645,43,0
82558,58,11,517,47,0
82563,315,56,14504,259,0
82578,194,39,6045,155,0
82588,317,63,16002,254,0
82596,200,40,6400,160,0
82599,819,152,101384,667,0
82604,1934,345,548205,1589,0
82615,108,17,1547,91,0
82621,836,151,103435,685,0
82641,1411,281,317530,1130,0
82678,120,24,2304,96,0
82708,131,25,2650,106,0
82714,217,44,7612,173,0
82732,47,11,396,36,0
82751,660,133,69928,527,0
82758,1296,252,263088,1044,0
82770,497,97,38800,400,0
82781,1204,251,239203,953,0
82825,714,137,79049,577,0
82830,971,184,144808,787,0
82848,405,82,26486,323,0
82849,1657,315,422730,1342,0
82866,405,82,26486,323,0
82867,793,158,100330,635,0
82890,1411,281,317530,1130,0
82903,2102,402,683400,1700,0
82925,58,15,645,43,0
82932,160,29,3799,131,0
82939,778,163,100245,615,0
82940,1025,201,165624,824,0
82941,1829,353,521028,1476,0
82957,1934,345,548205,1589,0
82961,641,131,66810,510,0
82964,110,18,1656,92,0
82966,714,137,79049,577,0
82972,1829,353,521028,1476,0
82983,1204,251,239203,953,0
83005,552,113,49607,439,0
83011,1829,353,521028,1476,0
83038,1331,255,274380,1076,0
83045,365,74,21534,291,0
83074,1262,259,259777,1003,0
83107,1934,345,548205,1589,0
83116,373,74,22126,299,0
83133,52,10,420,42,0
83134,1876,359,544603,1517,0
83140,2102,402,683400,1700,0
83156,1583,310,394630,1273,0
83157,932,168,128352,764,0
83162,1411,281,317530,1130,0
83202,1296,252,263088,1044,0
83204,660,133,69928,527,0
83224,1558,313,389685,1245,0
83231,821,171,111150,650,0
83233,186,35,5285,151,0
83245,317,63,16002,254,0
83246,21,3,54,18,0
83253,551,102,45798,449,0
83258,620,121,60379,499,0
83259,1934,345,548205,1589,0
83261,821,143,96954,678,0
83266,1552,299,374647,1253,0
83278,317,63,16002,254,0
83279,971,184,144808,787,0
83297,620,121,60379,499,0
83308,1342,282,298920,1060,0
83330,535,94,41454,441,0
83334,865,167,116566,698,0
83348,950,193,146101,757,0
83354,971,184,144808,787,0
83378,865,167,116566,698,0
83391,360,66,19404,294,0
83408,1558,313,389685,1245,0
83410,1876,359,544603,1517,0
83415,415,75,25500,340,0
83422,976,180,143280,796,0
83482,1025,201,165624,824,0
83493,2102,402,683400,1700,0
83497,1558,313,389685,1245,0
83508,61,11,550,50,0
83519,865,167,116566,698,0
83533,274,57,12369,217,0
83538,346,76,20520,270,0
83544,793,158,100330,635,0
83546,1829,353,521028,1476,0
83560,1296,252,263088,1044,0
83564,20,3,51,17,0
83568,771,137,86858,634,0
83580,198,43,6665,155,0
83594,1025,201,165624,824,0
83599,819,152,101384,667,0
83600,194,39,6045,155,0
83615,1657,315,422730,1342,0
83623,1541,306,377910,1235,0
83628,1876,359,544603,1517,0
83629,405,82,26486,323,0
83642,1331,255,274380,1076,0
83653,821,143,96954,678,0
83669,1541,306,377910,1235,0
83671,1876,359,544603,1517,0
83684,1204,251,239203,953,0
83689,1204,251,239203,953,0
83691,1558,313,389685,1245,0
83694,105,22,1826,83,0
83709,137,25,2800,112,0
83735,821,171,111150,650,0
83738,56,13,559,43,0
83752,144,29,3335,115,0
83770,19,2,34,17,0
83785,793,158,100330,635,0
83800,1657,315,422730,1342,0
83802,1558,313,389685,1245,0
83805,1262,259,259777,1003,0
83824,548,102,45492,446,0
83829,1331,255,274380,1076,0
83832,174,36,4968,138,0
83835,821,143,96954,678,0
83843,572,130,57460,442,0
83849,551,102,45798,449,0
83855,365,74,21534,291,0
83858,360,66,19404,294,0
83878,660,133,69928,527,0
83893,200,40,6400,160,0
83910,47,8,312,39,0
83952,171,35,4760,136,0
83962,595,121,57354,474,0
83998,767,144,89712,623,0
84048,193,39,6006,154,0
84049,1181,246,230010,935,0
84070,595,120,57000,475,0
84071,714,137,79049,577,0
84135,836,151,103435,685,0
84142,360,66,19404,294,0
84145,497,97,38800,400,0
84174,23,6,102,17,0
84177,20,3,51,17,0
84190,1552,299,374647,1253,0
84211,317,63,16002,254,0
84218,1025,201,165624,824,0
84222,373,74,22126,299,0
84224,323,55,14740,268,0
84225,324,67,17219,257,0
84228,1078,198,174240,880,0
84230,1331,255,274380,1076,0
84232,767,144,89712,623,0
84235,700,128,73216,572,0
84239,1204,251,239203,953,0
84260,6,2,8,4,0
84269,171,35,4760,136,0
84282,714,137,79049,577,0
84284,778,163,100245,615,0
84289,551,102,45798,449,0
84297,1280,232,243136,1048,0
84327,1541,306,377910,1235,0
84328,1583,310,394630,1273,0
84333,373,74,22126,299,0
84343,516,103,42539,413,0
84355,18,3,45,15,0
84365,155,35,4200,120,0
84411,771,137,86858,634,0
84414,568,114,51756,454,0
84422,971,184,144808,787,0
84436,156,34,4148,122,0
84437,1342,282,298920,1060,0
84442,1262,259,259777,1003,0
84443,950,193,146101,757,0
84452,395,72,23256,323,0
84462,122,20,2040,102,0
84485,1552,299,374647,1253,0
84503,1411,281,317530,1130,0
84508,1078,198,174240,880,0
84511,401,77,24948,324,0
84517,1280,232,243136,1048,0
84520,1280,232,243136,1048,0
84525,1262,259,259777,1003,0
84527,1829,353,521028,1476,0
84533,821,171,111150,650,0
84559,405,82,26486,323,0
84561,395,72,23256,323,0
84582,1583,310,394630,1273,0
84596,185,36,5364,149,0
84601,337,74,19462,263,0
84608,252,45,9315,207,0
84646,1657,315,422730,1342,0
84669,1262,259,259777,1003,0
84674,793,158,100330,635,0
84677,1181,246,230010,935,0
84690,1331,255,274380,1076,0
84718,1262,259,259777,1003,0
84722,1934,345,548205,1589,0
84741,33,8,200,25,0
84747,568,114,51756,454,0
84769,1204,251,239203,953,0
84777,516,103,42539,413,0
84779,463,83,31540,380,0
84817,321,54,14418,267,0
84826,1552,299,374647,1253,0
84842,2102,402,683400,1700,0
84846,35,7,196,28,0
84851,174,36,4968,138,0
84852,1934,345,548205,1589,0
84853,317,63,16002,254,0
84860,1657,315,422730,1342,0
84870,1657,315,422730,1342,0
84873,1934,345,548205,1589,0
84876,1342,282,298920,1060,0
84884,1296,252,263088,1044,0
84902,516,103,42539,413,0
84918,1829,353,521028,1476,0
84942,305,70,16450,235,0
84951,932,168,128352,764,0
84965,714,137,79049,577,0
84982,568,114,51756,454,0
85009,932,168,128352,764,0
85020,1204,251,239203,953,0
85057,2102,402,683400,1700,0
85079,52,10,420,42,0
85083,1552,299,374647,1253,0
85098,976,180,143280,796,0
85121,365,74,21534,291,0
85157,1558,313,389685,1245,0
85175,252,45,9315,207,0
85180,1411,281,317530,1130,0
85190,821,171,111150,650,0
85194,548,102,45492,446,0
85236,1558,313,389685,1245,0
85248,1181,246,230010,935,0
85249,395,72,23256,323,0
85285,47,11,396,36,0
85301,77,19,1102,58,0
85308,1331,255,274380,1076,0
85343,1934,345,548205,1589,0
85366,1583,310,394630,1273,0
85367,976,180,143280,796,0
85372,373,74,22126,299,0
85381,185,36,5364,149,0
85406,548,102,45492,446,0
85415,1876,359,544603,1517,0
85417,1541,306,377910,1235,0
85423,1331,255,274380,1076,0
85431,1541,306,377910,1235,0
85433,1657,315,422730,1342,0
85437,778,163,100245,615,0
85440,700,128,73216,572,0
85445,535,94,41454,441,0
85451,77,19,1102,58,0
85471,1411,281,317530,1130,0
85496,1876,359,544603,1517,0
85519,362,69,20217,293,0
85520,821,143,96954,678,0
85523,385,71,22294,314,0
85524,185,36,5364,149,0
85528,539,101,44238,438,0
85532,317,63,16002,254,0
85535,1204,251,239203,953,0
85576,836,151,103435,685,0
85577,174,36,4968,138,0
85578,42,5,185,37,0
85587,950,193,146101,757,0
85608,976,180,143280,796,0
85622,1331,255,274380,1076,0
85645,380,76,23104,304,0
85680,1025,201,165624,824,0
85684,380,76,23104,304,0
85692,365,74,21534,291,0
85705,950,193,146101,757,0
85724,1411,281,317530,1130,0
85731,641,131,66810,510,0
85733,131,25,2650,106,0
85755,112,18,1692,94,0
85757,26,5,105,21,0
85762,767,144,89712,623,0
85767,572,130,57460,442,0
85779,198,43,6665,155,0
85797,1262,259,259777,1003,0
85806,571,114,52098,457,0
85810,595,121,57354,474,0
85819,595,121,57354,474,0
85831,337,74,19462,263,0
85832,360,66,19404,294,0
85842,11,3,24,8,0
85853,1552,299,374647,1253,0
85859,194,39,6045,155,0
85863,932,168,128352,764,0
85882,405,82,26486,323,0
85890,793,158,100330,635,0
85891,160,32,4096,128,0
85907,620,121,60379,499,0
85926,1342,282,298920,1060,0
85936,64,8,448,56,0
85938,1541,306,377910,1235,0
85956,1657,315,422730,1342,0
85962,568,114,51756,454,0
85973,551,102,45798,449,0
85987,1552,299,374647,1253,0
85988,1934,345,548205,1589,0
86005,497,97,38800,400,0
86021,2102,402,683400,1700,0
86028,134,30,3120,104,0
86039,1181,246,230010,935,0
86048,1558,313,389685,1245,0
86069,1876,359,544603,1517,0
86096,641,131,66810,510,0
86112,1025,201,165624,824,0
86117,1181,246,230010,935,0
86121,1078,198,174240,880,0
86198,121,27,2538,94,0
86212,1181,246,230010,935,0
86236,767,144,89712,623,0
86246,1331,255,274380,1076,0
86251,194,39,6045,155,0
86254,1342,282,298920,1060,0
86258,497,97,38800,400,0
86273,415,75,25500,340,0
86288,1934,345,548205,1589,0
86295,395,72,23256,323,0
86300,1181,246,230010,935,0
86310,1829,353,521028,1476,0
86311,32,6,156,26,0
86322,821,143,96954,678,0
86338,1558,313,389685,1245,0
86355,282,50,11600,232,0
86382,31,7,168,24,0
86395,495,87,35496,408,0
86414,1657,315,422730,1342,0
86419,112,18,1692,94,0
86426,15,6,54,9,0
86448,819,152,101384,667,0
86454,1078,198,174240,880,0
86470,366,70,20720,296,0
86489,660,133,69928,527,0
86500,1934,345,548205,1589,0
86505,1262,259,259777,1003,0
86513,198,43,6665,155,0
86517,551,102,45798,449,0
86522,60,12,576,48,0
86530,976,180,143280,796,0
86531,1262,259,259777,1003,0
86534,1541,306,377910,1235,0
86538,1876,359,544603,1517,0
86556,337,74,19462,263,0
86611,976,180,143280,796,0
86636,778,163,100245,615,0
86645,1876,359,544603,1517,0
86648,971,184,144808,787,0
86663,24,6,108,18,0
86669,595,120,57000,475,0
86684,660,133,69928,527,0
86689,700,128,73216,572,0
86702,793,158,100330,635,0
86704,660,133,69928,527,0
86713,552,113,49607,439,0
86725,1262,259,259777,1003,0
86726,365,74,21534,291,0
86752,1541,306,377910,1235,0
86764,1876,359,544603,1517,0
86769,1342,282,298920,1060,0
86777,155,34,4114,121,0
86785,865,167,116566,698,0
86815,821,143,96954,678,0
86831,497,97,38800,400,0
86842,821,171,111150,650,0
86853,778,163,100245,615,0
86864,1411,281,317530,1130,0
86873,27,5,110,22,0
86875,6,2,8,4,0
86909,264,56,11648,208,0
86920,28,7,147,21,0
86944,40,6,204,34,0
86975,595,121,57354,474,0
86978,124,28,2688,96,0
86986,13,2,22,11,0
86995,273,58,12470,215,0
86996,641,131,66810,510,0
87009,362,69,20217,293,0
87019,819,152,101384,667,0
87027,385,71,22294,314,0
87055,778,163,100245,615,0
87078,1078,198,174240,880,0
87091,2102,402,683400,1700,0
87094,767,144,89712,623,0
87098,1583,310,394630,1273,0
87109,1558,313,389685,1245,0
87115,1583,310,394630,1273,0
87124,217,44,7612,173,0
87134,821,171,111150,650,0
87142,19,3,48,16,0
87145,171,35,4760,136,0
87174,641,131,66810,510,0
87180,373,74,22126,299,0
87181,264,56,11648,208,0
87210,1583,310,394630,1273,0
87220,641,131,66810,510,0
87226,252,45,9315,207,0
87227,1541,306,377910,1235,0
87228,552,113,49607,439,0
87229,443,85,30430,358,0
87272,1331,255,274380,1076,0
87280,97,22,1650,75,0
87303,2102,402,683400,1700,0
87316,1181,246,230010,935,0
87329,552,113,49607,439,0
87344,950,193,146101,757,0
87349,1583,310,394630,1273,0
87353,976,180,143280,796,0
87355,1204,251,239203,953,0
87378,415,75,25500,340,0
87394,401,77,24948,324,0
87409,1541,306,377910,1235,0
87429,535,94,41454,441,0
87442,1657,315,422730,1342,0
87450,497,97,38800,400,0
87454,198,43,6665,155,0
87466,568,114,51756,454,0
87468,659,132,69928,527,0
87492,1552,299,374647,1253,0
87497,1078,198,174240,880,0
87501,1331,255,274380,1076,0
87506,1025,201,165624,824,0
87509,124,28,2688,96,0
87513,1342,282,298920,1060,0
87535,1829,353,521028,1476,0
87537,33,7,182,26,0
87553,1934,345,548205,1589,0
87580,641,131,66810,510,0
87587,1583,310,394630,1273,0
87602,1262,259,259777,1003,0
87623,321,54,14418,267,0
87631,1411,281,317530,1130,0
87634,1541,306,377910,1235,0
87639,346,76,20520,270,0
87658,495,87,35496,408,0
87695,641,131,66810,510,0
87722,534,102,44064,432,0
87739,1934,345,548205,1589,0
87740,1541,306,377910,1235,0
87748,1829,353,521028,1476,0
87754,1934,345,548205,1589,0
87757,323,55,14740,268,0
87770,495,87,35496,408,0
87787,551,102,45798,449,0
87797,1204,251,239203,953,0
87809,819,152,101384,667,0
87831,18,3,45,15,0
87832,1558,313,389685,1245,0
87853,360,66,19404,294,0
87867,620,121,60379,499,0
87879,385,71,22294,314,0
87886,1411,281,317530,1130,0
87910,552,113,49607,439,0
87917,122,20,2040,102,0
87920,185,36,5364,149,0
87924,1876,359,544603,1517,0
87926,1078,198,174240,880,0
87950,950,193,146101,757,0
87953,620,121,60379,499,0
87958,771,137,86858,634,0
88000,950,193,146101,757,0
88024,1280,232,243136,1048,0
88032,443,85,30430,358,0
88033,595,120,57000,475,0
88035,443,85,30430,358,0
88037,282,50,11600,232,0
88041,155,27,3456,128,0
88044,950,193,146101,757,0
88054,34,7,189,27,0
88066,595,120,57000,475,0
88069,1280,232,243136,1048,0
88077,1876,359,544603,1517,0
88106,1025,201,165624,824,0
88112,700,128,73216,572,0
88113,1583,310,394630,1273,0
88135,950,193,146101,757,0
88169,497,97,38800,400,0
88172,771,137,86858,634,0
88174,1025,201,165624,824,0
88186,64,15,735,49,0
88190,1280,232,243136,1048,0
88194,198,43,6665,155,0
88216,516,103,42539,413,0
88237,495,87,35496,408,0
88242,380,76,23104,304,0
88263,1204,251,239203,953,0
88264,119,25,2350,94,0
88268,714,137,79049,577,0
88272,171,35,4760,136,0
88304,714,137,79049,577,0
88313,1411,281,317530,1130,0
88324,572,130,57460,442,0
88330,1558,313,389685,1245,0
88342,97,22,1650,75,0
88344,252,45,9315,207,0
88356,516,103,42539,413,0
88362,69,14,770,55,0
88394,971,184,144808,787,0
88415,1181,246,230010,935,0
88427,1934,345,548205,1589,0
88448,950,193,146101,757,0
88454,1558,313,389685,1245,0
88470,1583,310,394630,1273,0
88483,1541,306,377910,1235,0
88512,1558,313,389685,1245,0
88526,194,39,6045,155,0
88529,1262,259,259777,1003,0
88534,932,168,128352,764,0
88539,1181,246,230010,935,0
88543,366,70,20720,296,0
88553,595,120,57000,475,0
88565,552,113,49607,439,0
88577,516,103,42539,413,0
88590,1078,198,174240,880,0
88605,497,97,38800,400,0
88613,1262,259,259777,1003,0
88626,700,128,73216,572,0
88631,1411,281,317530,1130,0
88634,1657,315,422730,1342,0
88637,185,36,5364,149,0
88654,660,133,69928,527,0
88668,200,40,6400,160,0
88680,395,72,23256,323,0
88696,535,94,41454,441,0
88703,69,12,684,57,0
88706,641,131,66810,510,0
88707,323,55,14740,268,0
88709,821,171,111150,650,0
88744,380,76,23104,304,0
88750,1657,315,422730,1342,0
88759,1181,246,230010,935,0
88760,551,102,45798,449,0
88764,274,57,12369,217,0
88765,29,5,120,24,0
88774,1934,345,548205,1589,0
88796,1876,359,544603,1517,0
88798,1078,198,174240,880,0
88825,1262,259,259777,1003,0
88827,1331,255,274380,1076,0
88830,1541,306,377910,1235,0
88836,641,131,66810,510,0
88855,551,102,45798,449,0
88869,1025,201,165624,824,0
88895,2102,402,683400,1700,0
88903,207,41,6806,166,0
88904,793,158,100330,635,0
88912,620,121,60379,499,0
88921,124,28,2688,96,0
88940,778,163,100245,615,0
88941,495,87,35496,408,0
88965,1078,198,174240,880,0
88974,1331,255,274380,1076,0
88983,2102,402,683400,1700,0
88995,85,18,1206,67,0
89010,273,58,12470,215,0
89020,771,137,86858,634,0
89045,1657,315,422730,1342,0
89076,1829,353,521028,1476,0
89092,15,4,44,11,0
89105,105,22,1826,83,0
89109,160,32,4096,128,0
89115,121,27,2538,94,0
89116,1552,299,374647,1253,0
89119,516,103,42539,413,0
89122,2102,402,683400,1700,0
89124,1181,246,230010,935,0
89131,1204,251,239203,953,0
89146,49,9,360,40,0
89162,379,65,20410,314,0
89170,1342,282,298920,1060,0
89172,1934,345,548205,1589,0
89194,2102,402,683400,1700,0
89196,819,152,101384,667,0
89209,778,163,100245,615,0
89235,37,10,270,27,0
89265,1411,281,317530,1130,0
89266,185,36,5364,149,0
89283,1541,306,377910,1235,0
89284,174,36,4968,138,0
89293,932,168,128352,764,0
89298,572,130,57460,442,0
89300,1262,259,259777,1003,0
89313,1280,232,243136,1048,0
89314,1558,313,389685,1245,0
89316,108,17,1547,91,0
89317,144,29,3335,115,0
89345,700,128,73216,572,0
89359,821,171,111150,650,0
89361,1657,315,422730,1342,0
89393,315,56,14504,259,0
89408,548,102,45492,446,0
89412,950,193,146101,757,0
89415,516,103,42539,413,0
89417,174,36,4968,138,0
89438,539,101,44238,438,0
89444,1181,246,230010,935,0
89453,1657,315,422730,1342,0
89467,1262,259,259777,1003,0
89469,595,120,57000,475,0
89482,714,137,79049,577,0
89485,516,103,42539,413,0
89488,134,30,3120,104,0
89508,495,87,35496,408,0
89518,1411,281,317530,1130,0
89527,2102,402,683400,1700,0
89536,1829,353,521028,1476,0
89537,1552,299,374647,1253,0
89549,1331,255,274380,1076,0
89566,401,77,24948,324,0
89571,771,137,86858,634,0
89576,1541,306,377910,1235,0
89585,865,167,116566,698,0
89587,932,168,128352,764,0
89588,146,34,3808,112,0
89589,1829,353,521028,1476,0
89594,1280,232,243136,1048,0
89601,714,137,79049,577,0
89607,1296,252,263088,1044,0
89628,572,130,57460,442,0
89636,52,10,420,42,0
89668,1583,310,394630,1273,0
89677,44,9,315,35,0
89702,366,70,20720,296,0
89704,793,158,100330,635,0
89706,69,14,770,55,0
89709,1934,345,548205,1589,0
89714,380,76,23104,304,0
89718,463,83,31540,380,0
89727,1331,255,274380,1076,0
89732,17,6,66,11,0
89736,112,18,1692,94,0
89744,660,133,69928,527,0
89747,1876,359,544603,1517,0
89749,821,171,111150,650,0
89785,119,25,2350,94,0
89797,1411,281,317530,1130,0
89802,552,113,49607,439,0
89806,1262,259,259777,1003,0
89808,620,121,60379,499,0
89816,1025,201,165624,824,0
89824,1262,259,259777,1003,0
89831,1342,282,298920,1060,0
89837,1876,359,544603,1517,0
89841,1411,281,317530,1130,0
89857,1657,315,422730,1342,0
89858,110,18,1656,92,0
89876,463,83,31540,380,0
89881,282,50,11600,232,0
89882,346,76,20520,270,0
89896,793,158,100330,635,0
89899,793,158,100330,635,0
89906,865,167,116566,698,0
89909,1262,259,259777,1003,0
89919,1025,201,165624,824,0
89924,793,158,100330,635,0
89931,571,114,52098,457,0
89944,497,97,38800,400,0
89950,395,72,23256,323,0
89953,767,144,89712,623,0
89954,767,144,89712,623,0
89991,1829,353,521028,1476,0
89994,1262,259,259777,1003,0
89996,539,101,44238,438,0
89999,1583,310,394630,1273,0
90000,54,14,560,40,0
90011,793,158,100330,635,0
90016,58,15,645,43,0
90020,7,2,10,5,0
90034,1204,251,239203,953,0
90035,1331,255,274380,1076,0
90055,771,137,86858,634,0
90086,497,97,38800,400,0
90088,620,121,60379,499,0
90091,365,74,21534,291,0
90093,1411,281,317530,1130,0
90101,767,144,89712,623,0
90106,40,7,231,33,0
90107,110,27,2241,83,0
90122,1078,198,174240,880,0
90125,365,74,21534,291,0
90133,1558,313,389685,1245,0
90160,821,171,111150,650,0
90183,767,144,89712,623,0
90199,1552,299,374647,1253,0
90218,31,10,210,21,0
90229,1025,201,165624,824,0
90231,950,193,146101,757,0
90232,539,101,44238,438,0
90234,58,15,645,43,0
90241,821,143,96954,678,0
90261,395,72,23256,323,0
90265,1657,315,422730,1342,0
90276,1342,282,298920,1060,0
90296,112,18,1692,94,0
90302,1280,232,243136,1048,0
90303,495,87,35496,408,0
90309,534,102,44064,432,0
90318,771,137,86858,634,0
90319,1558,313,389685,1245,0
90321,1025,201,165624,824,0
90323,185,36,5364,149,0
90324,379,65,20410,314,0
90350,1078,198,174240,880,0
90386,821,143,96954,678,0
90391,463,83,31540,380,0
90408,2102,402,683400,1700,0
90410,497,97,38800,400,0
90412,463,83,31540,380,0
90423,620,121,60379,499,0
90430,185,36,5364,149,0
90435,373,74,22126,299,0
90436,932,168,128352,764,0
90443,1411,281,317530,1130,0
90451,1552,299,374647,1253,0
90452,1078,198,174240,880,0
90453,976,180,143280,796,0
90457,821,171,111150,650,0
90498,548,102,45492,446,0
90513,1411,281,317530,1130,0
90519,1552,299,374647,1253,0
90530,976,180,143280,796,0
90532,551,102,45798,449,0
90533,360,66,19404,294,0
90571,1552,299,374647,1253,0
90581,1829,353,521028,1476,0
90589,1657,315,422730,1342,0
90633,362,69,20217,293,0
90653,539,101,44238,438,0
90655,865,167,116566,698,0
90659,75,19,1064,56,0
90660,976,180,143280,796,0
90667,156,34,4148,122,0
90671,1280,232,243136,1048,0
90684,1934,345,548205,1589,0
90698,18,6,72,12,0
90700,52,11,451,41,0
90723,1829,353,521028,1476,0
90748,497,97,38800,400,0
90773,77,19,1102,58,0
90775,227,44,8052,183,0
90804,1583,310,394630,1273,0
90812,1204,251,239203,953,0
90814,767,144,89712,623,0
90817,463,83,31540,380,0
90822,1657,315,422730,1342,0
90861,346,76,20520,270,0
90898,641,131,66810,510,0
90903,120,24,2304,96,0
90926,463,83,31540,380,0
90937,1657,315,422730,1342,0
90955,821,171,111150,650,0
90961,535,94,41454,441,0
90977,1934,345,548205,1589,0
90983,1657,315,422730,1342,0
91003,1558,313,389685,1245,0
91014,1876,359,544603,1517,0
91019,1558,313,389685,1245,0
91028,1829,353,521028,1476,0
91040,1541,306,377910,1235,0
91041,516,103,42539,413,0
91094,1411,281,317530,1130,0
91128,534,102,44064,432,0
91134,198,43,6665,155,0
91139,1411,281,317530,1130,0
91142,1541,306,377910,1235,0
91148,1411,281,317530,1130,0
91164,950,193,146101,757,0
91184,65,17,816,48,0
91188,2102,402,683400,1700,0
91194,164,34,4420,130,0
91196,778,163,100245,615,0
91199,950,193,146101,757,0
91205,1204,251,239203,953,0
91216,821,171,111150,650,0
91231,1657,315,422730,1342,0
91233,1296,252,263088,1044,0
91236,1262,259,259777,1003,0
91247,198,43,6665,155,0
91256,1541,306,377910,1235,0
91271,534,102,44064,432,0
91278,1829,353,521028,1476,0
91279,1280,232,243136,1048,0
91284,568,114,51756,454,0
91285,156,34,4148,122,0
91301,1204,251,239203,953,0
91303,1558,313,389685,1245,0
91311,1025,201,165624,824,0
91317,401,77,24948,324,0
91323,1411,281,317530,1130,0
91368,365,74,21534,291,0
91387,1181,246,230010,935,0
91410,714,137,79049,577,0
91424,105,16,1424,89,0
91454,2102,402,683400,1700,0
91465,1331,255,274380,1076,0
91466,463,83,31540,380,0
91470,572,130,57460,442,0
91488,976,180,143280,796,0
91501,767,144,89712,623,0
91511,700,128,73216,572,0
91561,1934,345,548205,1589,0
91569,315,56,14504,259,0
91575,1934,345,548205,1589,0
91605,1558,313,389685,1245,0
91616,8,1,7,7,0
91622,641,131,66810,510,0
91627,700,128,73216,572,0
91632,595,121,57354,474,0
91636,1541,306,377910,1235,0
91637,405,82,26486,323,0
91642,1541,306,377910,1235,0
91657,11,4,28,7,0
91687,186,35,5285,151,0
91697,1657,315,422730,1342,0
91732,495,87,35496,408,0
91739,976,180,143280,796,0
91752,1552,299,374647,1253,0
91763,1280,232,243136,1048,0
91768,305,70,16450,235,0
91770,819,152,101384,667,0
91794,1342,282,298920,1060,0
91811,282,50,11600,232,0
91826,836,151,103435,685,0
91834,148,24,2976,124,0
91840,971,184,144808,787,0
91862,1181,246,230010,935,0
91879,415,75,25500,340,0
91885,60,12,576,48,0
91897,1331,255,274380,1076,0
91917,778,163,100245,615,0
91918,551,102,45798,449,0
91923,1331,255,274380,1076,0
91925,1876,359,544603,1517,0
91944,1829,353,521028,1476,0
91946,1876,359,544603,1517,0
91951,1296,252,263088,1044,0
91952,1829,353,521028,1476,0
91955,1078,198,174240,880,0
91961,1541,306,377910,1235,0
91985,1934,345,548205,1589,0
91992,1829,353,521028,1476,0
91993,976,180,143280,796,0
92011,11,3,24,8,0
92021,1078,198,174240,880,0
92022,365,74,21534,291,0
92034,134,30,3120,104,0
92036,865,167,116566,698,0
92044,443,85,30430,358,0
92055,160,32,4096,128,0
92056,144,29,3335,115,0
92062,1204,251,239203,953,0
92063,714,137,79049,577,0
92067,1541,306,377910,1235,0
92069,1204,251,239203,953,0
92081,17,3,42,14,0
92107,1657,315,422730,1342,0
92111,1552,299,374647,1253,0
92127,1331,255,274380,1076,0
92130,1934,345,548205,1589,0
92134,793,158,100330,635,0
92143,2102,402,683400,1700,0
92147,110,27,2241,83,0
92178,568,114,51756,454,0
92182,535,94,41454,441,0
92184,1583,310,394630,1273,0
92191,778,163,100245,615,0
92195,52,10,420,42,0
92200,552,113,49607,439,0
92216,1558,313,389685,1245,0
92219,641,131,66810,510,0
92228,58,11,517,47,0
92264,641,131,66810,510,0
92274,62,16,736,46,0
92283,1541,306,377910,1235,0
92284,865,167,116566,698,0
92290,1262,259,259777,1003,0
92291,135,30,3150,105,0
92294,572,130,57460,442,0
92299,227,44,8052,183,0
92301,1657,315,422730,1342,0
92307,1262,259,259777,1003,0
92324,6,2,8,4,0
92332,113,24,2136,89,0
92335,865,167,116566,698,0
92352,1262,259,259777,1003,0
92353,1262,259,259777,1003,0
92354,1331,255,274380,1076,0
92358,1876,359,544603,1517,0
92367,495,87,35496,408,0
92390,2102,402,683400,1700,0
92394,1181,246,230010,935,0
92401,821,171,111150,650,0
92411,819,152,101384,667,0
92423,321,54,14418,267,0
92435,405,82,26486,323,0
92436,571,114,52098,457,0
92441,1876,359,544603,1517,0
92446,1657,315,422730,1342,0
92447,40,6,204,34,0
92450,385,71,22294,314,0
92467,1342,282,298920,1060,0
92478,14,4,40,10,0
92479,778,163,100245,615,0
92489,714,137,79049,577,0
92498,155,27,3456,128,0
92524,69,12,684,57,0
92532,821,143,96954,678,0
92541,595,120,57000,475,0
92542,31,7,168,24,0
92556,865,167,116566,698,0
92558,700,128,73216,572,0
92570,1181,246,230010,935,0
92574,971,184,144808,787,0
92592,252,45,9315,207,0
92606,950,193,146101,757,0
92609,1541,306,377910,1235,0
92614,463,83,31540,380,0
92626,778,163,100245,615,0
92633,113,24,2136,89,0
92645,54,14,560,40,0
92678,571,114,52098,457,0
92689,1262,259,259777,1003,0
92703,620,121,60379,499,0
92709,1552,299,374647,1253,0
92735,175,29,4234,146,0
92749,535,94,41454,441,0
92752,932,168,128352,764,0
92754,572,130,57460,442,0
92784,379,65,20410,314,0
92793,104,16,1408,88,0
92814,2102,402,683400,1700,0
92836,58,12,552,46,0
92855,1181,246,230010,935,0
92865,778,163,100245,615,0
92881,160,32,4096,128,0
92902,1829,353,521028,1476,0
92906,595,120,57000,475,0
92931,568,114,51756,454,0
92943,1411,281,317530,1130,0
92957,836,151,103435,685,0
92959,700,128,73216,572,0
92994,539,101,44238,438,0
93010,1934,345,548205,1589,0
93014,1541,306,377910,1235,0
93066,1934,345,548205,1589,0
93069,819,152,101384,667,0
93093,950,193,146101,757,0
93099,1280,232,243136,1048,0
93113,1657,315,422730,1342,0
93129,337,74,19462,263,0
93134,1558,313,389685,1245,0
93136,836,151,103435,685,0
93156,380,76,23104,304,0
93172,373,74,22126,299,0
93175,1552,299,374647,1253,0
93179,932,168,128352,764,0
93207,29,5,120,24,0
93209,156,34,4148,122,0
93224,1296,252,263088,1044,0
93234,1829,353,521028,1476,0
93242,793,158,100330,635,0
93246,1025,201,165624,824,0
93265,1342,282,298920,1060,0
93279,337,74,19462,263,0
93288,1934,345,548205,1589,0
93291,932,168,128352,764,0
93319,539,101,44238,438,0
93337,1025,201,165624,824,0
93340,1558,313,389685,1245,0
93354,346,76,20520,270,0
93358,819,152,101384,667,0
93369,1657,315,422730,1342,0
93391,1331,255,274380,1076,0
93395,1262,259,259777,1003,0
93405,1541,306,377910,1235,0
93419,534,102,44064,432,0
93422,1541,306,377910,1235,0
93425,1262,259,259777,1003,0
93427,106,19,1653,87,0
93434,1541,306,377910,1235,0
93456,551,102,45798,449,0
93463,110,27,2241,83,0
93464,1342,282,298920,1060,0
93489,236,50,9300,186,0
93500,1829,353,521028,1476,0
93511,821,143,96954,678,0
93532,1829,353,521028,1476,0
93586,1829,353,521028,1476,0
93590,410,76,25384,334,0
93603,767,144,89712,623,0
93631,595,121,57354,474,0
93645,321,54,14418,267,0
93654,56,13,559,43,0
93670,401,77,24948,324,0
93684,85,18,1206,67,0
93713,1181,246,230010,935,0
93716,264,56,11648,208,0
93723,217,44,7612,173,0
93736,821,171,111150,650,0
93743,771,137,86858,634,0
93753,714,137,79049,577,0
93762,65,17,816,48,0
93771,1342,282,298920,1060,0
93772,2102,402,683400,1700,0
93773,641,131,66810,510,0
93778,121,27,2538,94,0
93780,571,114,52098,457,0
93783,1541,306,377910,1235,0
93785,771,137,86858,634,0
93788,217,44,7612,173,0
93808,1342,282,298920,1060,0
93820,1204,251,239203,953,0
93833,572,130,57460,442,0
93865,1829,353,521028,1476,0
93877,516,103,42539,413,0
93879,1204,251,239203,953,0
93882,659,132,69928,527,0
93883,1342,282,298920,1060,0
93884,360,66,19404,294,0
93892,405,82,26486,323,0
93893,410,76,25384,334,0
93897,1411,281,317530,1130,0
93899,131,21,2310,110,0
93925,767,144,89712,623,0
93934,321,54,14418,267,0
93950,282,50,11600,232,0
93956,1025,201,165624,824,0
93979,552,113,49607,439,0
94005,767,144,89712,623,0
94007,122,25,2425,97,0
94037,714,137,79049,577,0
94044,146,34,3808,112,0
94052,767,144,89712,623,0
94076,1657,315,422730,1342,0
94077,110,27,2241,83,0
94109,105,16,1424,89,0
94122,65,17,816,48,0
94136,552,113,49607,439,0
94157,1876,359,544603,1517,0
94162,321,54,14418,267,0
94189,2102,402,683400,1700,0
94192,1411,281,317530,1130,0
94195,1876,359,544603,1517,0
94200,552,113,49607,439,0
94211,819,152,101384,667,0
94228,1558,313,389685,1245,0
94230,64,15,735,49,0
94232,227,44,8052,183,0
94236,1541,306,377910,1235,0
94247,200,40,6400,160,0
94260,950,193,146101,757,0
94265,102,20,1640,82,0
94272,819,152,101384,667,0
94281,1262,259,259777,1003,0
94320,137,25,2800,112,0
94328,1262,259,259777,1003,0
94331,198,43,6665,155,0
94365,595,120,57000,475,0
94375,401,77,24948,324,0
94376,793,158,100330,635,0
94385,1829,353,521028,1476,0
94410,198,43,6665,155,0
94418,61,11,550,50,0
94423,1280,232,243136,1048,0
94452,821,143,96954,678,0
94462,1181,246,230010,935,0
94469,1934,345,548205,1589,0
94474,1934,345,548205,1589,0
94495,793,158,100330,635,0
94523,932,168,128352,764,0
94524,1411,281,317530,1130,0
94534,395,72,23256,323,0
94538,72,17,935,55,0
94550,194,39,6045,155,0
94552,410,76,25384,334,0
94573,144,29,3335,115,0
94574,950,193,146101,757,0
94584,40,7,231,33,0
94594,1262,259,259777,1003,0
94602,55,10,450,45,0
94620,405,82,26486,323,0
94641,1583,310,394630,1273,0
94645,346,76,20520,270,0
94663,700,128,73216,572,0
94666,365,74,21534,291,0
94677,793,158,100330,635,0
94682,1025,201,165624,824,0
94686,1411,281,317530,1130,0
94710,865,167,116566,698,0
94730,865,167,116566,698,0
94760,156,34,4148,122,0
94761,819,152,101384,667,0
94766,160,32,4096,128,0
94769,700,128,73216,572,0
94781,534,102,44064,432,0
94784,174,36,4968,138,0
94794,534,102,44064,432,0
94808,1204,251,239203,953,0
94814,1342,282,298920,1060,0
94838,274,57,12369,217,0
94846,274,57,12369,217,0
94860,1558,313,389685,1245,0
94885,1552,299,374647,1253,0
94904,1934,345,548205,1589,0
94921,539,101,44238,438,0
94922,1280,232,243136,1048,0
94931,571,114,52098,457,0
94950,1583,310,394630,1273,0
94963,1411,281,317530,1130,0
94983,127,29,2842,98,0
94985,1025,201,165624,824,0
94988,976,180,143280,796,0
94993,1296,252,263088,1044,0
94998,1934,345,548205,1589,0
95001,641,131,66810,510,0
95003,62,16,736,46,0
95013,1204,251,239203,953,0
95023,1411,281,317530,1130,0
95063,1204,251,239203,953,0
95066,1262,259,259777,1003,0
95068,516,103,42539,413,0
95082,551,102,45798,449,0
95086,443,85,30430,358,0
95098,865,167,116566,698,0
95103,1078,198,174240,880,0
95126,207,41,6806,166,0
95141,1262,259,259777,1003,0
95161,836,151,103435,685,0
95163,1934,345,548205,1589,0
95170,401,77,24948,324,0
95173,793,158,100330,635,0
95176,61,13,624,48,0
95178,539,101,44238,438,0
95180,1296,252,263088,1044,0
95195,106,19,1653,87,0
95221,976,180,143280,796,0
95238,65,13,676,52,0
95243,217,44,7612,173,0
95245,380,76,23104,304,0
95303,122,20,2040,102,0
95312,194,39,6045,155,0
95327,405,82,26486,323,0
95354,548,102,45492,446,0
95364,568,114,51756,454,0
95365,64,8,448,56,0
95372,122,20,2040,102,0
95386,2102,402,683400,1700,0
95394,405,82,26486,323,0
95405,1204,251,239203,953,0
95406,198,43,6665,155,0
95408,463,83,31540,380,0
95432,659,132,69928,527,0
95456,1657,315,422730,1342,0
95462,1829,353,521028,1476,0
95464,1541,306,377910,1235,0
95465,146,34,3808,112,0
95480,1262,259,259777,1003,0
95485,793,158,100330,635,0
95498,836,151,103435,685,0
95504,373,74,22126,299,0
95523,1876,359,544603,1517,0
95535,380,76,23104,304,0
95536,1829,353,521028,1476,0
95570,551,102,45798,449,0
95571,405,82,26486,323,0
95572,821,171,111150,650,0
95576,160,29,3799,131,0
95578,401,77,24948,324,0
95581,821,143,96954,678,0
95587,1558,313,389685,1245,0
95598,1541,306,377910,1235,0
95621,2102,402,683400,1700,0
95634,1876,359,544603,1517,0
95649,1829,353,521028,1476,0
95656,971,184,144808,787,0
95677,2102,402,683400,1700,0
95682,380,76,23104,304,0
95694,185,36,5364,149,0
95698,282,50,11600,232,0
95719,415,75,25500,340,0
95721,1829,353,521028,1476,0
95761,1296,252,263088,1044,0
95769,778,163,100245,615,0
95771,793,158,100330,635,0
95810,793,158,100330,635,0
95813,1204,251,239203,953,0
95814,1411,281,317530,1130,0
95826,1934,345,548205,1589,0
95840,155,34,4114,121,0
95851,1078,198,174240,880,0
95853,1552,299,374647,1253,0
95856,236,50,9300,186,0
95862,793,158,100330,635,0
95863,443,85,30430,358,0
95867,1262,259,259777,1003,0
95885,821,171,111150,650,0
95893,1342,282,298920,1060,0
95897,495,87,35496,408,0
95902,401,77,24948,324,0
95931,595,121,57354,474,0
95933,950,193,146101,757,0
95974,155,27,3456,128,0
95976,46,9,333,37,0
95977,1296,252,263088,1044,0
95999,2102,402,683400,1700,0
96003,1342,282,298920,1060,0
96004,31,7,168,24,0
96010,714,137,79049,577,0
96038,971,184,144808,787,0
96039,1204,251,239203,953,0
96051,323,55,14740,268,0
96071,64,15,735,49,0
96076,700,128,73216,572,0
96081,64,16,768,48,0
96085,1296,252,263088,1044,0
96087,1181,246,230010,935,0
96097,97,22,1650,75,0
96102,463,83,31540,380,0
96112,1204,251,239203,953,0
96120,1934,345,548205,1589,0
96122,1411,281,317530,1130,0
96158,35,5,150,30,0
96160,360,66,19404,294,0
96162,52,10,420,42,0
96163,1552,299,374647,1253,0
96189,305,70,16450,235,0
96194,198,43,6665,155,0
96200,1876,359,544603,1517,0
96218,379,65,20410,314,0
96226,865,167,116566,698,0
96228,282,50,11600,232,0
96233,1331,255,274380,1076,0
96248,778,163,100245,615,0
96257,305,70,16450,235,0
96259,1181,246,230010,935,0
96264,2102,402,683400,1700,0
96268,2102,402,683400,1700,0
96273,395,72,23256,323,0
96292,1934,345,548205,1589,0
96329,1558,313,389685,1245,0
96336,33,7,182,26,0
96369,1558,313,389685,1245,0
96370,1552,299,374647,1253,0
96378,778,163,100245,615,0
96435,539,101,44238,438,0
96437,105,22,1826,83,0
96466,950,193,146101,757,0
96471,1296,252,263088,1044,0
96475,70,12,696,58,0
96492,516,103,42539,413,0
96501,1934,345,548205,1589,0
96502,1280,232,243136,1048,0
96504,714,137,79049,577,0
96550,1204,251,239203,953,0
96551,110,27,2241,83,0
96555,1583,310,394630,1273,0
96602,714,137,79049,577,0
96616,1876,359,544603,1517,0
96622,1583,310,394630,1273,0
96631,186,35,5285,151,0
96641,620,121,60379,499,0
96660,11,3,24,8,0
96682,1583,310,394630,1273,0
96684,305,70,16450,235,0
96688,1876,359,544603,1517,0
96691,236,50,9300,186,0
96694,273,58,12470,215,0
96697,1934,345,548205,1589,0
96703,1829,353,521028,1476,0
96706,971,184,144808,787,0
96711,395,72,23256,323,0
96719,1558,313,389685,1245,0
96732,495,87,35496,408,0
96734,60,12,576,48,0
96735,105,15,1350,90,0
96749,976,180,143280,796,0
96751,572,130,57460,442,0
96752,160,29,3799,131,0
96753,321,54,14418,267,0
96760,620,121,60379,499,0
96775,1262,259,259777,1003,0
96793,1541,306,377910,1235,0
96807,274,57,12369,217,0
96845,1541,306,377910,1235,0
96867,1829,353,521028,1476,0
96870,108,17,1547,91,0
96880,1331,255,274380,1076,0
96900,1204,251,239203,953,0
96902,380,76,23104,304,0
96903,236,50,9300,186,0
96911,1583,310,394630,1273,0
96923,1657,315,422730,1342,0
96930,198,43,6665,155,0
96934,1558,313,389685,1245,0
96943,1411,281,317530,1130,0
96950,2102,402,683400,1700,0
96965,950,193,146101,757,0
96977,865,167,116566,698,0
96981,1181,246,230010,935,0
96984,1078,198,174240,880,0
96985,771,137,86858,634,0
96993,1262,259,259777,1003,0
96998,1583,310,394630,1273,0
97038,714,137,79049,577,0
97055,1558,313,389685,1245,0
97083,1934,345,548205,1589,0
97087,497,97,38800,400,0
97088,1583,310,394630,1273,0
97098,146,34,3808,112,0
97102,144,29,3335,115,0
97127,127,29,2842,98,0
97146,976,180,143280,796,0
97156,778,163,100245,615,0
97186,495,87,35496,408,0
97197,1025,201,165624,824,0
97198,539,101,44238,438,0
97206,976,180,143280,796,0
97257,346,76,20520,270,0
97262,1541,306,377910,1235,0
97263,976,180,143280,796,0
97272,1541,306,377910,1235,0
97275,1934,345,548205,1589,0
97292,571,114,52098,457,0
97296,700,128,73216,572,0
97316,1296,252,263088,1044,0
97327,305,70,16450,235,0
97332,1025,201,165624,824,0
97335,31,9,198,22,0
97355,1181,246,230010,935,0
97362,700,128,73216,572,0
97363,2102,402,683400,1700,0
97364,1583,310,394630,1273,0
97368,1876,359,544603,1517,0
97380,767,144,89712,623,0
97381,714,137,79049,577,0
97383,346,76,20520,270,0
97413,1331,255,274380,1076,0
97415,72,17,935,55,0
97433,1541,306,377910,1235,0
97442,771,137,86858,634,0
97468,2102,402,683400,1700,0
97473,1552,299,374647,1253,0
97476,193,39,6006,154,0
97482,548,102,45492,446,0
97483,49,8,328,41,0
97490,40,7,231,33,0
97499,1025,201,165624,824,0
97510,134,30,3120,104,0
97511,778,163,100245,615,0
97512,1025,201,165624,824,0
97514,264,56,11648,208,0
97521,1552,299,374647,1253,0
97526,535,94,41454,441,0
97529,950,193,146101,757,0
97530,1181,246,230010,935,0
97536,836,151,103435,685,0
97542,548,102,45492,446,0
97548,1552,299,374647,1253,0
97565,819,152,101384,667,0
97579,410,76,25384,334,0
97601,1296,252,263088,1044,0
97636,145,23,2806,122,0
97668,1280,232,243136,1048,0
97682,198,43,6665,155,0
97708,1934,345,548205,1589,0
97710,7,2,10,5,0
97713,572,130,57460,442,0
97721,1204,251,239203,953,0
97724,1876,359,544603,1517,0
97729,497,97,38800,400,0
97737,1829,353,521028,1476,0
97747,405,82,26486,323,0
97752,495,87,35496,408,0
97756,321,54,14418,267,0
97800,365,74,21534,291,0
97805,1181,246,230010,935,0
97812,595,121,57354,474,0
97815,1558,313,389685,1245,0
97820,641,131,66810,510,0
97824,497,97,38800,400,0
97836,976,180,143280,796,0
97842,366,70,20720,296,0
97879,950,193,146101,757,0
97902,932,168,128352,764,0
97915,1657,315,422730,1342,0
97918,58,15,645,43,0
97926,1657,315,422730,1342,0
97933,1657,315,422730,1342,0
97939,131,21,2310,110,0
97944,793,158,100330,635,0
97963,401,77,24948,324,0
97985,819,152,101384,667,0
97988,185,36,5364,149,0
98013,52,10,420,42,0
98036,1829,353,521028,1476,0
98053,495,87,35496,408,0
98060,2102,402,683400,1700,0
98066,1331,255,274380,1076,0
98070,793,158,100330,635,0
98072,1558,313,389685,1245,0
98073,373,74,22126,299,0
98083,1583,310,394630,1273,0
98089,1558,313,389685,1245,0
98092,1204,251,239203,953,0
98093,1541,306,377910,1235,0
98096,595,120,57000,475,0
98110,405,82,26486,323,0
98121,1262,259,259777,1003,0
98126,793,158,100330,635,0
98127,572,130,57460,442,0
98134,1541,306,377910,1235,0
98171,88,17,1207,71,0
98178,1934,345,548205,1589,0
98204,52,11,451,41,0
98207,595,120,57000,475,0
98212,976,180,143280,796,0
98213,405,82,26486,323,0
98233,767,144,89712,623,0
98239,72,17,935,55,0
98254,819,152,101384,667,0
98257,539,101,44238,438,0
98266,1331,255,274380,1076,0
98270,1181,246,230010,935,0
98284,315,56,14504,259,0
98292,1204,251,239203,953,0
98302,1829,353,521028,1476,0
98309,2102,402,683400,1700,0
98316,193,39,6006,154,0
98317,971,184,144808,787,0
98324,516,103,42539,413,0
98365,113,24,2136,89,0
98368,1552,299,374647,1253,0
98369,60,12,576,48,0
98374,932,168,128352,764,0
98403,551,102,45798,449,0
98406,1934,345,548205,1589,0
98407,700,128,73216,572,0
98408,1829,353,521028,1476,0
98413,1657,315,422730,1342,0
98420,273,58,12470,215,0
98422,1583,310,394630,1273,0
98431,36,6,180,30,0
98434,1181,246,230010,935,0
98453,1342,282,298920,1060,0
98466,495,87,35496,408,0
98479,366,70,20720,296,0
98496,1296,252,263088,1044,0
98503,1829,353,521028,1476,0
98512,1552,299,374647,1253,0
98526,1296,252,263088,1044,0
98531,1204,251,239203,953,0
98532,535,94,41454,441,0
98536,317,63,16002,254,0
98539,950,193,146101,757,0
98607,282,50,11600,232,0
98620,1876,359,544603,1517,0
98638,362,69,20217,293,0
98642,1181,246,230010,935,0
98645,548,102,45492,446,0
98653,1296,252,263088,1044,0
98669,1876,359,544603,1517,0
98675,793,158,100330,635,0
98688,971,184,144808,787,0
98690,360,66,19404,294,0
98693,1204,251,239203,953,0
98700,571,114,52098,457,0
98722,1541,306,377910,1235,0
98737,58,12,552,46,0
98776,1262,259,259777,1003,0
98838,305,70,16450,235,0
98842,1552,299,374647,1253,0
98851,771,137,86858,634,0
98862,69,14,770,55,0
98869,1583,310,394630,1273,0
98906,52,11,451,41,0
98920,194,39,6045,155,0
98936,1204,251,239203,953,0
98950,148,24,2976,124,0
98960,572,130,57460,442,0
98976,1078,198,174240,880,0
98979,971,184,144808,787,0
99006,572,130,57460,442,0
99023,346,76,20520,270,0
99028,160,32,4096,128,0
99031,1411,281,317530,1130,0
99081,660,133,69928,527,0
99123,77,17,1020,60,0
99126,1829,353,521028,1476,0
99131,568,114,51756,454,0
99140,1342,282,298920,1060,0
99146,236,50,9300,186,0
99161,137,25,2800,112,0
99162,950,193,146101,757,0
99186,401,77,24948,324,0
99212,2102,402,683400,1700,0
99219,134,30,3120,104,0
99228,539,101,44238,438,0
99238,551,102,45798,449,0
99240,175,29,4234,146,0
99247,155,35,4200,120,0
99258,1331,255,274380,1076,0
99261,395,72,23256,323,0
99264,24,2,44,22,0
99286,379,65,20410,314,0
99309,1411,281,317530,1130,0
99334,1829,353,521028,1476,0
99335,1331,255,274380,1076,0
99347,1552,299,374647,1253,0
99356,360,66,19404,294,0
99359,122,22,2200,100,0
99371,793,158,100330,635,0
99375,1552,299,374647,1253,0
99380,819,152,101384,667,0
99388,1541,306,377910,1235,0
99390,72,13,767,59,0
99395,1552,299,374647,1253,0
99398,35,5,150,30,0
99401,1934,345,548205,1589,0
99404,771,137,86858,634,0
99416,2102,402,683400,1700,0
99422,175,29,4234,146,0
99425,321,54,14418,267,0
99436,64,15,735,49,0
99450,1296,252,263088,1044,0
99454,1876,359,544603,1517,0
99459,950,193,146101,757,0
99468,1078,198,174240,880,0
99497,821,143,96954,678,0
99501,1583,310,394630,1273,0
99515,1296,252,263088,1044,0
99516,1876,359,544603,1517,0
99541,1262,259,259777,1003,0
99548,821,171,111150,650,0
99550,932,168,128352,764,0
99553,1829,353,521028,1476,0
99559,415,75,25500,340,0
99594,1583,310,394630,1273,0
99595,659,132,69928,527,0
99596,1181,246,230010,935,0
99599,317,63,16002,254,0
99602,1934,345,548205,1589,0
99629,101,20,1620,81,0
99630,534,102,44064,432,0
99638,1558,313,389685,1245,0
99642,8,4,16,4,0
99655,836,151,103435,685,0
99671,821,143,96954,678,0
99692,971,184,144808,787,0
99696,778,163,100245,615,0
99715,113,20,1860,93,0
99724,778,163,100245,615,0
99725,2102,402,683400,1700,0
99738,497,97,38800,400,0
99743,366,70,20720,296,0
99745,217,44,7612,173,0
99747,976,180,143280,796,0
99757,836,151,103435,685,0
99763,865,167,116566,698,0
99776,97,22,1650,75,0
99803,49,8,328,41,0
99818,401,77,24948,324,0
99836,273,58,12470,215,0
99849,186,35,5285,151,0
99852,15,4,44,11,0
99861,410,76,25384,334,0
99871,68,12,672,56,0
99890,337,74,19462,263,0
99892,1552,299,374647,1253,0
99917,365,74,21534,291,0
99919,1204,251,239203,953,0
99921,365,74,21534,291,0
99933,571,114,52098,457,0
99935,200,40,6400,160,0
99952,539,101,44238,438,0
99954,950,193,146101,757,0
99958,1934,345,548205,1589,0
99974,1552,299,374647,1253,0
99997,1181,246,230010,935,0
99999,1204,251,239203,953,0
100007,72,14,812,58,0
100012,714,137,79049,577,0
100019,1876,359,544603,1517,0
100022,315,56,14504,259,0
100023,932,168,128352,764,0
100025,1558,313,389685,1245,0
100034,1876,359,544603,1517,0
100036,1280,232,243136,1048,0
100076,1558,313,389685,1245,0
100099,55,10,450,45,0
100118,1296,252,263088,1044,0
100133,821,171,111150,650,0
100151,771,137,86858,634,0
100154,1934,345,548205,1589,0
100166,932,168,128352,764,0
100194,252,45,9315,207,0
100198,950,193,146101,757,0
100201,1411,281,317530,1130,0
100214,1262,259,259777,1003,0
100229,443,85,30430,358,0
100249,1181,246,230010,935,0
100274,1262,259,259777,1003,0
100284,2102,402,683400,1700,0
100288,1558,313,389685,1245,0
100292,1342,282,298920,1060,0
100304,552,113,49607,439,0
100308,595,120,57000,475,0
100312,2102,402,683400,1700,0
100316,932,168,128352,764,0
100328,18,2,32,16,0
100338,976,180,143280,796,0
100350,1296,252,263088,1044,0
100352,1411,281,317530,1130,0
100368,68,15,795,53,0
100384,865,167,116566,698,0
100385,552,113,49607,439,0
100387,68,12,672,56,0
100402,122,22,2200,100,0
100428,1829,353,521028,1476,0
100433,22,6,96,16,0
100462,324,67,17219,257,0
100468,821,143,96954,678,0
100482,1296,252,263088,1044,0
100488,767,144,89712,623,0
100499,1411,281,317530,1130,0
100506,107,18,1602,89,0
100509,1331,255,274380,1076,0
100510,2102,402,683400,1700,0
100531,534,102,44064,432,0
100533,198,43,6665,155,0
100535,771,137,86858,634,0
100538,1025,201,165624,824,0
100582,971,184,144808,787,0
100600,346,76,20520,270,0
100606,252,45,9315,207,0
100607,821,171,111150,650,0
100627,1181,246,230010,935,0
100647,767,144,89712,623,0
100692,1657,315,422730,1342,0
100714,146,34,3808,112,0
100751,122,25,2425,97,0
100756,1829,353,521028,1476,0
100772,1541,306,377910,1235,0
100775,122,22,2200,100,0
100802,27,3,72,24,0
100815,20,5,75,15,0
100819,23,6,102,17,0
100840,395,72,23256,323,0
100851,337,74,19462,263,0
100859,360,66,19404,294,0
100873,89,15,1110,74,0
100880,821,171,111150,650,0
100901,1331,255,274380,1076,0
100906,37,11,286,26,0
100914,1331,255,274380,1076,0
100931,516,103,42539,413,0
100932,1934,345,548205,1589,0
100936,1280,232,243136,1048,0
100968,595,120,57000,475,0
100996,1829,353,521028,1476,0
101003,1025,201,165624,824,0
101005,1411,281,317530,1130,0
101009,10,2,16,8,0
101045,1296,252,263088,1044,0
101047,385,71,22294,314,0
101073,660,133,69928,527,0
101089,595,120,57000,475,0
101093,52,10,420,42,0
101109,77,12,780,65,0
101114,1541,306,377910,1235,0
101121,17,2,30,15,0
101122,1541,306,377910,1235,0
101130,1558,313,389685,1245,0
101133,535,94,41454,441,0
101135,1331,255,274380,1076,0
101140,1181,246,230010,935,0
101142,534,102,44064,432,0
101160,1541,306,377910,1235,0
101182,1558,313,389685,1245,0
101195,1657,315,422730,1342,0
101198,18,4,56,14,0
101199,1829,353,521028,1476,0
101229,1541,306,377910,1235,0
101230,164,34,4420,130,0
101242,821,143,96954,678,0
101246,976,180,143280,796,0
101247,1262,259,259777,1003,0
101256,572,130,57460,442,0
101259,146,34,3808,112,0
101267,1829,353,521028,1476,0
101270,1583,310,394630,1273,0
101272,551,102,45798,449,0
101277,1657,315,422730,1342,0
101281,1934,345,548205,1589,0
101293,1552,299,374647,1253,0
101294,366,70,20720,296,0
101318,976,180,143280,796,0
101331,534,102,44064,432,0
101335,1657,315,422730,1342,0
101367,77,19,1102,58,0
101374,976,180,143280,796,0
101384,571,114,52098,457,0
101385,62,16,736,46,0
101388,1552,299,374647,1253,0
101394,1025,201,165624,824,0
101407,324,67,17219,257,0
101432,767,144,89712,623,0
101437,1657,315,422730,1342,0
101444,516,103,42539,413,0
101470,1280,232,243136,1048,0
101490,362,69,20217,293,0
101492,1583,310,394630,1273,0
101496,1876,359,544603,1517,0
101506,49,9,360,40,0
101512,54,14,560,40,0
101517,2102,402,683400,1700,0
101524,1541,306,377910,1235,0
101533,1552,299,374647,1253,0
101573,264,56,11648,208,0
101610,821,171,111150,650,0
101621,641,131,66810,510,0
101631,1583,310,394630,1273,0
101644,793,158,100330,635,0
101651,700,128,73216,572,0
101660,1025,201,165624,824,0
101665,641,131,66810,510,0
101678,1558,313,389685,1245,0
101691,778,163,100245,615,0
101694,1411,281,317530,1130,0
101722,821,171,111150,650,0
101726,185,36,5364,149,0
101745,324,67,17219,257,0
101747,1181,246,230010,935,0
101762,365,74,21534,291,0
101774,778,163,100245,615,0
101794,113,24,2136,89,0
101813,395,72,23256,323,0
101817,535,94,41454,441,0
101820,552,113,49607,439,0
101843,1552,299,374647,1253,0
101845,568,114,51756,454,0
101846,1181,246,230010,935,0
101852,1280,232,243136,1048,0
101866,1204,251,239203,953,0
101892,976,180,143280,796,0
101931,571,114,52098,457,0
101935,497,97,38800,400,0
101936,252,45,9315,207,0
101969,119,22,2134,97,0
101976,595,120,57000,475,0
101993,1280,232,243136,1048,0
101997,105,15,1350,90,0
102000,1934,345,548205,1589,0
102024,568,114,51756,454,0
102047,14,3,33,11,0
102049,821,171,111150,650,0
102055,641,131,66810,510,0
102084,337,74,19462,263,0
102095,1181,246,230010,935,0
102097,1583,310,394630,1273,0
102111,1558,313,389685,1245,0
102115,620,121,60379,499,0
102117,1025,201,165624,824,0
102121,793,158,100330,635,0
102148,121,27,2538,94,0
102177,660,133,69928,527,0
102196,144,29,3335,115,0
102212,1280,232,243136,1048,0
102216,1934,345,548205,1589,0
102228,1181,246,230010,935,0
102248,48,10,380,38,0
102253,1583,310,394630,1273,0
102268,101,20,1620,81,0
102271,700,128,73216,572,0
102276,1934,345,548205,1589,0
102278,185,36,5364,149,0
102291,660,133,69928,527,0
102294,1342,282,298920,1060,0
102307,821,171,111150,650,0
102310,58,12,552,46,0
102318,33,8,200,25,0
102326,821,143,96954,678,0
102374,793,158,100330,635,0
102391,1204,251,239203,953,0
102402,1078,198,174240,880,0
102403,1876,359,544603,1517,0
102413,1657,315,422730,1342,0
102428,365,74,21534,291,0
102442,1829,353,521028,1476,0
102462,1025,201,165624,824,0
102466,836,151,103435,685,0
102477,641,131,66810,510,0
102481,346,76,20520,270,0
102501,362,69,20217,293,0
102503,207,41,6806,166,0
102504,778,163,100245,615,0
102506,12,3,27,9,0
102507,443,85,30430,358,0
102515,2102,402,683400,1700,0
102523,1262,259,259777,1003,0
102545,1280,232,243136,1048,0
102585,131,21,2310,110,0
102592,131,25,2650,106,0
102593,106,19,1653,87,0
102598,305,70,16450,235,0
102606,976,180,143280,796,0
102612,1583,310,394630,1273,0
102616,548,102,45492,446,0
102636,362,69,20217,293,0
102646,410,76,25384,334,0
102652,164,34,4420,130,0
102674,2102,402,683400,1700,0
102683,1331,255,274380,1076,0
102695,534,102,44064,432,0
102710,72,13,767,59,0
102727,1541,306,377910,1235,0
102736,252,45,9315,207,0
102759,1078,198,174240,880,0
102764,88,17,1207,71,0
102775,1552,299,374647,1253,0
102783,821,171,111150,650,0
102802,620,121,60379,499,0
102803,1262,259,259777,1003,0
102857,1025,201,165624,824,0
102873,539,101,44238,438,0
102874,767,144,89712,623,0
102875,405,82,26486,323,0
102892,1342,282,298920,1060,0
102900,1204,251,239203,953,0
102913,360,66,19404,294,0
102916,1541,306,377910,1235,0
102922,305,70,16450,235,0
102932,971,184,144808,787,0
102933,1342,282,298920,1060,0
102939,200,40,6400,160,0
102955,35,9,234,26,0
102959,1583,310,394630,1273,0
102966,714,137,79049,577,0
102982,641,131,66810,510,0
102983,373,74,22126,299,0
102994,497,97,38800,400,0
103030,36,6,180,30,0
103031,620,121,60379,499,0
103049,1583,310,394630,1273,0
103050,46,9,333,37,0
103068,160,29,3799,131,0
103081,819,152,101384,667,0
103094,714,137,79049,577,0
103100,61,11,550,50,0
103106,497,97,38800,400,0
103109,819,152,101384,667,0
103117,1876,359,544603,1517,0
103130,1331,255,274380,1076,0
103137,61,9,468,52,0
103163,2102,402,683400,1700,0
103186,47,8,312,39,0
103187,1657,315,422730,1342,0
103195,252,45,9315,207,0
103214,1829,353,521028,1476,0
103248,700,128,73216,572,0
103257,1262,259,259777,1003,0
103272,971,184,144808,787,0
103284,2102,402,683400,1700,0
103285,1280,232,243136,1048,0
103290,236,50,9300,186,0
103293,8,2,12,6,0
103300,1296,252,263088,1044,0
103301,595,120,57000,475,0
103323,971,184,144808,787,0
103343,971,184,144808,787,0
103346,568,114,51756,454,0
103354,1583,310,394630,1273,0
103391,821,143,96954,678,0
103412,131,21,2310,110,0
103429,793,158,100330,635,0
103452,1331,255,274380,1076,0
103475,97,22,1650,75,0
103478,836,151,103435,685,0
103501,252,45,9315,207,0
103506,497,97,38800,400,0
103510,714,137,79049,577,0
103523,1078,198,174240,880,0
103526,1296,252,263088,1044,0
103574,415,75,25500,340,0
103586,819,152,101384,667,0
103592,365,74,21534,291,0
103609,497,97,38800,400,0
103622,1934,345,548205,1589,0
103623,385,71,22294,314,0
103633,1541,306,377910,1235,0
103645,1876,359,544603,1517,0
103652,323,55,14740,268,0
103661,1558,313,389685,1245,0
103682,767,144,89712,623,0
103692,1331,255,274380,1076,0
103704,1934,345,548205,1589,0
103705,443,85,30430,358,0
103706,1411,281,317530,1130,0
103708,516,103,42539,413,0
103726,61,9,468,52,0
103727,1541,306,377910,1235,0
103736,2102,402,683400,1700,0
103744,1657,315,422730,1342,0
103763,1025,201,165624,824,0
103792,443,85,30430,358,0
103807,793,158,100330,635,0
103811,1411,281,317530,1130,0
103813,971,184,144808,787,0
103821,89,15,1110,74,0
103823,1078,198,174240,880,0
103829,950,193,146101,757,0
103841,198,43,6665,155,0
103845,1829,353,521028,1476,0
103850,61,14,658,47,0
103877,1829,353,521028,1476,0
103900,1342,282,298920,1060,0
103916,227,44,8052,183,0
103918,778,163,100245,615,0
103925,405,82,26486,323,0
103929,1934,345,548205,1589,0
103942,865,167,116566,698,0
103954,379,65,20410,314,0
103965,1280,232,243136,1048,0
103978,337,74,19462,263,0
103987,1078,198,174240,880,0
103992,2102,402,683400,1700,0
104016,1204,251,239203,953,0
104023,1296,252,263088,1044,0
104027,236,50,9300,186,0
104033,551,102,45798,449,0
104050,495,87,35496,408,0
104059,1280,232,243136,1048,0
104061,198,43,6665,155,0
104067,1331,255,274380,1076,0
104075,1657,315,422730,1342,0
104091,1934,345,548205,1589,0
104094,1829,353,521028,1476,0
104110,620,121,60379,499,0
104146,1552,299,374647,1253,0
104156,497,97,38800,400,0
104164,148,24,2976,124,0
104176,385,71,22294,314,0
104179,1657,315,422730,1342,0
104208,1829,353,521028,1476,0
104211,865,167,116566,698,0
104260,104,16,1408,88,0
104288,1657,315,422730,1342,0
104300,1262,259,259777,1003,0
104320,106,19,1653,87,0
104338,1583,310,394630,1273,0
104365,401,77,24948,324,0
104375,110,18,1656,92,0
104377,976,180,143280,796,0
104379,1583,310,394630,1273,0
104397,1280,232,243136,1048,0
104410,122,25,2425,97,0
104420,122,22,2200,100,0
104470,1829,353,521028,1476,0
104472,20,5,75,15,0
104480,1657,315,422730,1342,0
104494,282,50,11600,232,0
104497,1558,313,389685,1245,0
104504,1331,255,274380,1076,0
104507,571,114,52098,457,0
104515,534,102,44064,432,0
104522,1558,313,389685,1245,0
104530,264,56,11648,208,0
104539,174,36,4968,138,0
104541,1411,281,317530,1130,0
104543,1296,252,263088,1044,0
104544,1342,282,298920,1060,0
104588,105,15,1350,90,0
104603,1657,315,422730,1342,0
104609,321,54,14418,267,0
104610,1342,282,298920,1060,0
104615,30,6,144,24,0
104633,1411,281,317530,1130,0
104634,767,144,89712,623,0
104635,1296,252,263088,1044,0
104638,950,193,146101,757,0
104657,1296,252,263088,1044,0
104659,1657,315,422730,1342,0
104660,535,94,41454,441,0
104666,571,114,52098,457,0
104690,1342,282,298920,1060,0
104701,321,54,14418,267,0
104702,463,83,31540,380,0
104709,821,143,96954,678,0
104715,1280,232,243136,1048,0
104718,1583,310,394630,1273,0
104734,821,171,111150,650,0
104738,497,97,38800,400,0
104777,1876,359,544603,1517,0
104798,539,101,44238,438,0
104831,1296,252,263088,1044,0
104833,1876,359,544603,1517,0
104834,124,28,2688,96,0
104844,107,19,1672,88,0
104894,1558,313,389685,1245,0
104901,137,25,2800,112,0
104903,1262,259,259777,1003,0
104907,155,34,4114,121,0
104917,700,128,73216,572,0
104922,1280,232,243136,1048,0
104942,2102,402,683400,1700,0
104947,1342,282,298920,1060,0
104967,1876,359,544603,1517,0
104969,405,82,26486,323,0
104986,714,137,79049,577,0
105013,778,163,100245,615,0
105015,641,131,66810,510,0
105023,1583,310,394630,1273,0
105026,1876,359,544603,1517,0
105030,360,66,19404,294,0
105035,1829,353,521028,1476,0
105041,1078,198,174240,880,0
105043,236,50,9300,186,0
105050,1331,255,274380,1076,0
105088,131,25,2650,106,0
105090,264,56,11648,208,0
105092,535,94,41454,441,0
105099,595,121,57354,474,0
105107,660,133,69928,527,0
105112,317,63,16002,254,0
105116,1078,198,174240,880,0
105120,595,121,57354,474,0
105122,186,35,5285,151,0
105130,641,131,66810,510,0
105133,1262,259,259777,1003,0
105135,660,133,69928,527,0
105141,44,10,340,34,0
105150,1411,281,317530,1130,0
105151,401,77,24948,324,0
105157,497,97,38800,400,0
105190,58,12,552,46,0
105191,659,132,69928,527,0
105205,68,14,756,54,0
105213,659,132,69928,527,0
105218,793,158,100330,635,0
105222,405,82,26486,323,0
105229,106,19,1653,87,0
105230,971,184,144808,787,0
105232,101,20,1620,81,0
105249,641,131,66810,510,0
105253,373,74,22126,299,0
105256,380,76,23104,304,0
105274,595,120,57000,475,0
105288,971,184,144808,787,0
105304,1558,313,389685,1245,0
105313,865,167,116566,698,0
105315,1280,232,243136,1048,0
105324,410,76,25384,334,0
105326,236,50,9300,186,0
105379,323,55,14740,268,0
105380,1657,315,422730,1342,0
105384,146,34,3808,112,0
105386,819,152,101384,667,0
105391,1583,310,394630,1273,0
105411,346,76,20520,270,0
105419,1204,251,239203,953,0
105422,572,130,57460,442,0
105427,1829,353,521028,1476,0
105429,767,144,89712,623,0
105435,620,121,60379,499,0
105436,107,18,1602,89,0
105449,1829,353,521028,1476,0
105460,714,137,79049,577,0
105499,200,40,6400,160,0
105512,821,171,111150,650,0
105531,976,180,143280,796,0
105543,89,15,1110,74,0
105546,410,76,25384,334,0
105558,380,76,23104,304,0
105568,415,75,25500,340,0
105569,1829,353,521028,1476,0
105573,61,11,550,50,0
105584,346,76,20520,270,0
105594,1296,252,263088,1044,0
105607,155,35,4200,120,0
105610,171,35,4760,136,0
105613,1558,313,389685,1245,0
105642,821,143,96954,678,0
105645,88,17,1207,71,0
105687,700,128,73216,572,0
105689,58,12,552,46,0
105691,1541,306,377910,1235,0
105702,821,143,96954,678,0
105713,1280,232,243136,1048,0
105732,207,41,6806,166,0
105760,1876,359,544603,1517,0
105767,175,29,4234,146,0
105774,122,22,2200,100,0
105784,516,103,42539,413,0
105833,1342,282,298920,1060,0
105836,932,168,128352,764,0
105844,2102,402,683400,1700,0
105865,1657,315,422730,1342,0
105884,1541,306,377910,1235,0
105895,104,16,1408,88,0
105917,1331,255,274380,1076,0
105918,1583,310,394630,1273,0
105920,362,69,20217,293,0
105921,552,113,49607,439,0
105927,1296,252,263088,1044,0
105932,2102,402,683400,1700,0
105944,836,151,103435,685,0
105946,321,54,14418,267,0
105949,193,39,6006,154,0
105956,155,34,4114,121,0
105983,2102,402,683400,1700,0
106015,660,133,69928,527,0
106016,395,72,23256,323,0
106040,1078,198,174240,880,0
106056,595,121,57354,474,0
106062,362,69,20217,293,0
106065,821,143,96954,678,0
106073,2102,402,683400,1700,0
106118,31,8,184,23,0
106120,620,121,60379,499,0
106130,1342,282,298920,1060,0
106134,160,29,3799,131,0
106136,714,137,79049,577,0
106146,1829,353,521028,1476,0
106155,26,6,120,20,0
106156,771,137,86858,634,0
106167,641,131,66810,510,0
106186,932,168,128352,764,0
106195,144,29,3335,115,0
106198,346,76,20520,270,0
106214,362,69,20217,293,0
106215,401,77,24948,324,0
106272,155,34,4114,121,0
106280,410,76,25384,334,0
106282,1657,315,422730,1342,0
106288,1262,259,259777,1003,0
106302,571,114,52098,457,0
106313,148,24,2976,124,0
106323,819,152,101384,667,0
106361,1025,201,165624,824,0
106377,373,74,22126,299,0
106392,1025,201,165624,824,0
106399,362,69,20217,293,0
106406,535,94,41454,441,0
106420,595,120,57000,475,0
106423,534,102,44064,432,0
106429,821,143,96954,678,0
106432,714,137,79049,577,0
106446,971,184,144808,787,0
106459,33,8,200,25,0
106462,1296,252,263088,1044,0
106472,236,50,9300,186,0
106475,379,65,20410,314,0
106478,401,77,24948,324,0
106489,1411,281,317530,1130,0
106494,119,22,2134,97,0
106502,836,151,103435,685,0
106503,1331,255,274380,1076,0
106513,463,83,31540,380,0
106518,534,102,44064,432,0
106521,1181,246,230010,935,0
106526,865,167,116566,698,0
106537,1829,353,521028,1476,0
106577,1280,232,243136,1048,0
106617,620,121,60379,499,0
106632,1876,359,544603,1517,0
106638,113,24,2136,89,0
106642,217,44,7612,173,0
106666,401,77,24948,324,0
106670,1876,359,544603,1517,0
106676,1558,313,389685,1245,0
106686,1876,359,544603,1517,0
106688,119,25,2350,94,0
106691,1296,252,263088,1044,0
106693,18,3,45,15,0
106698,571,114,52098,457,0
106712,362,69,20217,293,0
106718,346,76,20520,270,0
106721,122,25,2425,97,0
106736,50,8,336,42,0
106743,346,76,20520,270,0
106749,1934,345,548205,1589,0
106757,714,137,79049,577,0
106761,1552,299,374647,1253,0
106769,207,41,6806,166,0
106772,771,137,86858,634,0
106789,1541,306,377910,1235,0
106806,346,76,20520,270,0
106824,324,67,17219,257,0
106831,1552,299,374647,1253,0
106834,1541,306,377910,1235,0
106843,641,131,66810,510,0
106852,1876,359,544603,1517,0
106858,124,28,2688,96,0
106864,552,113,49607,439,0
106871,1280,232,243136,1048,0
106893,641,131,66810,510,0
106896,1280,232,243136,1048,0
106901,793,158,100330,635,0
106918,572,130,57460,442,0
106922,793,158,100330,635,0
106932,1657,315,422730,1342,0
106941,134,30,3120,104,0
106963,410,76,25384,334,0
107006,1296,252,263088,1044,0
107008,1078,198,174240,880,0
107018,1280,232,243136,1048,0
107047,362,69,20217,293,0
107080,366,70,20720,296,0
107110,1204,251,239203,953,0
107121,395,72,23256,323,0
107124,516,103,42539,413,0
107145,778,163,100245,615,0
107150,410,76,25384,334,0
107157,1181,246,230010,935,0
107161,950,193,146101,757,0
107175,122,20,2040,102,0
107182,1558,313,389685,1245,0
107193,373,74,22126,299,0
107194,2102,402,683400,1700,0
107205,1558,313,389685,1245,0
107213,1296,252,263088,1044,0
107214,1558,313,389685,1245,0
107228,160,29,3799,131,0
107230,77,18,1062,59,0
107233,2102,402,683400,1700,0
107234,1552,299,374647,1253,0
107235,1829,353,521028,1476,0
107242,771,137,86858,634,0
107243,1829,353,521028,1476,0
107254,1296,252,263088,1044,0
107266,836,151,103435,685,0
107281,767,144,89712,623,0
107285,1657,315,422730,1342,0
107290,660,133,69928,527,0
107298,1025,201,165624,824,0
107304,1280,232,243136,1048,0
107344,365,74,21534,291,0
107346,1280,232,243136,1048,0
107359,836,151,103435,685,0
107360,1204,251,239203,953,0
107361,1829,353,521028,1476,0
107362,315,56,14504,259,0
107373,1583,310,394630,1273,0
107385,950,193,146101,757,0
107451,497,97,38800,400,0
107452,1181,246,230010,935,0
107460,552,113,49607,439,0
107466,77,12,780,65,0
107508,1583,310,394630,1273,0
107514,1331,255,274380,1076,0
107523,950,193,146101,757,0
107527,1025,201,165624,824,0
107541,1331,255,274380,1076,0
107548,1078,198,174240,880,0
107551,767,144,89712,623,0
107565,516,103,42539,413,0
107566,1552,299,374647,1253,0
107568,1583,310,394630,1273,0
107583,186,35,5285,151,0
107600,1552,299,374647,1253,0
107604,12,2,20,10,0
107607,793,158,100330,635,0
107627,29,5,120,24,0
107653,620,121,60379,499,0
107658,1552,299,374647,1253,0
107672,463,83,31540,380,0
107685,1296,252,263088,1044,0
107723,1025,201,165624,824,0
107740,865,167,116566,698,0
107748,660,133,69928,527,0
107752,110,27,2241,83,0
107759,821,171,111150,650,0
107774,1262,259,259777,1003,0
107775,1078,198,174240,880,0
107776,595,121,57354,474,0
107785,1331,255,274380,1076,0
107805,1583,310,394630,1273,0
107808,1342,282,298920,1060,0
107813,1934,345,548205,1589,0
107816,497,97,38800,400,0
107817,1829,353,521028,1476,0
107818,1657,315,422730,1342,0
107819,950,193,146101,757,0
107820,105,15,1350,90,0
107821,379,65,20410,314,0
107846,1331,255,274380,1076,0
107851,155,27,3456,128,0
107858,659,132,69928,527,0
107862,44,9,315,35,0
107868,1181,246,230010,935,0
107871,771,137,86858,634,0
107878,821,171,111150,650,0
107899,200,40,6400,160,0
107917,50,8,336,42,0
107926,568,114,51756,454,0
107929,47,11,396,36,0
107930,21,4,68,17,0
107953,52,11,451,41,0
107976,156,34,4148,122,0
107995,971,184,144808,787,0
107999,620,121,60379,499,0
108011,443,85,30430,358,0
108019,379,65,20410,314,0
108031,415,75,25500,340,0
108043,971,184,144808,787,0
108070,1558,313,389685,1245,0
108077,15,6,54,9,0
108109,793,158,100330,635,0
108129,264,56,11648,208,0
108151,1657,315,422730,1342,0
108158,595,120,57000,475,0
108161,1657,315,422730,1342,0
108168,1331,255,274380,1076,0
108169,1558,313,389685,1245,0
108171,971,184,144808,787,0
108172,595,121,57354,474,0
108175,373,74,22126,299,0
108187,1342,282,298920,1060,0
108188,571,114,52098,457,0
108210,516,103,42539,413,0
108241,1934,345,548205,1589,0
108247,1025,201,165624,824,0
108249,700,128,73216,572,0
108258,385,71,22294,314,0
108264,131,21,2310,110,0
108271,767,144,89712,623,0
108276,14,3,33,11,0
108278,1411,281,317530,1130,0
108283,539,101,44238,438,0
108293,1262,259,259777,1003,0
108301,1541,306,377910,1235,0
108313,1558,313,389685,1245,0
108319,551,102,45798,449,0
108325,1280,232,243136,1048,0
108326,821,171,111150,650,0
108327,1829,353,521028,1476,0
108355,1657,315,422730,1342,0
108364,207,41,6806,166,0
108379,572,130,57460,442,0
108380,463,83,31540,380,0
108385,198,43,6665,155,0
108388,227,44,8052,183,0
108395,595,120,57000,475,0
108396,410,76,25384,334,0
108406,548,102,45492,446,0
108416,1657,315,422730,1342,0
108418,18,3,45,15,0
108424,1342,282,298920,1060,0
108425,1541,306,377910,1235,0
108435,61,11,550,50,0
108451,793,158,100330,635,0
108461,198,43,6665,155,0
108487,443,85,30430,358,0
108509,131,25,2650,106,0
108514,16,4,48,12,0
108517,595,120,57000,475,0
108537,144,29,3335,115,0
108540,1829,353,521028,1476,0
108545,193,39,6006,154,0
108547,950,193,146101,757,0
108569,198,43,6665,155,0
108587,273,58,12470,215,0
108596,950,193,146101,757,0
108602,1558,313,389685,1245,0
108606,77,17,1020,60,0
108616,778,163,100245,615,0
108621,836,151,103435,685,0
108625,551,102,45798,449,0
108626,551,102,45798,449,0
108628,1558,313,389685,1245,0
108636,516,103,42539,413,0
108637,1411,281,317530,1130,0
108654,548,102,45492,446,0
108659,793,158,100330,635,0
108662,1331,255,274380,1076,0
108670,1078,198,174240,880,0
108678,264,56,11648,208,0
108702,1552,299,374647,1253,0
108708,660,133,69928,527,0
108715,1829,353,521028,1476,0
108719,410,76,25384,334,0
108732,932,168,128352,764,0
108737,700,128,73216,572,0
108743,337,74,19462,263,0
108752,595,120,57000,475,0
108771,552,113,49607,439,0
108773,1583,310,394630,1273,0
108790,21,4,68,17,0
108803,105,16,1424,89,0
108815,1411,281,317530,1130,0
108819,362,69,20217,293,0
108825,443,85,30430,358,0
108851,146,34,3808,112,0
108864,315,56,14504,259,0
108878,1552,299,374647,1253,0
108888,819,152,101384,667,0
108924,1204,251,239203,953,0
108925,1296,252,263088,1044,0
108928,1657,315,422730,1342,0
108937,950,193,146101,757,0
108944,31,9,198,22,0
108950,1583,310,394630,1273,0
108968,1025,201,165624,824,0
108982,26,5,105,21,0
108998,1296,252,263088,1044,0
109014,1078,198,174240,880,0
109043,1078,198,174240,880,0
109053,8,1,7,7,0
109070,700,128,73216,572,0
109074,463,83,31540,380,0
109076,1558,313,389685,1245,0
109091,1829,353,521028,1476,0
109093,264,56,11648,208,0
109102,160,29,3799,131,0
109128,821,171,111150,650,0
109136,70,12,696,58,0
109145,1025,201,165624,824,0
109149,1262,259,259777,1003,0
109153,324,67,17219,257,0
109174,1331,255,274380,1076,0
109184,1657,315,422730,1342,0
109191,571,114,52098,457,0
109212,659,132,69928,527,0
109227,1829,353,521028,1476,0
109228,1934,345,548205,1589,0
109243,660,133,69928,527,0
109249,160,32,4096,128,0
109269,105,22,1826,83,0
109274,1583,310,394630,1273,0
109317,1558,313,389685,1245,0
109324,1280,232,243136,1048,0
109334,194,39,6045,155,0
109343,174,36,4968,138,0
109375,714,137,79049,577,0
109381,40,6,204,34,0
109388,568,114,51756,454,0
109394,75,19,1064,56,0
109408,36,10,260,26,0
109456,1657,315,422730,1342,0
109457,976,180,143280,796,0
109462,160,32,4096,128,0
109463,836,151,103435,685,0
109468,1262,259,259777,1003,0
109476,1262,259,259777,1003,0
109486,1541,306,377910,1235,0
109497,324,67,17219,257,0
109503,1552,299,374647,1253,0
109518,495,87,35496,408,0
109576,317,63,16002,254,0
109579,32,5,135,27,0
109586,1829,353,521028,1476,0
109591,1331,255,274380,1076,0
109602,85,18,1206,67,0
109609,379,65,20410,314,0
109620,552,113,49607,439,0
109624,1204,251,239203,953,0
109631,273,58,12470,215,0
109641,771,137,86858,634,0
109642,1296,252,263088,1044,0
109645,572,130,57460,442,0
109652,366,70,20720,296,0
109689,1181,246,230010,935,0
109695,1342,282,298920,1060,0
109698,1876,359,544603,1517,0
109704,595,120,57000,475,0
109713,551,102,45798,449,0
109716,171,35,4760,136,0
109719,1204,251,239203,953,0
109726,274,57,12369,217,0
109727,552,113,49607,439,0
109733,1541,306,377910,1235,0
109734,85,18,1206,67,0
109738,1583,310,394630,1273,0
109742,950,193,146101,757,0
109771,1342,282,298920,1060,0
109785,19,4,60,15,0
109789,366,70,20720,296,0
109802,548,102,45492,446,0
109808,1558,313,389685,1245,0
109812,1078,198,174240,880,0
109815,385,71,22294,314,0
109816,539,101,44238,438,0
109826,1876,359,544603,1517,0
109832,10,1,9,9,0
109833,379,65,20410,314,0
109840,819,152,101384,667,0
109841,821,143,96954,678,0
109848,31,10,210,21,0
109860,11,4,28,7,0
109890,1262,259,259777,1003,0
109910,21,3,54,18,0
109927,568,114,51756,454,0
109953,64,16,768,48,0
109958,1262,259,259777,1003,0
109962,620,121,60379,499,0
109964,337,74,19462,263,0
109982,819,152,101384,667,0
109999,1204,251,239203,953,0
110009,552,113,49607,439,0
110012,821,171,111150,650,0
110017,346,76,20520,270,0
110035,1342,282,298920,1060,0
110043,1331,255,274380,1076,0
110049,819,152,101384,667,0
110051,595,121,57354,474,0
110052,1558,313,389685,1245,0
110059,548,102,45492,446,0
110063,1876,359,544603,1517,0
110064,548,102,45492,446,0
110084,1541,306,377910,1235,0
110091,32,7,175,25,0
110093,1934,345,548205,1589,0
110097,366,70,20720,296,0
110106,1876,359,544603,1517,0
110113,1552,299,374647,1253,0
110136,535,94,41454,441,0
110145,379,65,20410,314,0
110147,971,184,144808,787,0
110150,1280,232,243136,1048,0
110165,1025,201,165624,824,0
110172,61,14,658,47,0
110174,33,5,140,28,0
110182,641,131,66810,510,0
110186,274,57,12369,217,0
110193,1934,345,548205,1589,0
110205,365,74,21534,291,0
110213,61,13,624,48,0
110217,1876,359,544603,1517,0
110220,1657,315,422730,1342,0
110222,1262,259,259777,1003,0
110227,52,11,451,41,0
110228,1657,315,422730,1342,0
110247,865,167,116566,698,0
110256,568,114,51756,454,0
110286,1558,313,389685,1245,0
110322,410,76,25384,334,0
110323,443,85,30430,358,0
110337,1657,315,422730,1342,0
110347,57,7,350,50,0
110366,395,72,23256,323,0
110383,47,11,396,36,0
110392,1558,313,389685,1245,0
110404,620,121,60379,499,0
110428,305,70,16450,235,0
110434,976,180,143280,796,0
110438,595,121,57354,474,0
110440,1829,353,521028,1476,0
110447,401,77,24948,324,0
110449,793,158,100330,635,0
110465,1342,282,298920,1060,0
110467,793,158,100330,635,0
110489,200,40,6400,160,0
110491,227,44,8052,183,0
110499,1657,315,422730,1342,0
110503,1078,198,174240,880,0
110507,1541,306,377910,1235,0
110512,360,66,19404,294,0
110513,1541,306,377910,1235,0
110521,113,20,1860,93,0
110522,836,151,103435,685,0
110525,620,121,60379,499,0
110527,101,20,1620,81,0
110568,1078,198,174240,880,0
110569,548,102,45492,446,0
110598,49,8,328,41,0
110600,415,75,25500,340,0
110614,1876,359,544603,1517,0
110616,836,151,103435,685,0
110650,207,41,6806,166,0
110684,1411,281,317530,1130,0
110697,379,65,20410,314,0
110700,2102,402,683400,1700,0
110707,497,97,38800,400,0
110721,366,70,20720,296,0
110723,171,35,4760,136,0
110737,1876,359,544603,1517,0
110745,1204,251,239203,953,0
110750,1078,198,174240,880,0
110754,821,171,111150,650,0
110761,1331,255,274380,1076,0
110765,551,102,45798,449,0
110768,379,65,20410,314,0
110775,971,184,144808,787,0
110778,1583,310,394630,1273,0
110783,572,130,57460,442,0
110798,379,65,20410,314,0
110813,1876,359,544603,1517,0
110814,548,102,45492,446,0
110825,1876,359,544603,1517,0
110829,155,35,4200,120,0
110835,1078,198,174240,880,0
110846,68,14,756,54,0
110852,836,151,103435,685,0
110853,1331,255,274380,1076,0
110857,1583,310,394630,1273,0
110870,1934,345,548205,1589,0
110872,1296,252,263088,1044,0
110876,415,75,25500,340,0
110884,971,184,144808,787,0
110886,767,144,89712,623,0
110889,1583,310,394630,1273,0
110894,443,85,30430,358,0
110899,1583,310,394630,1273,0
110918,68,12,672,56,0
110941,932,168,128352,764,0
110956,405,82,26486,323,0
110978,1296,252,263088,1044,0
111007,1657,315,422730,1342,0
111027,1552,299,374647,1253,0
111029,821,143,96954,678,0
111036,1541,306,377910,1235,0
111039,497,97,38800,400,0
111041,1262,259,259777,1003,0
111043,595,121,57354,474,0
111052,950,193,146101,757,0
111053,1876,359,544603,1517,0
111060,65,17,816,48,0
111076,264,56,11648,208,0
111081,1657,315,422730,1342,0
111083,155,27,3456,128,0
111089,193,39,6006,154,0
111099,571,114,52098,457,0
111148,44,9,315,35,0
111150,793,158,100330,635,0
111171,171,35,4760,136,0
111172,1280,232,243136,1048,0
111197,1657,315,422730,1342,0
111200,1934,345,548205,1589,0
111209,1025,201,165624,824,0
111213,595,120,57000,475,0
111222,1657,315,422730,1342,0
111234,1078,198,174240,880,0
111247,380,76,23104,304,0
111259,932,168,128352,764,0
111280,8,2,12,6,0
111282,595,121,57354,474,0
111328,778,163,100245,615,0
111331,362,69,20217,293,0
111335,1558,313,389685,1245,0
111341,185,36,5364,149,0
111345,821,171,111150,650,0
111354,315,56,14504,259,0
111356,1541,306,377910,1235,0
111363,68,14,756,54,0
111375,1657,315,422730,1342,0
111398,144,29,3335,115,0
111403,1876,359,544603,1517,0
111411,836,151,103435,685,0
111420,185,36,5364,149,0
111424,821,143,96954,678,0
111425,155,34,4114,121,0
111434,160,29,3799,131,0
111437,1342,282,298920,1060,0
111438,552,113,49607,439,0
111454,497,97,38800,400,0
111463,516,103,42539,413,0
111469,495,87,35496,408,0
111473,620,121,60379,499,0
111496,700,128,73216,572,0
111517,836,151,103435,685,0
111522,971,184,144808,787,0
111532,932,168,128352,764,0
111541,410,76,25384,334,0
111561,771,137,86858,634,0
111566,1934,345,548205,1589,0
111581,659,132,69928,527,0
111583,2102,402,683400,1700,0
111600,2102,402,683400,1700,0
111606,1262,259,259777,1003,0
111608,70,15,825,55,0
111624,836,151,103435,685,0
111627,1541,306,377910,1235,0
111642,1411,281,317530,1130,0
111647,865,167,116566,698,0
111662,1342,282,298920,1060,0
111664,534,102,44064,432,0
111668,62,16,736,46,0
111692,72,14,812,58,0
111705,572,130,57460,442,0
111711,1541,306,377910,1235,0
111712,227,44,8052,183,0
111723,821,143,96954,678,0
111727,373,74,22126,299,0
111747,171,35,4760,136,0
111766,714,137,79049,577,0
111771,365,74,21534,291,0
111774,1541,306,377910,1235,0
111778,282,50,11600,232,0
111787,2102,402,683400,1700,0
111798,2102,402,683400,1700,0
111813,37,5,160,32,0
111834,1262,259,259777,1003,0
111839,865,167,116566,698,0
111864,1342,282,298920,1060,0
111872,620,121,60379,499,0
111892,865,167,116566,698,0
111896,61,9,468,52,0
111925,101,20,1620,81,0
111928,660,133,69928,527,0
111929,75,19,1064,56,0
111939,26,5,105,21,0
111951,373,74,22126,299,0
111977,1181,246,230010,935,0
111987,1411,281,317530,1130,0
111997,110,18,1656,92,0
112013,767,144,89712,623,0
112026,1541,306,377910,1235,0
112042,1552,299,374647,1253,0
112063,1262,259,259777,1003,0
112069,1934,345,548205,1589,0
112084,1280,232,243136,1048,0
112087,1657,315,422730,1342,0
112105,1181,246,230010,935,0
112117,119,22,2134,97,0
112120,22,3,57,19,0
112121,700,128,73216,572,0
112125,571,114,52098,457,0
112140,274,57,12369,217,0
112143,495,87,35496,408,0
112155,1657,315,422730,1342,0
112172,771,137,86858,634,0
112195,1331,255,274380,1076,0
112202,119,25,2350,94,0
112210,767,144,89712,623,0
112216,660,133,69928,527,0
112224,1876,359,544603,1517,0
112227,950,193,146101,757,0
112232,52,11,451,41,0
112236,1280,232,243136,1048,0
112256,495,87,35496,408,0
112264,1280,232,243136,1048,0
112275,819,152,101384,667,0
112279,595,121,57354,474,0
112296,1262,259,259777,1003,0
112308,1876,359,544603,1517,0
112357,497,97,38800,400,0
112371,324,67,17219,257,0
112387,1204,251,239203,953,0
112390,160,32,4096,128,0
112397,700,128,73216,572,0
112408,105,22,1826,83,0
112416,217,44,7612,173,0
112419,463,83,31540,380,0
112434,539,101,44238,438,0
112451,1204,251,239203,953,0
112454,552,113,49607,439,0
112466,72,13,767,59,0
112476,88,17,1207,71,0
112485,1280,232,243136,1048,0
112486,1411,281,317530,1130,0
112495,771,137,86858,634,0
112520,552,113,49607,439,0
112522,443,85,30430,358,0
112534,321,54,14418,267,0
112536,1558,313,389685,1245,0
112560,1541,306,377910,1235,0
112563,1583,310,394630,1273,0
112564,976,180,143280,796,0
112582,379,65,20410,314,0
112593,1829,353,521028,1476,0
112596,1411,281,317530,1130,0
112612,1934,345,548205,1589,0
112618,1078,198,174240,880,0
112644,1411,281,317530,1130,0
112658,1657,315,422730,1342,0
112660,305,70,16450,235,0
112693,1181,246,230010,935,0
112717,700,128,73216,572,0
112734,700,128,73216,572,0
112741,61,7,378,54,0
112745,198,43,6665,155,0
112748,1331,255,274380,1076,0
112763,572,130,57460,442,0
112773,401,77,24948,324,0
112780,572,130,57460,442,0
112786,778,163,100245,615,0
112792,495,87,35496,408,0
112809,55,11,484,44,0
112827,1342,282,298920,1060,0
112831,1078,198,174240,880,0
112833,113,24,2136,89,0
112835,778,163,100245,615,0
112853,865,167,116566,698,0
112859,1262,259,259777,1003,0
112871,321,54,14418,267,0
112898,305,70,16450,235,0
112900,620,121,60379,499,0
112931,1411,281,317530,1130,0
112935,1262,259,259777,1003,0
112956,1296,252,263088,1044,0
112960,1657,315,422730,1342,0
112982,821,143,96954,678,0
112997,595,121,57354,474,0
113011,97,22,1650,75,0
113013,122,20,2040,102,0
113045,19,2,34,17,0
113047,516,103,42539,413,0
113057,366,70,20720,296,0
113068,105,15,1350,90,0
113084,1552,299,374647,1253,0
113100,198,43,6665,155,0
113107,1078,198,174240,880,0
113128,1876,359,544603,1517,0
113147,315,56,14504,259,0
113164,57,7,350,50,0
113168,778,163,100245,615,0
113171,821,171,111150,650,0
113199,131,25,2650,106,0
113201,620,121,60379,499,0
113202,971,184,144808,787,0
113213,1025,201,165624,824,0
113218,1552,299,374647,1253,0
113224,264,56,11648,208,0
113227,1558,313,389685,1245,0
113232,976,180,143280,796,0
113235,1342,282,298920,1060,0
113246,379,65,20410,314,0
113268,127,29,2842,98,0
113278,1204,251,239203,953,0
113280,1541,306,377910,1235,0
113284,595,121,57354,474,0
113298,821,171,111150,650,0
113341,950,193,146101,757,0
113352,1280,232,243136,1048,0
113357,778,163,100245,615,0
113366,821,171,111150,650,0
113376,194,39,6045,155,0
113382,337,74,19462,263,0
113390,380,76,23104,304,0
113402,198,43,6665,155,0
113421,463,83,31540,380,0
113422,2102,402,683400,1700,0
113424,1583,310,394630,1273,0
113429,865,167,116566,698,0
113441,1342,282,298920,1060,0
113448,415,75,25500,340,0
113468,1262,259,259777,1003,0
113474,1876,359,544603,1517,0
113475,405,82,26486,323,0
113505,534,102,44064,432,0
113514,1262,259,259777,1003,0
113518,1331,255,274380,1076,0
113525,134,30,3120,104,0
113536,971,184,144808,787,0
113542,767,144,89712,623,0
113549,950,193,146101,757,0
113552,714,137,79049,577,0
113557,700,128,73216,572,0
113576,539,101,44238,438,0
113578,1876,359,544603,1517,0
113583,105,16,1424,89,0
113585,976,180,143280,796,0
113587,175,29,4234,146,0
113588,264,56,11648,208,0
113593,305,70,16450,235,0
113599,305,70,16450,235,0
113611,1025,201,165624,824,0
113620,819,152,101384,667,0
113633,865,167,116566,698,0
113640,1204,251,239203,953,0
113658,1025,201,165624,824,0
113662,1181,246,230010,935,0
113666,119,22,2134,97,0
113676,315,56,14504,259,0
113683,572,130,57460,442,0
113686,52,11,451,41,0
113691,273,58,12470,215,0
113694,1078,198,174240,880,0
113698,516,103,42539,413,0
113703,548,102,45492,446,0
113706,1296,252,263088,1044,0
113718,534,102,44064,432,0
113719,69,12,684,57,0
113743,1583,310,394630,1273,0
113763,950,193,146101,757,0
113778,1583,310,394630,1273,0
113785,131,25,2650,106,0
113805,252,45,9315,207,0
113816,323,55,14740,268,0
113818,976,180,143280,796,0
113843,405,82,26486,323,0
113851,324,67,17219,257,0
113854,976,180,143280,796,0
113860,1411,281,317530,1130,0
113862,46,9,333,37,0
113866,778,163,100245,615,0
113878,1262,259,259777,1003,0
113880,171,35,4760,136,0
113901,61,9,468,52,0
113911,401,77,24948,324,0
113916,714,137,79049,577,0
113931,778,163,100245,615,0
113938,1657,315,422730,1342,0
113953,1583,310,394630,1273,0
113962,315,56,14504,259,0
113989,572,130,57460,442,0
114005,315,56,14504,259,0
114017,174,36,4968,138,0
114032,836,151,103435,685,0
114036,1411,281,317530,1130,0
114038,410,76,25384,334,0
114042,2102,402,683400,1700,0
114062,2102,402,683400,1700,0
114070,1331,255,274380,1076,0
114080,1204,251,239203,953,0
114087,1280,232,243136,1048,0
114097,273,58,12470,215,0
114102,714,137,79049,577,0
114105,380,76,23104,304,0
114107,112,18,1692,94,0
114123,101,20,1620,81,0
114124,1657,315,422730,1342,0
114130,6,2,8,4,0
114148,620,121,60379,499,0
114164,539,101,44238,438,0
114166,1342,282,298920,1060,0
114169,134,30,3120,104,0
114176,171,35,4760,136,0
114188,971,184,144808,787,0
114204,26,8,144,18,0
114207,971,184,144808,787,0
114211,360,66,19404,294,0
114235,572,130,57460,442,0
114269,317,63,16002,254,0
114270,19,3,48,16,0
114271,595,120,57000,475,0
114281,620,121,60379,499,0
114288,186,35,5285,151,0
114300,44,10,340,34,0
114304,1541,306,377910,1235,0
114309,497,97,38800,400,0
114326,317,63,16002,254,0
114338,155,34,4114,121,0
114340,264,56,11648,208,0
114345,836,151,103435,685,0
114372,836,151,103435,685,0
114381,1296,252,263088,1044,0
114398,8,4,16,4,0
114403,60,12,576,48,0
114413,1204,251,239203,953,0
114423,620,121,60379,499,0
114441,552,113,49607,439,0
114450,463,83,31540,380,0
114461,1558,313,389685,1245,0
114474,1934,345,548205,1589,0
114481,2102,402,683400,1700,0
114496,2102,402,683400,1700,0
114506,571,114,52098,457,0
114525,1411,281,317530,1130,0
114541,1583,310,394630,1273,0
114551,568,114,51756,454,0
114564,35,9,234,26,0
114573,778,163,100245,615,0
114585,17,4,52,13,0
114622,56,13,559,43,0
114627,401,77,24948,324,0
114658,463,83,31540,380,0
114666,18,5,65,13,0
114673,539,101,44238,438,0
114678,620,121,60379,499,0
114679,282,50,11600,232,0
114680,385,71,22294,314,0
114685,1829,353,521028,1476,0
114747,819,152,101384,667,0
114756,836,151,103435,685,0
114776,131,25,2650,106,0
114779,264,56,11648,208,0
114784,572,130,57460,442,0
114803,77,19,1102,58,0
114815,317,63,16002,254,0
114816,497,97,38800,400,0
114830,714,137,79049,577,0
114840,274,57,12369,217,0
114847,385,71,22294,314,0
114849,497,97,38800,400,0
114852,88,17,1207,71,0
114873,932,168,128352,764,0
114874,373,74,22126,299,0
114875,497,97,38800,400,0
114883,380,76,23104,304,0
114889,1204,251,239203,953,0
114904,171,35,4760,136,0
114907,821,143,96954,678,0
114933,88,17,1207,71,0
114934,148,24,2976,124,0
114935,1204,251,239203,953,0
114963,595,121,57354,474,0
114965,1583,310,394630,1273,0
114984,1181,246,230010,935,0
115005,1583,310,394630,1273,0
115020,185,36,5364,149,0
115030,410,76,25384,334,0
115034,548,102,45492,446,0
115041,1280,232,243136,1048,0
115055,13,2,22,11,0
115066,1657,315,422730,1342,0
115071,1558,313,389685,1245,0
115086,135,30,3150,105,0
115097,373,74,22126,299,0
115105,548,102,45492,446,0
115106,321,54,14418,267,0
115109,1541,306,377910,1235,0
115155,1342,282,298920,1060,0
115160,61,13,624,48,0
115167,767,144,89712,623,0
115182,26,4,88,22,0
115187,362,69,20217,293,0
115211,497,97,38800,400,0
115213,264,56,11648,208,0
115234,641,131,66810,510,0
115248,174,36,4968,138,0
115258,373,74,22126,299,0
115260,113,24,2136,89,0
115267,1342,282,298920,1060,0
115274,1829,353,521028,1476,0
115284,551,102,45798,449,0
115329,105,22,1826,83,0
115351,1331,255,274380,1076,0
115374,535,94,41454,441,0
115418,1025,201,165624,824,0
115430,175,29,4234,146,0
115438,1181,246,230010,935,0
115449,61,13,624,48,0
115470,1829,353,521028,1476,0
115472,410,76,25384,334,0
115479,6,2,8,4,0
115485,323,55,14740,268,0
115515,539,101,44238,438,0
115522,1411,281,317530,1130,0
115533,198,43,6665,155,0
115596,971,184,144808,787,0
115608,395,72,23256,323,0
115617,1078,198,174240,880,0
115620,865,167,116566,698,0
115627,571,114,52098,457,0
115637,1342,282,298920,1060,0
115654,207,41,6806,166,0
115661,315,56,14504,259,0
115684,1262,259,259777,1003,0
115687,64,8,448,56,0
115698,1583,310,394630,1273,0
115714,282,50,11600,232,0
115720,1552,299,374647,1253,0
115735,971,184,144808,787,0
115743,77,18,1062,59,0
115748,1296,252,263088,1044,0
115760,865,167,116566,698,0
115761,274,57,12369,217,0
115797,548,102,45492,446,0
115804,821,143,96954,678,0
115812,380,76,23104,304,0
115813,932,168,128352,764,0
115825,865,167,116566,698,0
115826,443,85,30430,358,0
115834,1541,306,377910,1235,0
115847,548,102,45492,446,0
115848,155,35,4200,120,0
115854,1876,359,544603,1517,0
115856,950,193,146101,757,0
115863,144,29,3335,115,0
115869,595,120,57000,475,0
115870,26,8,144,18,0
115873,551,102,45798,449,0
115878,346,76,20520,270,0
115892,101,20,1620,81,0
115893,1342,282,298920,1060,0
115894,40,7,231,33,0
115897,571,114,52098,457,0
115901,185,36,5364,149,0
115908,2102,402,683400,1700,0
115909,1342,282,298920,1060,0
115920,282,50,11600,232,0
115930,1552,299,374647,1253,0
115940,1025,201,165624,824,0
115941,819,152,101384,667,0
115948,1552,299,374647,1253,0
115965,64,16,768,48,0
115969,821,171,111150,650,0
115972,1296,252,263088,1044,0
115999,24,6,108,18,0
116001,171,35,4760,136,0
116006,950,193,146101,757,0
116015,410,76,25384,334,0
116030,273,58,12470,215,0
116035,324,67,17219,257,0
116060,1876,359,544603,1517,0
116064,1934,345,548205,1589,0
116081,767,144,89712,623,0
116087,516,103,42539,413,0
116089,1558,313,389685,1245,0
116100,539,101,44238,438,0
116103,551,102,45798,449,0
116105,1829,353,521028,1476,0
116114,324,67,17219,257,0
116139,767,144,89712,623,0
116148,821,171,111150,650,0
116160,595,121,57354,474,0
116177,1342,282,298920,1060,0
116195,160,32,4096,128,0
116197,32,7,175,25,0
116207,551,102,45798,449,0
116246,401,77,24948,324,0
116278,821,143,96954,678,0
116283,405,82,26486,323,0
116288,156,34,4148,122,0
116295,976,180,143280,796,0
116300,1411,281,317530,1130,0
116302,46,9,333,37,0
116312,865,167,116566,698,0
116318,9,2,14,7,0
116319,714,137,79049,577,0
116336,1331,255,274380,1076,0
116343,1552,299,374647,1253,0
116344,539,101,44238,438,0
116363,410,76,25384,334,0
116389,976,180,143280,796,0
116399,950,193,146101,757,0
116405,1411,281,317530,1130,0
116408,572,130,57460,442,0
116430,346,76,20520,270,0
116444,324,67,17219,257,0
116449,1411,281,317530,1130,0
116459,315,56,14504,259,0
116478,2102,402,683400,1700,0
116481,1342,282,298920,1060,0
116489,771,137,86858,634,0
116491,1552,299,374647,1253,0
116497,72,17,935,55,0
116510,1552,299,374647,1253,0
116514,107,18,1602,89,0
116519,1583,310,394630,1273,0
116551,971,184,144808,787,0
116571,9,1,8,8,0
116578,1331,255,274380,1076,0
116584,31,10,210,21,0
116597,160,29,3799,131,0
116606,395,72,23256,323,0
116610,227,44,8052,183,0
116622,641,131,66810,510,0
116626,1262,259,259777,1003,0
116634,193,39,6006,154,0
116636,1558,313,389685,1245,0
116640,700,128,73216,572,0
116646,362,69,20217,293,0
116654,1411,281,317530,1130,0
116662,1876,359,544603,1517,0
116680,1541,306,377910,1235,0
116682,2102,402,683400,1700,0
116692,1181,246,230010,935,0
116694,865,167,116566,698,0
116708,535,94,41454,441,0
116733,131,21,2310,110,0
116745,373,74,22126,299,0
116751,71,15,840,56,0
116766,821,143,96954,678,0
116770,443,85,30430,358,0
116774,88,17,1207,71,0
116787,660,133,69928,527,0
116789,23,6,102,17,0
116804,1876,359,544603,1517,0
116840,317,63,16002,254,0
116863,1934,345,548205,1589,0
116867,1262,259,259777,1003,0
116879,932,168,128352,764,0
116881,660,133,69928,527,0
116884,1552,299,374647,1253,0
116893,2102,402,683400,1700,0
116903,620,121,60379,499,0
116904,1657,315,422730,1342,0
116915,552,113,49607,439,0
116923,1558,313,389685,1245,0
116928,767,144,89712,623,0
116933,69,14,770,55,0
116937,1541,306,377910,1235,0
116977,1829,353,521028,1476,0
116998,17,4,52,13,0
116999,971,184,144808,787,0
117014,1876,359,544603,1517,0
117027,36,10,260,26,0
117028,337,74,19462,263,0
117029,1280,232,243136,1048,0
117034,534,102,44064,432,0
117044,144,29,3335,115,0
117069,1204,251,239203,953,0
117070,1934,345,548205,1589,0
117097,1181,246,230010,935,0
117103,778,163,100245,615,0
117109,1331,255,274380,1076,0
117114,108,17,1547,91,0
117122,495,87,35496,408,0
117124,273,58,12470,215,0
117126,2102,402,683400,1700,0
117129,1558,313,389685,1245,0
117132,641,131,66810,510,0
117162,101,20,1620,81,0
117165,865,167,116566,698,0
117167,101,20,1620,81,0
117178,88,17,1207,71,0
117183,1181,246,230010,935,0
117197,539,101,44238,438,0
117202,1876,359,544603,1517,0
117207,2102,402,683400,1700,0
117219,1280,232,243136,1048,0
117226,1552,299,374647,1253,0
117234,821,171,111150,650,0
117248,539,101,44238,438,0
117290,1331,255,274380,1076,0
117292,36,10,260,26,0
117306,641,131,66810,510,0
117321,1934,345,548205,1589,0
117340,1296,252,263088,1044,0
117355,1296,252,263088,1044,0
117356,1583,310,394630,1273,0
117406,26,6,120,20,0
117422,88,17,1207,71,0
117444,1541,306,377910,1235,0
117445,194,39,6045,155,0
117449,36,10,260,26,0
117463,950,193,146101,757,0
117464,821,171,111150,650,0
117467,71,15,840,56,0
117480,415,75,25500,340,0
117482,1552,299,374647,1253,0
117486,1078,198,174240,880,0
117489,1876,359,544603,1517,0
117522,976,180,143280,796,0
117537,1558,313,389685,1245,0
117544,61,13,624,48,0
117556,155,27,3456,128,0
117583,778,163,100245,615,0
117595,366,70,20720,296,0
117616,1657,315,422730,1342,0
117635,821,143,96954,678,0
117645,1541,306,377910,1235,0
117656,405,82,26486,323,0
117663,37,11,286,26,0
117668,185,36,5364,149,0
117671,1583,310,394630,1273,0
117676,552,113,49607,439,0
117692,89,15,1110,74,0
117704,305,70,16450,235,0
117738,821,143,96954,678,0
117756,548,102,45492,446,0
117764,28,7,147,21,0
117770,405,82,26486,323,0
117785,1541,306,377910,1235,0
117835,2102,402,683400,1700,0
117849,373,74,22126,299,0
117854,1558,313,389685,1245,0
117855,1657,315,422730,1342,0
117856,821,171,111150,650,0
117864,1025,201,165624,824,0
117865,1657,315,422730,1342,0
117869,124,28,2688,96,0
117877,317,63,16002,254,0
117880,380,76,23104,304,0
117883,819,152,101384,667,0
117884,365,74,21534,291,0
117885,1829,353,521028,1476,0
117886,700,128,73216,572,0
117889,548,102,45492,446,0
117899,1411,281,317530,1130,0
117905,28,7,147,21,0
117923,548,102,45492,446,0
117955,1296,252,263088,1044,0
117962,1558,313,389685,1245,0
117981,1331,255,274380,1076,0
117987,548,102,45492,446,0
117995,778,163,100245,615,0
118026,1296,252,263088,1044,0
118039,44,10,340,34,0
118075,865,167,116566,698,0
118092,24,4,80,20,0
118112,1262,259,259777,1003,0
118113,1296,252,263088,1044,0
118135,122,22,2200,100,0
118148,1829,353,521028,1476,0
118157,1262,259,259777,1003,0
118161,551,102,45798,449,0
118162,110,18,1656,92,0
118179,767,144,89712,623,0
118182,1181,246,230010,935,0
118197,1204,251,239203,953,0
118200,595,121,57354,474,0
118218,819,152,101384,667,0
118221,1078,198,174240,880,0
118233,1204,251,239203,953,0
118252,821,143,96954,678,0
118263,1829,353,521028,1476,0
118293,317,63,16002,254,0
118324,497,97,38800,400,0
118344,110,18,1656,92,0
118349,1829,353,521028,1476,0
118363,1583,310,394630,1273,0
118372,1331,255,274380,1076,0
118374,1025,201,165624,824,0
118395,1876,359,544603,1517,0
118401,1280,232,243136,1048,0
118408,821,171,111150,650,0
118414,659,132,69928,527,0
118429,410,76,25384,334,0
118439,110,18,1656,92,0
118452,950,193,146101,757,0
118463,539,101,44238,438,0
118465,200,40,6400,160,0
118466,1262,259,259777,1003,0
118470,1411,281,317530,1130,0
118481,971,184,144808,787,0
118491,1411,281,317530,1130,0
118524,778,163,100245,615,0
118535,1657,315,422730,1342,0
118547,976,180,143280,796,0
118559,497,97,38800,400,0
118569,620,121,60379,499,0
118576,1204,251,239203,953,0
118578,1876,359,544603,1517,0
118585,315,56,14504,259,0
118589,1541,306,377910,1235,0
118610,9,1,8,8,0
118619,56,13,559,43,0
118626,1331,255,274380,1076,0
118628,793,158,100330,635,0
118630,568,114,51756,454,0
118653,1331,255,274380,1076,0
118665,767,144,89712,623,0
118670,976,180,143280,796,0
118695,1829,353,521028,1476,0
118701,714,137,79049,577,0
118713,932,168,128352,764,0
118719,5,1,4,4,0
118732,950,193,146101,757,0
118744,1583,310,394630,1273,0
118750,105,15,1350,90,0
118761,1204,251,239203,953,0
118768,1181,246,230010,935,0
118806,1280,232,243136,1048,0
118809,120,24,2304,96,0
118814,405,82,26486,323,0
118823,186,35,5285,151,0
118825,1876,359,544603,1517,0
118826,1204,251,239203,953,0
118829,771,137,86858,634,0
118844,1657,315,422730,1342,0
118883,1558,313,389685,1245,0
118892,534,102,44064,432,0
118902,43,7,252,36,0
118906,595,120,57000,475,0
118910,373,74,22126,299,0
118911,1181,246,230010,935,0
118924,1204,251,239203,953,0
118961,950,193,146101,757,0
118964,47,11,396,36,0
118966,1541,306,377910,1235,0
118970,1934,345,548205,1589,0
118971,950,193,146101,757,0
118986,539,101,44238,438,0
118987,274,57,12369,217,0
118989,102,20,1640,82,0
119010,415,75,25500,340,0
119020,516,103,42539,413,0
119032,1876,359,544603,1517,0
119038,2102,402,683400,1700,0
119047,119,25,2350,94,0
119052,539,101,44238,438,0
119069,1541,306,377910,1235,0
119077,595,120,57000,475,0
119078,443,85,30430,358,0
119082,185,36,5364,149,0
119096,274,57,12369,217,0
119111,2102,402,683400,1700,0
119115,1078,198,174240,880,0
119120,72,17,935,55,0
119123,950,193,146101,757,0
119141,61,11,550,50,0
119146,568,114,51756,454,0
119153,1411,281,317530,1130,0
119157,595,120,57000,475,0
119159,1934,345,548205,1589,0
119162,1558,313,389685,1245,0
119168,1583,310,394630,1273,0
119194,539,101,44238,438,0
119196,778,163,100245,615,0
119202,1342,282,298920,1060,0
119212,836,151,103435,685,0
119213,1552,299,374647,1253,0
119218,641,131,66810,510,0
119220,273,58,12470,215,0
119233,659,132,69928,527,0
119235,1583,310,394630,1273,0
119237,160,32,4096,128,0
119268,68,15,795,53,0
119272,976,180,143280,796,0
119282,1876,359,544603,1517,0
119306,1204,251,239203,953,0
119310,976,180,143280,796,0
119311,1296,252,263088,1044,0
119313,551,102,45798,449,0
119315,61,11,550,50,0
119327,1331,255,274380,1076,0
119332,1541,306,377910,1235,0
119346,767,144,89712,623,0
119368,595,120,57000,475,0
119374,1280,232,243136,1048,0
119377,102,20,1640,82,0
119379,1541,306,377910,1235,0
119426,217,44,7612,173,0
119430,264,56,11648,208,0
119446,71,15,840,56,0
119458,950,193,146101,757,0
119463,64,15,735,49,0
119472,1583,310,394630,1273,0
119484,1829,353,521028,1476,0
119486,548,102,45492,446,0
119489,539,101,44238,438,0
119508,366,70,20720,296,0
119509,2102,402,683400,1700,0
119512,1583,310,394630,1273,0
119519,1280,232,243136,1048,0
119523,52,10,420,42,0
119532,385,71,22294,314,0
119538,836,151,103435,685,0
119553,568,114,51756,454,0
119557,121,27,2538,94,0
119563,641,131,66810,510,0
119565,443,85,30430,358,0
119592,1934,345,548205,1589,0
119597,767,144,89712,623,0
119598,1296,252,263088,1044,0
119621,1552,299,374647,1253,0
119623,950,193,146101,757,0
119630,58,11,517,47,0
119655,155,35,4200,120,0
119657,13,2,22,11,0
119662,1280,232,243136,1048,0
119665,1204,251,239203,953,0
119685,1552,299,374647,1253,0
119686,1541,306,377910,1235,0
119695,1411,281,317530,1130,0
119696,77,19,1102,58,0
119711,971,184,144808,787,0
119717,714,137,79049,577,0
119743,110,27,2241,83,0
119755,1342,282,298920,1060,0
119759,1583,310,394630,1273,0
119761,337,74,19462,263,0
119771,950,193,146101,757,0
119793,174,36,4968,138,0
119801,1657,315,422730,1342,0
119811,1541,306,377910,1235,0
119812,405,82,26486,323,0
119871,2102,402,683400,1700,0
119872,1181,246,230010,935,0
119895,1280,232,243136,1048,0
119900,1411,281,317530,1130,0
119903,793,158,100330,635,0
119922,1657,315,422730,1342,0
119934,112,18,1692,94,0
119949,1331,255,274380,1076,0
119957,568,114,51756,454,0
119988,1552,299,374647,1253,0
119996,89,15,1110,74,0
120026,1583,310,394630,1273,0
120044,44,10,340,34,0
120077,620,121,60379,499,0
120090,107,18,1602,89,0
120098,463,83,31540,380,0
120099,1296,252,263088,1044,0
120102,836,151,103435,685,0
120108,1552,299,374647,1253,0
120120,1657,315,422730,1342,0
120147,932,168,128352,764,0
120157,660,133,69928,527,0
120185,495,87,35496,408,0
120196,1657,315,422730,1342,0
120197,155,34,4114,121,0
120199,68,15,795,53,0
120210,1876,359,544603,1517,0
120229,1541,306,377910,1235,0
120234,836,151,103435,685,0
120245,366,70,20720,296,0
120250,1876,359,544603,1517,0
120251,200,40,6400,160,0
120261,282,50,11600,232,0
120265,571,114,52098,457,0
120270,571,114,52098,457,0
120271,1025,201,165624,824,0
120316,1204,251,239203,953,0
120317,821,143,96954,678,0
120335,821,171,111150,650,0
120338,119,25,2350,94,0
120356,1025,201,165624,824,0
120408,1078,198,174240,880,0
120416,77,19,1102,58,0
120421,305,70,16450,235,0
120432,52,10,420,42,0
120444,107,18,1602,89,0
120457,324,67,17219,257,0
120478,1934,345,548205,1589,0
120486,1541,306,377910,1235,0
120490,380,76,23104,304,0
120536,1204,251,239203,953,0
120555,516,103,42539,413,0
120575,1552,299,374647,1253,0
120579,1583,310,394630,1273,0
120591,198,43,6665,155,0
120598,767,144,89712,623,0
120624,1331,255,274380,1076,0
120637,1657,315,422730,1342,0
120649,1342,282,298920,1060,0
120665,1934,345,548205,1589,0
120668,1541,306,377910,1235,0
120671,85,18,1206,67,0
120682,34,7,189,27,0
120695,360,66,19404,294,0
120708,69,14,770,55,0
120713,200,40,6400,160,0
120721,976,180,143280,796,0
120732,1541,306,377910,1235,0
120749,175,29,4234,146,0
120761,2102,402,683400,1700,0
120765,155,34,4114,121,0
120773,337,74,19462,263,0
120791,21,6,90,15,0
120798,323,55,14740,268,0
120846,2102,402,683400,1700,0
120847,1342,282,298920,1060,0
120860,971,184,144808,787,0
120862,379,65,20410,314,0
120866,55,11,484,44,0
120872,535,94,41454,441,0
120901,274,57,12369,217,0
120907,366,70,20720,296,0
120910,641,131,66810,510,0
120921,77,18,1062,59,0
120923,443,85,30430,358,0
120924,865,167,116566,698,0
120927,1934,345,548205,1589,0
120951,771,137,86858,634,0
120957,1331,255,274380,1076,0
120958,932,168,128352,764,0
120965,410,76,25384,334,0
120972,61,14,658,47,0
120997,337,74,19462,263,0
121022,1558,313,389685,1245,0
121026,641,131,66810,510,0
121030,164,34,4420,130,0
121039,1657,315,422730,1342,0
121044,1296,252,263088,1044,0
121053,273,58,12470,215,0
121054,1541,306,377910,1235,0
121069,700,128,73216,572,0
121080,548,102,45492,446,0
121089,97,22,1650,75,0
121095,175,29,4234,146,0
121105,641,131,66810,510,0
121118,1025,201,165624,824,0
121134,836,151,103435,685,0
121138,778,163,100245,615,0
121148,1181,246,230010,935,0
121159,767,144,89712,623,0
121175,1583,310,394630,1273,0
121179,1078,198,174240,880,0
121193,155,35,4200,120,0
121199,1204,251,239203,953,0
121201,700,128,73216,572,0
121210,1262,259,259777,1003,0
121228,572,130,57460,442,0
121246,33,8,200,25,0
121248,1411,281,317530,1130,0
121250,274,57,12369,217,0
121259,771,137,86858,634,0
121269,1331,255,274380,1076,0
121280,26,6,120,20,0
121289,1296,252,263088,1044,0
121299,1657,315,422730,1342,0
121331,571,114,52098,457,0
121335,534,102,44064,432,0
121336,47,11,396,36,0
121355,324,67,17219,257,0
121357,217,44,7612,173,0
121362,660,133,69928,527,0
121369,69,14,770,55,0
121375,113,24,2136,89,0
121379,401,77,24948,324,0
121388,1657,315,422730,1342,0
121397,535,94,41454,441,0
121407,793,158,100330,635,0
121412,360,66,19404,294,0
121413,932,168,128352,764,0
121415,113,24,2136,89,0
121416,1541,306,377910,1235,0
121446,1331,255,274380,1076,0
121447,771,137,86858,634,0
121448,321,54,14418,267,0
121461,415,75,25500,340,0
121473,1342,282,298920,1060,0
121517,112,18,1692,94,0
121522,75,19,1064,56,0
121523,595,120,57000,475,0
121538,346,76,20520,270,0
121569,1204,251,239203,953,0
121593,1541,306,377910,1235,0
121599,1342,282,298920,1060,0
121631,819,152,101384,667,0
121634,379,65,20410,314,0
121641,535,94,41454,441,0
121645,68,15,795,53,0
121651,535,94,41454,441,0
121660,1342,282,298920,1060,0
121669,767,144,89712,623,0
121671,160,29,3799,131,0
121673,1541,306,377910,1235,0
121676,1934,345,548205,1589,0
121677,767,144,89712,623,0
121684,950,193,146101,757,0
121721,227,44,8052,183,0
121757,1025,201,165624,824,0
121772,1552,299,374647,1253,0
121786,767,144,89712,623,0
121795,497,97,38800,400,0
121803,1181,246,230010,935,0
121808,971,184,144808,787,0
121814,236,50,9300,186,0
121821,1583,310,394630,1273,0
121827,1552,299,374647,1253,0
121828,1552,299,374647,1253,0
121829,1296,252,263088,1044,0
121834,155,27,3456,128,0
121838,767,144,89712,623,0
121843,171,35,4760,136,0
121853,106,19,1653,87,0
121868,572,130,57460,442,0
121877,20,4,64,16,0
121905,821,143,96954,678,0
121907,976,180,143280,796,0
121911,497,97,38800,400,0
121913,1342,282,298920,1060,0
121925,131,25,2650,106,0
121950,950,193,146101,757,0
121955,595,121,57354,474,0
121968,71,15,840,56,0
121986,595,121,57354,474,0
121987,1583,310,394630,1273,0
121998,26,5,105,21,0
122007,77,17,1020,60,0
122024,971,184,144808,787,0
122041,395,72,23256,323,0
122051,405,82,26486,323,0
122073,1934,345,548205,1589,0
122074,497,97,38800,400,0
122080,75,19,1064,56,0
122087,819,152,101384,667,0
122156,1657,315,422730,1342,0
122158,1342,282,298920,1060,0
122166,443,85,30430,358,0
122182,1583,310,394630,1273,0
122192,1078,198,174240,880,0
122193,1829,353,521028,1476,0
122205,821,143,96954,678,0
122222,31,8,184,23,0
122238,415,75,25500,340,0
122267,385,71,22294,314,0
122268,107,18,1602,89,0
122274,174,36,4968,138,0
122278,360,66,19404,294,0
122283,778,163,100245,615,0
122284,148,24,2976,124,0
122291,119,22,2134,97,0
122307,1657,315,422730,1342,0
122319,819,152,101384,667,0
122354,595,121,57354,474,0
122369,1262,259,259777,1003,0
122370,1934,345,548205,1589,0
122372,571,114,52098,457,0
122425,516,103,42539,413,0
122446,1558,313,389685,1245,0
122453,13,3,30,10,0
122467,1876,359,544603,1517,0
122471,156,34,4148,122,0
122474,1876,359,544603,1517,0
122478,264,56,11648,208,0
122483,1342,282,298920,1060,0
122485,24,4,80,20,0
122489,771,137,86858,634,0
122523,950,193,146101,757,0
122532,321,54,14418,267,0
122537,463,83,31540,380,0
122539,1342,282,298920,1060,0
122544,102,20,1640,82,0
122548,365,74,21534,291,0
122551,821,143,96954,678,0
122560,1204,251,239203,953,0
122561,976,180,143280,796,0
122591,1411,281,317530,1130,0
122593,443,85,30430,358,0
122594,186,35,5285,151,0
122599,1181,246,230010,935,0
122601,819,152,101384,667,0
122605,193,39,6006,154,0
122619,1181,246,230010,935,0
122656,1411,281,317530,1130,0
122675,1657,315,422730,1342,0
122677,821,143,96954,678,0
122687,1342,282,298920,1060,0
122695,641,131,66810,510,0
122698,1331,255,274380,1076,0
122699,1829,353,521028,1476,0
122703,1552,299,374647,1253,0
122707,2102,402,683400,1700,0
122712,1829,353,521028,1476,0
122735,620,121,60379,499,0
122742,641,131,66810,510,0
122758,571,114,52098,457,0
122759,821,171,111150,650,0
122763,1296,252,263088,1044,0
122766,1552,299,374647,1253,0
122783,401,77,24948,324,0
122816,35,8,216,27,0
122866,595,121,57354,474,0
122893,373,74,22126,299,0
122908,1342,282,298920,1060,0
122914,865,167,116566,698,0
122943,1876,359,544603,1517,0
122952,572,130,57460,442,0
122964,1331,255,274380,1076,0
122983,2102,402,683400,1700,0
123019,185,36,5364,149,0
123022,282,50,11600,232,0
123032,1078,198,174240,880,0
123036,620,121,60379,499,0
123066,535,94,41454,441,0
123068,700,128,73216,572,0
123080,1262,259,259777,1003,0
123081,714,137,79049,577,0
123087,1934,345,548205,1589,0
123095,379,65,20410,314,0
123100,2102,402,683400,1700,0
123111,104,16,1408,88,0
123122,1181,246,230010,935,0
123133,217,44,7612,173,0
123147,360,66,19404,294,0
123150,31,9,198,22,0
123158,121,27,2538,94,0
123160,535,94,41454,441,0
123194,1411,281,317530,1130,0
123201,2102,402,683400,1700,0
123207,463,83,31540,380,0
123217,360,66,19404,294,0
123219,1025,201,165624,824,0
123224,58,12,552,46,0
123229,700,128,73216,572,0
123232,552,113,49607,439,0
123236,2102,402,683400,1700,0
123242,317,63,16002,254,0
123249,227,44,8052,183,0
123265,1262,259,259777,1003,0
123267,15,6,54,9,0
123269,700,128,73216,572,0
123273,495,87,35496,408,0
123284,20,5,75,15,0
123291,1280,232,243136,1048,0
123307,976,180,143280,796,0
123311,1876,359,544603,1517,0
123336,155,34,4114,121,0
123347,767,144,89712,623,0
123377,119,22,2134,97,0
123378,1025,201,165624,824,0
123390,714,137,79049,577,0
123435,659,132,69928,527,0
123456,362,69,20217,293,0
123483,1331,255,274380,1076,0
123485,110,27,2241,83,0
123504,1078,198,174240,880,0
123512,1876,359,544603,1517,0
123516,1078,198,174240,880,0
123525,185,36,5364,149,0
123528,1296,252,263088,1044,0
123529,1583,310,394630,1273,0
123539,1552,299,374647,1253,0
123541,1829,353,521028,1476,0
123546,77,19,1102,58,0
123552,1552,299,374647,1253,0
123574,551,102,45798,449,0
123576,61,13,624,48,0
123578,821,171,111150,650,0
123591,548,102,45492,446,0
123596,1583,310,394630,1273,0
123619,771,137,86858,634,0
123638,1558,313,389685,1245,0
123640,572,130,57460,442,0
123702,119,22,2134,97,0
123704,1657,315,422730,1342,0
123710,102,20,1640,82,0
123725,534,102,44064,432,0
123737,516,103,42539,413,0
123747,932,168,128352,764,0
123755,443,85,30430,358,0
123761,2102,402,683400,1700,0
123774,443,85,30430,358,0
123775,1657,315,422730,1342,0
123790,778,163,100245,615,0
123795,119,25,2350,94,0
123809,1934,345,548205,1589,0
123844,1181,246,230010,935,0
123849,1280,232,243136,1048,0
123850,819,152,101384,667,0
123851,305,70,16450,235,0
123871,50,8,336,42,0
123882,497,97,38800,400,0
123893,236,50,9300,186,0
123905,365,74,21534,291,0
123911,534,102,44064,432,0
123927,415,75,25500,340,0
123951,26,8,144,18,0
123959,1280,232,243136,1048,0
123972,156,34,4148,122,0
123977,535,94,41454,441,0
123989,778,163,100245,615,0
124001,164,34,4420,130,0
124013,572,130,57460,442,0
124018,767,144,89712,623,0
124043,976,180,143280,796,0
124045,700,128,73216,572,0
124053,950,193,146101,757,0
124059,620,121,60379,499,0
124065,1934,345,548205,1589,0
124068,227,44,8052,183,0
124077,971,184,144808,787,0
124084,31,8,184,23,0
124089,821,143,96954,678,0
124093,337,74,19462,263,0
124099,105,15,1350,90,0
124102,410,76,25384,334,0
124162,700,128,73216,572,0
124168,193,39,6006,154,0
124170,69,12,684,57,0
124193,1541,306,377910,1235,0
124218,264,56,11648,208,0
124222,88,17,1207,71,0
124231,1280,232,243136,1048,0
124247,836,151,103435,685,0
124253,35,9,234,26,0
124255,1541,306,377910,1235,0
124257,323,55,14740,268,0
124261,976,180,143280,796,0
124288,385,71,22294,314,0
124302,1657,315,422730,1342,0
124306,1552,299,374647,1253,0
124314,932,168,128352,764,0
124317,595,120,57000,475,0
124330,58,12,552,46,0
124332,1025,201,165624,824,0
124337,836,151,103435,685,0
124345,2102,402,683400,1700,0
124352,1204,251,239203,953,0
124364,534,102,44064,432,0
124372,932,168,128352,764,0
124398,1657,315,422730,1342,0
124400,1262,259,259777,1003,0
124402,101,20,1620,81,0
124405,932,168,128352,764,0
124406,1583,310,394630,1273,0
124446,1876,359,544603,1517,0
124448,539,101,44238,438,0
124451,1181,246,230010,935,0
124455,976,180,143280,796,0
124457,1262,259,259777,1003,0
124466,1876,359,544603,1517,0
124467,362,69,20217,293,0
124470,227,44,8052,183,0
124476,200,40,6400,160,0
124501,539,101,44238,438,0
124509,595,120,57000,475,0
124517,1829,353,521028,1476,0
124530,534,102,44064,432,0
124539,44,10,340,34,0
124566,821,143,96954,678,0
124579,185,36,5364,149,0
124597,1342,282,298920,1060,0
124619,1411,281,317530,1130,0
124656,1411,281,317530,1130,0
124722,171,35,4760,136,0
124727,5,1,4,4,0
124733,410,76,25384,334,0
124734,315,56,14504,259,0
124737,535,94,41454,441,0
124743,971,184,144808,787,0
124746,819,152,101384,667,0
124752,207,41,6806,166,0
124768,714,137,79049,577,0
124773,8,3,15,5,0
124778,1583,310,394630,1273,0
124781,821,171,111150,650,0
124793,146,34,3808,112,0
124795,113,20,1860,93,0
124796,2102,402,683400,1700,0
124800,552,113,49607,439,0
124812,282,50,11600,232,0
124814,1331,255,274380,1076,0
124815,1829,353,521028,1476,0
124843,552,113,49607,439,0
124853,1078,198,174240,880,0
124897,144,29,3335,115,0
124904,1541,306,377910,1235,0
124921,410,76,25384,334,0
124922,1583,310,394630,1273,0
124924,25,2,46,23,0
124928,539,101,44238,438,0
124932,60,12,576,48,0
124934,227,44,8052,183,0
124946,120,24,2304,96,0
124950,932,168,128352,764,0
124951,20,5,75,15,0
124964,401,77,24948,324,0
124981,950,193,146101,757,0
124983,155,35,4200,120,0
124998,495,87,35496,408,0
125001,69,12,684,57,0
125003,1657,315,422730,1342,0
125004,771,137,86858,634,0
125014,641,131,66810,510,0
125015,1657,315,422730,1342,0
125020,1331,255,274380,1076,0
125027,1204,251,239203,953,0
125036,1025,201,165624,824,0
125075,552,113,49607,439,0
125083,89,15,1110,74,0
125114,552,113,49607,439,0
125118,1657,315,422730,1342,0
125127,1204,251,239203,953,0
125148,1411,281,317530,1130,0
125155,1552,299,374647,1253,0
125159,1583,310,394630,1273,0
125164,324,67,17219,257,0
125208,1280,232,243136,1048,0
125223,217,44,7612,173,0
125224,2102,402,683400,1700,0
125231,337,74,19462,263,0
125244,865,167,116566,698,0
125246,1876,359,544603,1517,0
125254,1934,345,548205,1589,0
125266,771,137,86858,634,0
125269,1262,259,259777,1003,0
125287,346,76,20520,270,0
125291,700,128,73216,572,0
125292,395,72,23256,323,0
125300,274,57,12369,217,0
125301,1558,313,389685,1245,0
125308,976,180,143280,796,0
125310,1657,315,422730,1342,0
125326,865,167,116566,698,0
125350,171,35,4760,136,0
125356,198,43,6665,155,0
125369,1829,353,521028,1476,0
125379,821,171,111150,650,0
125383,1331,255,274380,1076,0
125388,365,74,21534,291,0
125392,1934,345,548205,1589,0
125395,1331,255,274380,1076,0
125396,535,94,41454,441,0
125400,1331,255,274380,1076,0
125412,516,103,42539,413,0
125437,1558,313,389685,1245,0
125439,700,128,73216,572,0
125447,660,133,69928,527,0
125452,24,6,108,18,0
125457,1934,345,548205,1589,0
125469,497,97,38800,400,0
125471,124,28,2688,96,0
125495,971,184,144808,787,0
125504,1829,353,521028,1476,0
125506,1204,251,239203,953,0
125512,551,102,45798,449,0
125539,572,130,57460,442,0
125563,821,143,96954,678,0
125613,620,121,60379,499,0
125639,1583,310,394630,1273,0
125643,568,114,51756,454,0
125647,1411,281,317530,1130,0
125654,865,167,116566,698,0
125663,1331,255,274380,1076,0
125682,415,75,25500,340,0
125691,380,76,23104,304,0
125694,819,152,101384,667,0
125743,131,25,2650,106,0
125765,1331,255,274380,1076,0
125769,1411,281,317530,1130,0
125770,185,36,5364,149,0
125772,1078,198,174240,880,0
125795,1558,313,389685,1245,0
125810,1331,255,274380,1076,0
125821,2102,402,683400,1700,0
125827,1829,353,521028,1476,0
125843,366,70,20720,296,0
125856,1583,310,394630,1273,0
125862,2102,402,683400,1700,0
125865,971,184,144808,787,0
125867,865,167,116566,698,0
125885,1829,353,521028,1476,0
125891,21,4,68,17,0
125897,61,7,378,54,0
125917,971,184,144808,787,0
125918,405,82,26486,323,0
125931,37,11,286,26,0
125932,1296,252,263088,1044,0
125933,1342,282,298920,1060,0
125937,2102,402,683400,1700,0
125950,366,70,20720,296,0
125957,2102,402,683400,1700,0
125970,35,8,216,27,0
125974,1342,282,298920,1060,0
125983,68,12,672,56,0
125984,539,101,44238,438,0
125985,227,44,8052,183,0
125989,1934,345,548205,1589,0
126008,1541,306,377910,1235,0
126011,1078,198,174240,880,0
126012,1280,232,243136,1048,0
126048,1829,353,521028,1476,0
126074,44,10,340,34,0
126089,1583,310,394630,1273,0
126099,1280,232,243136,1048,0
126117,1342,282,298920,1060,0
126128,1078,198,174240,880,0
126138,1657,315,422730,1342,0
126146,144,29,3335,115,0
126151,58,12,552,46,0
126173,1829,353,521028,1476,0
126180,1657,315,422730,1342,0
126192,135,30,3150,105,0
126197,950,193,146101,757,0
126214,495,87,35496,408,0
126226,1262,259,259777,1003,0
126227,700,128,73216,572,0
126229,1204,251,239203,953,0
126285,1876,359,544603,1517,0
126298,55,11,484,44,0
126300,1204,251,239203,953,0
126313,497,97,38800,400,0
126323,641,131,66810,510,0
126336,1204,251,239203,953,0
126340,1541,306,377910,1235,0
126373,2102,402,683400,1700,0
126412,274,57,12369,217,0
126417,463,83,31540,380,0
126437,821,143,96954,678,0
126445,113,20,1860,93,0
126454,405,82,26486,323,0
126475,1583,310,394630,1273,0
126479,1934,345,548205,1589,0
126481,443,85,30430,358,0
126486,54,14,560,40,0
126498,1342,282,298920,1060,0
126500,551,102,45798,449,0
126508,463,83,31540,380,0
126515,97,22,1650,75,0
126547,595,120,57000,475,0
126549,1411,281,317530,1130,0
126558,1541,306,377910,1235,0
126579,274,57,12369,217,0
126590,1181,246,230010,935,0
126594,1541,306,377910,1235,0
126613,1558,313,389685,1245,0
126621,61,13,624,48,0
126628,2102,402,683400,1700,0
126632,110,27,2241,83,0
126649,2102,402,683400,1700,0
126654,1552,299,374647,1253,0
126656,1342,282,298920,1060,0
126662,366,70,20720,296,0
126670,971,184,144808,787,0
126675,1876,359,544603,1517,0
126677,1342,282,298920,1060,0
126684,305,70,16450,235,0
126689,1558,313,389685,1245,0
126698,534,102,44064,432,0
126738,836,151,103435,685,0
126752,700,128,73216,572,0
126760,337,74,19462,263,0
126767,950,193,146101,757,0
126784,932,168,128352,764,0
126801,568,114,51756,454,0
126802,155,34,4114,121,0
126808,1558,313,389685,1245,0
126814,1078,198,174240,880,0
126819,1934,345,548205,1589,0
126820,1876,359,544603,1517,0
126850,107,18,1602,89,0
126882,1204,251,239203,953,0
126910,539,101,44238,438,0
126915,1829,353,521028,1476,0
126916,1552,299,374647,1253,0
126939,595,120,57000,475,0
126941,932,168,128352,764,0
126959,366,70,20720,296,0
126960,1296,252,263088,1044,0
126964,146,34,3808,112,0
126966,124,28,2688,96,0
126969,317,63,16002,254,0
126971,85,18,1206,67,0
126974,2102,402,683400,1700,0
126996,767,144,89712,623,0
127010,976,180,143280,796,0
127012,1262,259,259777,1003,0
127013,405,82,26486,323,0
127028,155,27,3456,128,0
127030,35,9,234,26,0
127035,971,184,144808,787,0
127046,771,137,86858,634,0
127061,1342,282,298920,1060,0
127075,22,6,96,16,0
127096,1280,232,243136,1048,0
127111,1829,353,521028,1476,0
127112,379,65,20410,314,0
127118,1558,313,389685,1245,0
127129,1829,353,521028,1476,0
127139,1025,201,165624,824,0
127142,1829,353,521028,1476,0
127148,373,74,22126,299,0
127150,1829,353,521028,1476,0
127172,395,72,23256,323,0
127178,274,57,12369,217,0
127184,1181,246,230010,935,0
127187,362,69,20217,293,0
127231,976,180,143280,796,0
127233,207,41,6806,166,0
127243,950,193,146101,757,0
127253,24,4,80,20,0
127265,932,168,128352,764,0
127285,160,32,4096,128,0
127304,337,74,19462,263,0
127308,155,35,4200,120,0
127328,252,45,9315,207,0
127341,1204,251,239203,953,0
127343,200,40,6400,160,0
127358,1078,198,174240,880,0
127364,415,75,25500,340,0
127379,971,184,144808,787,0
127385,1876,359,544603,1517,0
127399,571,114,52098,457,0
127406,1025,201,165624,824,0
127410,366,70,20720,296,0
127413,185,36,5364,149,0
127418,443,85,30430,358,0
127419,106,19,1653,87,0
127422,463,83,31540,380,0
127443,1829,353,521028,1476,0
127444,950,193,146101,757,0
127462,1558,313,389685,1245,0
127468,971,184,144808,787,0
127486,1934,345,548205,1589,0
127491,61,8,424,53,0
127509,443,85,30430,358,0
127537,1411,281,317530,1130,0
127549,1552,299,374647,1253,0
127577,373,74,22126,299,0
127579,1558,313,389685,1245,0
127586,61,11,550,50,0
127591,1657,315,422730,1342,0
127604,1876,359,544603,1517,0
127615,2102,402,683400,1700,0
127639,1280,232,243136,1048,0
127640,1411,281,317530,1130,0
127643,89,15,1110,74,0
127652,1181,246,230010,935,0
127654,164,34,4420,130,0
127658,551,102,45798,449,0
127667,52,10,420,42,0
127672,1262,259,259777,1003,0
127674,819,152,101384,667,0
127675,1657,315,422730,1342,0
127708,2102,402,683400,1700,0
127709,264,56,11648,208,0
127756,1025,201,165624,824,0
127759,821,171,111150,650,0
127769,198,43,6665,155,0
127772,767,144,89712,623,0
127811,932,168,128352,764,0
127830,122,25,2425,97,0
127839,2102,402,683400,1700,0
127843,227,44,8052,183,0
127851,105,22,1826,83,0
127853,1829,353,521028,1476,0
127865,366,70,20720,296,0
127866,819,152,101384,667,0
127892,932,168,128352,764,0
127904,552,113,49607,439,0
127912,836,151,103435,685,0
127919,1411,281,317530,1130,0
127956,62,16,736,46,0
127974,771,137,86858,634,0
127987,971,184,144808,787,0
128004,1876,359,544603,1517,0
128005,2102,402,683400,1700,0
128012,32,5,135,27,0
128051,1934,345,548205,1589,0
128052,324,67,17219,257,0
128055,976,180,143280,796,0
128076,1876,359,544603,1517,0
128079,1657,315,422730,1342,0
128087,836,151,103435,685,0
128092,1876,359,544603,1517,0
128095,1934,345,548205,1589,0
128102,1552,299,374647,1253,0
128127,346,76,20520,270,0
128133,16,4,48,12,0
128134,405,82,26486,323,0
128161,1411,281,317530,1130,0
128169,317,63,16002,254,0
128171,1558,313,389685,1245,0
128174,1204,251,239203,953,0
128178,595,121,57354,474,0
128181,932,168,128352,764,0
128188,1262,259,259777,1003,0
128205,932,168,128352,764,0
128213,1829,353,521028,1476,0
128246,793,158,100330,635,0
128247,1411,281,317530,1130,0
128260,1296,252,263088,1044,0
128265,1876,359,544603,1517,0
128278,1331,255,274380,1076,0
128292,1331,255,274380,1076,0
128298,1583,310,394630,1273,0
128309,1876,359,544603,1517,0
128338,932,168,128352,764,0
128339,217,44,7612,173,0
128344,1078,198,174240,880,0
128364,2102,402,683400,1700,0
128377,146,34,3808,112,0
128383,18,3,45,15,0
128384,443,85,30430,358,0
128386,385,71,22294,314,0
128391,21,6,90,15,0
128401,1025,201,165624,824,0
128404,1934,345,548205,1589,0
128418,1657,315,422730,1342,0
128423,1552,299,374647,1253,0
128448,1552,299,374647,1253,0
128455,571,114,52098,457,0
128467,52,11,451,41,0
128471,70,15,825,55,0
128480,1280,232,243136,1048,0
128491,1829,353,521028,1476,0
128497,61,7,378,54,0
128531,1829,353,521028,1476,0
128554,534,102,44064,432,0
128560,56,13,559,43,0
128576,572,130,57460,442,0
128577,1558,313,389685,1245,0
128601,2102,402,683400,1700,0
128617,127,29,2842,98,0
128624,22,6,96,16,0
128626,595,121,57354,474,0
128684,379,65,20410,314,0
128701,2102,402,683400,1700,0
128722,71,15,840,56,0
128727,52,10,420,42,0
128736,534,102,44064,432,0
128741,1876,359,544603,1517,0
128750,932,168,128352,764,0
128752,1876,359,544603,1517,0
128755,148,24,2976,124,0
128768,57,7,350,50,0
128776,1541,306,377910,1235,0
128796,122,22,2200,100,0
128803,1583,310,394630,1273,0
128838,778,163,100245,615,0
128847,1411,281,317530,1130,0
128856,1558,313,389685,1245,0
128872,595,120,57000,475,0
128875,1331,255,274380,1076,0
128880,821,171,111150,650,0
128882,1558,313,389685,1245,0
128886,641,131,66810,510,0
128887,186,35,5285,151,0
128896,641,131,66810,510,0
128897,1296,252,263088,1044,0
128901,1934,345,548205,1589,0
128917,1025,201,165624,824,0
128930,1181,246,230010,935,0
128943,22,6,96,16,0
128954,1558,313,389685,1245,0
128960,1552,299,374647,1253,0
128962,323,55,14740,268,0
128978,156,34,4148,122,0
128985,1181,246,230010,935,0
129022,207,41,6806,166,0
129036,1411,281,317530,1130,0
129046,55,10,450,45,0
129069,415,75,25500,340,0
129073,72,17,935,55,0
129074,821,143,96954,678,0
129080,1876,359,544603,1517,0
129088,1657,315,422730,1342,0
129111,1280,232,243136,1048,0
129118,1296,252,263088,1044,0
129122,1583,310,394630,1273,0
129125,273,58,12470,215,0
129163,144,29,3335,115,0
129170,1829,353,521028,1476,0
129175,714,137,79049,577,0
129176,379,65,20410,314,0
129186,950,193,146101,757,0
129191,497,97,38800,400,0
129197,1204,251,239203,953,0
129201,836,151,103435,685,0
129202,552,113,49607,439,0
129204,1078,198,174240,880,0
129230,274,57,12369,217,0
129243,571,114,52098,457,0
129273,1876,359,544603,1517,0
129276,1829,353,521028,1476,0
129277,124,28,2688,96,0
129290,1552,299,374647,1253,0
129293,1558,313,389685,1245,0
129323,836,151,103435,685,0
129339,497,97,38800,400,0
129341,75,19,1064,56,0
129346,1280,232,243136,1048,0
129347,362,69,20217,293,0
129369,193,39,6006,154,0
129395,61,13,624,48,0
129397,571,114,52098,457,0
129399,865,167,116566,698,0
129409,1204,251,239203,953,0
129412,1280,232,243136,1048,0
129443,324,67,17219,257,0
129452,1558,313,389685,1245,0
129455,65,17,816,48,0
129456,865,167,116566,698,0
129460,819,152,101384,667,0
129462,366,70,20720,296,0
129478,821,143,96954,678,0
129486,110,18,1656,92,0
129487,1204,251,239203,953,0
129516,186,35,5285,151,0
129517,31,9,198,22,0
129538,1262,259,259777,1003,0
129542,1583,310,394630,1273,0
129555,1262,259,259777,1003,0
129560,2102,402,683400,1700,0
129572,1657,315,422730,1342,0
129602,1342,282,298920,1060,0
129604,2102,402,683400,1700,0
129609,1204,251,239203,953,0
129610,1204,251,239203,953,0
129613,1078,198,174240,880,0
129631,366,70,20720,296,0
129651,1078,198,174240,880,0
129652,1280,232,243136,1048,0
129658,1342,282,298920,1060,0
129666,595,120,57000,475,0
129689,415,75,25500,340,0
129723,1583,310,394630,1273,0
129744,1541,306,377910,1235,0
129754,365,74,21534,291,0
129755,1876,359,544603,1517,0
129765,1558,313,389685,1245,0
129775,1876,359,544603,1517,0
129800,552,113,49607,439,0
129801,1262,259,259777,1003,0
129804,793,158,100330,635,0
129808,127,29,2842,98,0
129860,385,71,22294,314,0
129864,1829,353,521028,1476,0
129866,495,87,35496,408,0
129869,1583,310,394630,1273,0
129872,25,3,66,22,0
129889,1934,345,548205,1589,0
129892,793,158,100330,635,0
129925,714,137,79049,577,0
129931,1411,281,317530,1130,0
129933,1025,201,165624,824,0
129953,27,5,110,22,0
129975,346,76,20520,270,0
129978,551,102,45798,449,0
129989,1583,310,394630,1273,0
129995,971,184,144808,787,0
129996,1025,201,165624,824,0
130018,821,171,111150,650,0
130051,134,30,3120,104,0
130060,516,103,42539,413,0
130071,1657,315,422730,1342,0
130073,317,63,16002,254,0
130086,113,24,2136,89,0
130088,366,70,20720,296,0
130103,572,130,57460,442,0
130123,217,44,7612,173,0
130168,516,103,42539,413,0
130208,771,137,86858,634,0
130231,1552,299,374647,1253,0
130248,463,83,31540,380,0
130266,1583,310,394630,1273,0
130302,971,184,144808,787,0
130310,1934,345,548205,1589,0
130320,971,184,144808,787,0
130341,2102,402,683400,1700,0
130342,323,55,14740,268,0
130346,552,113,49607,439,0
130373,365,74,21534,291,0
130388,932,168,128352,764,0
130397,1262,259,259777,1003,0
130401,1262,259,259777,1003,0
130402,1204,251,239203,953,0
130410,819,152,101384,667,0
130451,121,27,2538,94,0
130474,571,114,52098,457,0
130480,155,34,4114,121,0
130496,767,144,89712,623,0
130510,620,121,60379,499,0
130517,11,1,10,10,0
130525,552,113,49607,439,0
130533,714,137,79049,577,0
130535,778,163,100245,615,0
130538,198,43,6665,155,0
130542,1025,201,165624,824,0
130543,767,144,89712,623,0
130545,1078,198,174240,880,0
130553,1583,310,394630,1273,0
130554,1262,259,259777,1003,0
130570,185,36,5364,149,0
130573,207,41,6806,166,0
130575,1558,313,389685,1245,0
130580,1934,345,548205,1589,0
130599,317,63,16002,254,0
130626,365,74,21534,291,0
130630,1342,282,298920,1060,0
130639,1331,255,274380,1076,0
130646,572,130,57460,442,0
130650,950,193,146101,757,0
130651,641,131,66810,510,0
130653,171,35,4760,136,0
130655,641,131,66810,510,0
130658,305,70,16450,235,0
130695,70,15,825,55,0
130700,317,63,16002,254,0
130727,1558,313,389685,1245,0
130740,227,44,8052,183,0
130752,1342,282,298920,1060,0
130763,77,17,1020,60,0
130779,819,152,101384,667,0
130787,30,6,144,24,0
130801,660,133,69928,527,0
130826,950,193,146101,757,0
130841,1552,299,374647,1253,0
130853,113,24,2136,89,0
130854,120,24,2304,96,0
130855,1280,232,243136,1048,0
130859,1876,359,544603,1517,0
130861,18,6,72,12,0
130869,641,131,66810,510,0
130874,1262,259,259777,1003,0
130885,324,67,17219,257,0
130893,15,6,54,9,0
130896,1342,282,298920,1060,0
130900,821,171,111150,650,0
130918,1280,232,243136,1048,0
130923,317,63,16002,254,0
130926,337,74,19462,263,0
130965,551,102,45798,449,0
130987,323,55,14740,268,0
131013,1558,313,389685,1245,0
131020,950,193,146101,757,0
131021,1829,353,521028,1476,0
131022,1331,255,274380,1076,0
131036,1657,315,422730,1342,0
131041,385,71,22294,314,0
131042,217,44,7612,173,0
131058,1078,198,174240,880,0
131062,595,120,57000,475,0
131070,160,32,4096,128,0
131102,865,167,116566,698,0
131104,1280,232,243136,1048,0
131106,516,103,42539,413,0
131111,385,71,22294,314,0
131118,778,163,100245,615,0
131163,821,171,111150,650,0
131173,767,144,89712,623,0
131196,865,167,116566,698,0
131201,282,50,11600,232,0
131203,1262,259,259777,1003,0
131204,1876,359,544603,1517,0
131217,971,184,144808,787,0
131220,134,30,3120,104,0
131229,950,193,146101,757,0
131236,1583,310,394630,1273,0
131241,1829,353,521028,1476,0
131250,61,11,550,50,0
131256,595,121,57354,474,0
131257,2102,402,683400,1700,0
131274,1558,313,389685,1245,0
131283,1280,232,243136,1048,0
131288,595,121,57354,474,0
131291,1876,359,544603,1517,0
131302,539,101,44238,438,0
131326,793,158,100330,635,0
131332,552,113,49607,439,0
131333,264,56,11648,208,0
131338,1411,281,317530,1130,0
131340,315,56,14504,259,0
131343,1934,345,548205,1589,0
131345,1296,252,263088,1044,0
131360,595,121,57354,474,0
131366,700,128,73216,572,0
131369,2102,402,683400,1700,0
131384,186,35,5285,151,0
131385,380,76,23104,304,0
131400,1552,299,374647,1253,0
131401,497,97,38800,400,0
131404,1876,359,544603,1517,0
131407,2102,402,683400,1700,0
131412,282,50,11600,232,0
131418,821,171,111150,650,0
131444,1078,198,174240,880,0
131452,971,184,144808,787,0
131458,8,2,12,6,0
131464,976,180,143280,796,0
131493,1181,246,230010,935,0
131498,660,133,69928,527,0
131515,113,24,2136,89,0
131519,572,130,57460,442,0
131523,714,137,79049,577,0
131538,198,43,6665,155,0
131556,1025,201,165624,824,0
131566,1262,259,259777,1003,0
131592,821,171,111150,650,0
131613,1262,259,259777,1003,0
131617,1411,281,317530,1130,0
131628,2102,402,683400,1700,0
131644,551,102,45798,449,0
131647,771,137,86858,634,0
131648,1657,315,422730,1342,0
131661,252,45,9315,207,0
131724,29,5,120,24,0
131725,700,128,73216,572,0
131734,1876,359,544603,1517,0
131770,571,114,52098,457,0
131780,1876,359,544603,1517,0
131797,1411,281,317530,1130,0
131824,56,13,559,43,0
131829,1829,353,521028,1476,0
131841,1552,299,374647,1253,0
131847,1934,345,548205,1589,0
131856,366,70,20720,296,0
131857,1331,255,274380,1076,0
131879,660,133,69928,527,0
131896,37,10,270,27,0
131900,1934,345,548205,1589,0
131910,932,168,128352,764,0
131919,819,152,101384,667,0
131932,819,152,101384,667,0
131985,1541,306,377910,1235,0
131986,41,8,264,33,0
131987,2102,402,683400,1700,0
131991,61,13,624,48,0
131996,595,121,57354,474,0
132016,1204,251,239203,953,0
132034,1262,259,259777,1003,0
132036,1876,359,544603,1517,0
132063,778,163,100245,615,0
132092,1342,282,298920,1060,0
132096,236,50,9300,186,0
132104,317,63,16002,254,0
132106,35,6,174,29,0
132113,62,16,736,46,0
132116,2102,402,683400,1700,0
132152,1181,246,230010,935,0
132160,321,54,14418,267,0
132169,1829,353,521028,1476,0
132173,315,56,14504,259,0
132195,373,74,22126,299,0
132199,1411,281,317530,1130,0
132202,1025,201,165624,824,0
132206,1342,282,298920,1060,0
132220,1876,359,544603,1517,0
132250,1657,315,422730,1342,0
132256,534,102,44064,432,0
132279,69,12,684,57,0
132306,366,70,20720,296,0
132339,1657,315,422730,1342,0
132341,1829,353,521028,1476,0
132363,1342,282,298920,1060,0
132370,836,151,103435,685,0
132371,620,121,60379,499,0
132397,47,8,312,39,0
132407,821,171,111150,650,0
132429,516,103,42539,413,0
132436,821,171,111150,650,0
132439,767,144,89712,623,0
132453,767,144,89712,623,0
132461,1025,201,165624,824,0
132462,131,21,2310,110,0
132476,641,131,66810,510,0
132525,1262,259,259777,1003,0
132527,1181,246,230010,935,0
132553,1025,201,165624,824,0
132567,1204,251,239203,953,0
132571,323,55,14740,268,0
132574,410,76,25384,334,0
132587,1342,282,298920,1060,0
132595,360,66,19404,294,0
132617,200,40,6400,160,0
132635,22,6,96,16,0
132641,395,72,23256,323,0
132645,1181,246,230010,935,0
132653,1342,282,298920,1060,0
132670,539,101,44238,438,0
132698,1296,252,263088,1044,0
132699,1078,198,174240,880,0
132781,1552,299,374647,1253,0
132787,950,193,146101,757,0
132793,1296,252,263088,1044,0
132794,1876,359,544603,1517,0
132802,771,137,86858,634,0
132817,463,83,31540,380,0
132837,572,130,57460,442,0
132839,971,184,144808,787,0
132858,160,32,4096,128,0
132872,323,55,14740,268,0
132905,101,20,1620,81,0
132929,164,34,4420,130,0
132947,1558,313,389685,1245,0
132959,185,36,5364,149,0
132970,660,133,69928,527,0
133030,932,168,128352,764,0
133035,379,65,20410,314,0
133074,1583,310,394630,1273,0
133081,365,74,21534,291,0
133088,171,35,4760,136,0
133093,819,152,101384,667,0
133106,495,87,35496,408,0
133122,821,171,111150,650,0
133135,497,97,38800,400,0
133163,1829,353,521028,1476,0
133174,346,76,20520,270,0
133199,1342,282,298920,1060,0
133200,1583,310,394630,1273,0
133201,1583,310,394630,1273,0
133202,641,131,66810,510,0
133209,1657,315,422730,1342,0
133216,40,9,279,31,0
133217,2102,402,683400,1700,0
133232,1552,299,374647,1253,0
133247,1204,251,239203,953,0
133268,1280,232,243136,1048,0
133272,865,167,116566,698,0
133276,516,103,42539,413,0
133307,778,163,100245,615,0
133321,360,66,19404,294,0
133341,463,83,31540,380,0
133346,1181,246,230010,935,0
133353,1552,299,374647,1253,0
133356,1204,251,239203,953,0
133366,552,113,49607,439,0
133375,819,152,101384,667,0
133397,1262,259,259777,1003,0
133433,131,21,2310,110,0
133434,497,97,38800,400,0
133438,535,94,41454,441,0
133439,1025,201,165624,824,0
133456,1552,299,374647,1253,0
133463,793,158,100330,635,0
133464,1552,299,374647,1253,0
133471,1657,315,422730,1342,0
133476,380,76,23104,304,0
133478,1331,255,274380,1076,0
133514,185,36,5364,149,0
133522,497,97,38800,400,0
133526,305,70,16450,235,0
133542,1876,359,544603,1517,0
133548,1558,313,389685,1245,0
133562,1829,353,521028,1476,0
133569,1583,310,394630,1273,0
133582,22,3,57,19,0
133592,1280,232,243136,1048,0
133594,821,171,111150,650,0
133597,65,13,676,52,0
133601,324,67,17219,257,0
133608,778,163,100245,615,0
133610,1541,306,377910,1235,0
133613,2102,402,683400,1700,0
133658,1829,353,521028,1476,0
133660,1025,201,165624,824,0
133670,112,18,1692,94,0
133680,535,94,41454,441,0
133689,1829,353,521028,1476,0
133706,571,114,52098,457,0
133710,571,114,52098,457,0
133714,32,5,135,27,0
133741,1829,353,521028,1476,0
133749,976,180,143280,796,0
133757,61,14,658,47,0
133759,932,168,128352,764,0
133764,61,13,624,48,0
133773,1829,353,521028,1476,0
133775,1657,315,422730,1342,0
133786,620,121,60379,499,0
133788,175,29,4234,146,0
133803,1296,252,263088,1044,0
133806,1876,359,544603,1517,0
133815,1280,232,243136,1048,0
133827,321,54,14418,267,0
133841,1876,359,544603,1517,0
133847,1657,315,422730,1342,0
133853,1204,251,239203,953,0
133854,1829,353,521028,1476,0
133859,1331,255,274380,1076,0
133864,1296,252,263088,1044,0
133885,1876,359,544603,1517,0
133900,1876,359,544603,1517,0
133902,1025,201,165624,824,0
133906,1411,281,317530,1130,0
133909,120,24,2304,96,0
133924,1583,310,394630,1273,0
133953,107,18,1602,89,0
133973,1342,282,298920,1060,0
133983,1558,313,389685,1245,0
134002,516,103,42539,413,0
134025,198,43,6665,155,0
134074,1552,299,374647,1253,0
134080,70,12,696,58,0
134083,410,76,25384,334,0
134092,443,85,30430,358,0
134094,497,97,38800,400,0
134095,714,137,79049,577,0
134098,64,8,448,56,0
134111,1411,281,317530,1130,0
134116,72,14,812,58,0
134139,620,121,60379,499,0
134142,110,27,2241,83,0
134156,1558,313,389685,1245,0
134158,495,87,35496,408,0
134159,72,17,935,55,0
134162,551,102,45798,449,0
134169,77,12,780,65,0
134193,1262,259,259777,1003,0
134202,1829,353,521028,1476,0
134205,1657,315,422730,1342,0
134224,595,121,57354,474,0
134236,714,137,79049,577,0
134237,1552,299,374647,1253,0
134253,1541,306,377910,1235,0
134257,950,193,146101,757,0
134258,35,7,196,28,0
134274,548,102,45492,446,0
134281,1411,281,317530,1130,0
134301,104,16,1408,88,0
134306,497,97,38800,400,0
134315,1657,315,422730,1342,0
134327,1934,345,548205,1589,0
134332,700,128,73216,572,0
134339,821,171,111150,650,0
134342,516,103,42539,413,0
134367,548,102,45492,446,0
134371,1829,353,521028,1476,0
134379,1204,251,239203,953,0
134384,315,56,14504,259,0
134386,1541,306,377910,1235,0
134391,57,7,350,50,0
134414,1934,345,548205,1589,0
134439,778,163,100245,615,0
134455,950,193,146101,757,0
134471,321,54,14418,267,0
134472,1552,299,374647,1253,0
134485,362,69,20217,293,0
134487,1552,299,374647,1253,0
134492,337,74,19462,263,0
134503,1829,353,521028,1476,0
134508,1558,313,389685,1245,0
134520,1342,282,298920,1060,0
134534,379,65,20410,314,0
134535,1876,359,544603,1517,0
134547,379,65,20410,314,0
134555,976,180,143280,796,0
134559,821,171,111150,650,0
134573,1262,259,259777,1003,0
134595,1583,310,394630,1273,0
134611,321,54,14418,267,0
134618,37,10,270,27,0
134651,1342,282,298920,1060,0
134689,44,9,315,35,0
134695,122,20,2040,102,0
134703,1934,345,548205,1589,0
134718,778,163,100245,615,0
134731,463,83,31540,380,0
134740,821,143,96954,678,0
134767,27,4,92,23,0
134779,70,15,825,55,0
134802,362,69,20217,293,0
134806,771,137,86858,634,0
134810,252,45,9315,207,0
134811,534,102,44064,432,0
134824,976,180,143280,796,0
134828,595,121,57354,474,0
134831,1583,310,394630,1273,0
134835,595,120,57000,475,0
134853,534,102,44064,432,0
134856,767,144,89712,623,0
134873,77,18,1062,59,0
134890,572,130,57460,442,0
134904,346,76,20520,270,0
134905,1204,251,239203,953,0
134916,516,103,42539,413,0
134924,714,137,79049,577,0
134929,1342,282,298920,1060,0
134938,30,6,144,24,0
134942,1934,345,548205,1589,0
134952,1552,299,374647,1253,0
134974,595,121,57354,474,0
134986,700,128,73216,572,0
134991,534,102,44064,432,0
135013,443,85,30430,358,0
135032,77,17,1020,60,0
135053,1262,259,259777,1003,0
135056,443,85,30430,358,0
135059,1296,252,263088,1044,0
135081,1342,282,298920,1060,0
135086,534,102,44064,432,0
135087,1262,259,259777,1003,0
135094,1204,251,239203,953,0
135114,595,121,57354,474,0
135132,1541,306,377910,1235,0
135158,131,25,2650,106,0
135176,2102,402,683400,1700,0
135186,1411,281,317530,1130,0
135214,1296,252,263088,1044,0
135221,68,14,756,54,0
135235,1829,353,521028,1476,0
135272,36,10,260,26,0
135287,1296,252,263088,1044,0
135289,50,8,336,42,0
135292,771,137,86858,634,0
135297,337,74,19462,263,0
135314,865,167,116566,698,0
135380,217,44,7612,173,0
135384,1296,252,263088,1044,0
135399,1552,299,374647,1253,0
135404,401,77,24948,324,0
135406,236,50,9300,186,0
135415,264,56,11648,208,0
135416,1331,255,274380,1076,0
135429,641,131,66810,510,0
135432,1411,281,317530,1130,0
135434,836,151,103435,685,0
135440,72,14,812,58,0
135461,971,184,144808,787,0
135473,1342,282,298920,1060,0
135510,29,5,120,24,0
135513,155,34,4114,121,0
135528,69,14,770,55,0
135533,932,168,128352,764,0
135574,1934,345,548205,1589,0
135578,620,121,60379,499,0
135585,273,58,12470,215,0
135591,1280,232,243136,1048,0
135592,144,29,3335,115,0
135599,113,20,1860,93,0
135602,1657,315,422730,1342,0
135610,463,83,31540,380,0
135622,821,143,96954,678,0
135627,1342,282,298920,1060,0
135630,572,130,57460,442,0
135640,405,82,26486,323,0
135652,365,74,21534,291,0
135654,1181,246,230010,935,0
135662,1262,259,259777,1003,0
135670,61,14,658,47,0
135685,35,6,174,29,0
135689,819,152,101384,667,0
135692,1411,281,317530,1130,0
135698,1541,306,377910,1235,0
135724,122,22,2200,100,0
135727,1280,232,243136,1048,0
135735,108,17,1547,91,0
135742,932,168,128352,764,0
135744,821,143,96954,678,0
135749,1181,246,230010,935,0
135757,274,57,12369,217,0
135768,495,87,35496,408,0
135769,2102,402,683400,1700,0
135783,26,4,88,22,0
135794,1204,251,239203,953,0
135811,405,82,26486,323,0
135819,88,17,1207,71,0
135821,659,132,69928,527,0
135832,337,74,19462,263,0
135840,1296,252,263088,1044,0
135869,516,103,42539,413,0
135877,1331,255,274380,1076,0
135878,72,13,767,59,0
135885,932,168,128352,764,0
135886,1552,299,374647,1253,0
135895,68,15,795,53,0
135905,548,102,45492,446,0
135933,976,180,143280,796,0
135940,135,30,3150,105,0
135947,641,131,66810,510,0
135960,819,152,101384,667,0
135971,146,34,3808,112,0
135980,58,11,517,47,0
135981,18,6,72,12,0
136007,1558,313,389685,1245,0
136029,1558,313,389685,1245,0
136032,31,10,210,21,0
136035,1296,252,263088,1044,0
136038,771,137,86858,634,0
136050,1181,246,230010,935,0
136066,164,34,4420,130,0
136070,236,50,9300,186,0
136073,2102,402,683400,1700,0
136089,1876,359,544603,1517,0
136103,31,7,168,24,0
136122,971,184,144808,787,0
136125,1934,345,548205,1589,0
136129,1204,251,239203,953,0
136143,1342,282,298920,1060,0
136169,155,27,3456,128,0
136177,1876,359,544603,1517,0
136210,1657,315,422730,1342,0
136211,145,23,2806,122,0
136246,1296,252,263088,1044,0
136248,43,7,252,36,0
136249,620,121,60379,499,0
136250,821,171,111150,650,0
136252,131,21,2310,110,0
136271,950,193,146101,757,0
136280,385,71,22294,314,0
136330,1829,353,521028,1476,0
136331,337,74,19462,263,0
136339,595,121,57354,474,0
136342,865,167,116566,698,0
136344,1296,252,263088,1044,0
136373,380,76,23104,304,0
136378,836,151,103435,685,0
136386,552,113,49607,439,0
136398,24,6,108,18,0
136447,551,102,45798,449,0
136454,85,18,1206,67,0
136476,43,7,252,36,0
136480,17,6,66,11,0
136499,365,74,21534,291,0
136500,535,94,41454,441,0
136507,950,193,146101,757,0
136509,1296,252,263088,1044,0
136510,1262,259,259777,1003,0
136513,112,18,1692,94,0
136523,1829,353,521028,1476,0
136547,108,17,1547,91,0
136551,1262,259,259777,1003,0
136569,217,44,7612,173,0
136572,1934,345,548205,1589,0
136573,443,85,30430,358,0
136574,373,74,22126,299,0
136589,366,70,20720,296,0
136603,821,171,111150,650,0
136632,1181,246,230010,935,0
136644,77,12,780,65,0
136657,793,158,100330,635,0
136659,1934,345,548205,1589,0
136661,1296,252,263088,1044,0
136669,535,94,41454,441,0
136676,121,27,2538,94,0
136685,971,184,144808,787,0
136687,405,82,26486,323,0
136705,539,101,44238,438,0
136714,14,3,33,11,0
136720,68,12,672,56,0
136723,865,167,116566,698,0
136727,1934,345,548205,1589,0
136746,1025,201,165624,824,0
136758,1876,359,544603,1517,0
136759,572,130,57460,442,0
136785,821,171,111150,650,0
136795,104,16,1408,88,0
136803,1934,345,548205,1589,0
136809,1657,315,422730,1342,0
136810,1181,246,230010,935,0
136835,1583,310,394630,1273,0
136847,700,128,73216,572,0
136854,595,120,57000,475,0
136880,337,74,19462,263,0
136884,373,74,22126,299,0
136888,69,14,770,55,0
136889,1558,313,389685,1245,0
136904,1552,299,374647,1253,0
136919,1296,252,263088,1044,0
136921,21,6,90,15,0
136928,778,163,100245,615,0
136930,193,39,6006,154,0
136955,380,76,23104,304,0
136963,821,171,111150,650,0
136969,932,168,128352,764,0
136996,778,163,100245,615,0
137005,497,97,38800,400,0
137009,324,67,17219,257,0
137023,463,83,31540,380,0
137025,401,77,24948,324,0
137034,145,23,2806,122,0
137035,380,76,23104,304,0
137039,14,3,33,11,0
137042,1411,281,317530,1130,0
137054,819,152,101384,667,0
137092,1876,359,544603,1517,0
137098,771,137,86858,634,0
137107,620,121,60379,499,0
137111,164,34,4420,130,0
137116,337,74,19462,263,0
137147,1934,345,548205,1589,0
137151,198,43,6665,155,0
137164,1342,282,298920,1060,0
137188,1296,252,263088,1044,0
137226,595,121,57354,474,0
137229,971,184,144808,787,0
137233,1829,353,521028,1476,0
137241,551,102,45798,449,0
137246,534,102,44064,432,0
137270,971,184,144808,787,0
137278,1829,353,521028,1476,0
137306,932,168,128352,764,0
137316,1934,345,548205,1589,0
137330,227,44,8052,183,0
137356,865,167,116566,698,0
137358,767,144,89712,623,0
137367,415,75,25500,340,0
137369,1657,315,422730,1342,0
137379,568,114,51756,454,0
137381,932,168,128352,764,0
137399,360,66,19404,294,0
137403,595,121,57354,474,0
137410,463,83,31540,380,0
137415,1583,310,394630,1273,0
137437,767,144,89712,623,0
137440,252,45,9315,207,0
137473,539,101,44238,438,0
137490,105,22,1826,83,0
137515,771,137,86858,634,0
137545,1204,251,239203,953,0
137568,131,25,2650,106,0
137569,1583,310,394630,1273,0
137580,395,72,23256,323,0
137590,6,1,5,5,0
137591,865,167,116566,698,0
137639,595,120,57000,475,0
137642,1876,359,544603,1517,0
137658,305,70,16450,235,0
137664,1025,201,165624,824,0
137666,778,163,100245,615,0
137668,534,102,44064,432,0
137688,1541,306,377910,1235,0
137697,535,94,41454,441,0
137700,1552,299,374647,1253,0
137719,20,5,75,15,0
137733,1552,299,374647,1253,0
137736,1583,310,394630,1273,0
137738,1204,251,239203,953,0
137745,58,12,552,46,0
137747,1934,345,548205,1589,0
137762,2102,402,683400,1700,0
137763,72,14,812,58,0
137772,568,114,51756,454,0
137778,976,180,143280,796,0
137789,113,20,1860,93,0
137794,305,70,16450,235,0
137802,305,70,16450,235,0
137805,174,36,4968,138,0
137807,194,39,6045,155,0
137808,236,50,9300,186,0
137813,1657,315,422730,1342,0
137821,373,74,22126,299,0
137838,767,144,89712,623,0
137840,572,130,57460,442,0
137849,282,50,11600,232,0
137852,415,75,25500,340,0
137853,14,3,33,11,0
137856,43,7,252,36,0
137857,1025,201,165624,824,0
137894,1552,299,374647,1253,0
137896,865,167,116566,698,0
137899,113,24,2136,89,0
137901,52,10,420,42,0
137904,595,121,57354,474,0
137925,595,120,57000,475,0
137944,1876,359,544603,1517,0
137978,385,71,22294,314,0
137990,1876,359,544603,1517,0
138006,819,152,101384,667,0
138015,660,133,69928,527,0
138016,571,114,52098,457,0
138029,1934,345,548205,1589,0
138030,535,94,41454,441,0
138053,155,35,4200,120,0
138057,2102,402,683400,1700,0
138060,102,20,1640,82,0
138086,1262,259,259777,1003,0
138090,641,131,66810,510,0
138106,1331,255,274380,1076,0
138121,714,137,79049,577,0
138129,516,103,42539,413,0
138146,1829,353,521028,1476,0
138151,1876,359,544603,1517,0
138154,1296,252,263088,1044,0
138155,971,184,144808,787,0
138160,572,130,57460,442,0
138165,595,121,57354,474,0
138179,1829,353,521028,1476,0
138194,362,69,20217,293,0
138199,1829,353,521028,1476,0
138200,1025,201,165624,824,0
138207,1280,232,243136,1048,0
138237,1331,255,274380,1076,0
138253,155,34,4114,121,0
138261,174,36,4968,138,0
138264,778,163,100245,615,0
138278,324,67,17219,257,0
138285,175,29,4234,146,0
138291,1829,353,521028,1476,0
138294,1657,315,422730,1342,0
138340,405,82,26486,323,0
138360,1262,259,259777,1003,0
138361,43,7,252,36,0
138363,121,27,2538,94,0
138370,1558,313,389685,1245,0
138375,771,137,86858,634,0
138420,1876,359,544603,1517,0
138422,35,8,216,27,0
138438,971,184,144808,787,0
138440,49,9,360,40,0
138457,1541,306,377910,1235,0
138476,164,34,4420,130,0
138494,771,137,86858,634,0
138496,1558,313,389685,1245,0
138520,324,67,17219,257,0
138527,495,87,35496,408,0
138530,778,163,100245,615,0
138536,778,163,100245,615,0
138537,323,55,14740,268,0
138541,155,34,4114,121,0
138553,108,17,1547,91,0
138561,1296,252,263088,1044,0
138563,24,6,108,18,0
138564,1934,345,548205,1589,0
138570,1262,259,259777,1003,0
138585,1829,353,521028,1476,0
138590,516,103,42539,413,0
138598,2102,402,683400,1700,0
138610,1342,282,298920,1060,0
138645,660,133,69928,527,0
138661,1411,281,317530,1130,0
138663,1876,359,544603,1517,0
138669,539,101,44238,438,0
138672,174,36,4968,138,0
138684,932,168,128352,764,0
138688,1342,282,298920,1060,0
138692,127,29,2842,98,0
138703,595,120,57000,475,0
138711,1262,259,259777,1003,0
138715,539,101,44238,438,0
138721,821,143,96954,678,0
138729,200,40,6400,160,0
138738,1025,201,165624,824,0
138743,365,74,21534,291,0
138744,516,103,42539,413,0
138754,778,163,100245,615,0
138778,1331,255,274380,1076,0
138784,2102,402,683400,1700,0
138787,1262,259,259777,1003,0
138792,60,12,576,48,0
138796,819,152,101384,667,0
138800,77,19,1102,58,0
138812,2102,402,683400,1700,0
138814,976,180,143280,796,0
138816,1411,281,317530,1130,0
138826,1181,246,230010,935,0
138834,32,7,175,25,0
138840,821,171,111150,650,0
138883,1181,246,230010,935,0
138888,1583,310,394630,1273,0
138913,595,120,57000,475,0
138919,551,102,45798,449,0
138925,714,137,79049,577,0
138938,1181,246,230010,935,0
138954,77,12,780,65,0
138957,105,16,1424,89,0
138963,971,184,144808,787,0
138973,1558,313,389685,1245,0
138974,264,56,11648,208,0
139014,1296,252,263088,1044,0
139025,1280,232,243136,1048,0
139027,495,87,35496,408,0
139035,1262,259,259777,1003,0
139045,771,137,86858,634,0
139059,1558,313,389685,1245,0
139065,971,184,144808,787,0
139068,1829,353,521028,1476,0
139069,971,184,144808,787,0
139073,401,77,24948,324,0
139098,156,34,4148,122,0
139127,950,193,146101,757,0
139143,337,74,19462,263,0
139147,641,131,66810,510,0
139148,1411,281,317530,1130,0
139161,932,168,128352,764,0
139181,568,114,51756,454,0
139212,360,66,19404,294,0
139244,1078,198,174240,880,0
139254,72,14,812,58,0
139268,1541,306,377910,1235,0
139272,571,114,52098,457,0
139280,1280,232,243136,1048,0
139281,1078,198,174240,880,0
139290,186,35,5285,151,0
139298,1552,299,374647,1253,0
139299,793,158,100330,635,0
139300,568,114,51756,454,0
139302,1876,359,544603,1517,0
139308,14,3,33,11,0
139318,2102,402,683400,1700,0
139321,366,70,20720,296,0
139339,373,74,22126,299,0
139340,58,11,517,47,0
139344,836,151,103435,685,0
139352,1552,299,374647,1253,0
139354,552,113,49607,439,0
139358,1204,251,239203,953,0
139366,571,114,52098,457,0
139377,1078,198,174240,880,0
139384,1204,251,239203,953,0
139392,72,14,812,58,0
139393,69,12,684,57,0
139401,821,171,111150,650,0
139406,379,65,20410,314,0
139411,2102,402,683400,1700,0
139412,64,8,448,56,0
139414,821,171,111150,650,0
139424,778,163,100245,615,0
139425,72,13,767,59,0
139427,1204,251,239203,953,0
139429,380,76,23104,304,0
139436,198,43,6665,155,0
139437,401,77,24948,324,0
139446,497,97,38800,400,0
139451,1829,353,521028,1476,0
139455,497,97,38800,400,0
139459,767,144,89712,623,0
139476,821,143,96954,678,0
139479,620,121,60379,499,0
139502,595,120,57000,475,0
139515,793,158,100330,635,0
139521,539,101,44238,438,0
139523,534,102,44064,432,0
139547,1296,252,263088,1044,0
139554,1541,306,377910,1235,0
139557,2102,402,683400,1700,0
139560,25,3,66,22,0
139565,443,85,30430,358,0
139580,976,180,143280,796,0
139593,443,85,30430,358,0
139607,971,184,144808,787,0
139615,767,144,89712,623,0
139622,97,22,1650,75,0
139661,1181,246,230010,935,0
139665,1204,251,239203,953,0
139672,1342,282,298920,1060,0
139705,821,171,111150,650,0
139713,385,71,22294,314,0
139723,641,131,66810,510,0
139725,64,16,768,48,0
139738,236,50,9300,186,0
139743,714,137,79049,577,0
139746,373,74,22126,299,0
139753,950,193,146101,757,0
139776,1558,313,389685,1245,0
139787,324,67,17219,257,0
139804,2102,402,683400,1700,0
139805,767,144,89712,623,0
139815,217,44,7612,173,0
139830,1934,345,548205,1589,0
139833,1078,198,174240,880,0
139835,1552,299,374647,1253,0
139836,1342,282,298920,1060,0
139842,551,102,45798,449,0
139847,1552,299,374647,1253,0
139897,535,94,41454,441,0
139904,535,94,41454,441,0
139917,819,152,101384,667,0
139934,401,77,24948,324,0
139936,72,17,935,55,0
139937,976,180,143280,796,0
139987,660,133,69928,527,0
139990,516,103,42539,413,0
139997,571,114,52098,457,0
140001,932,168,128352,764,0
140014,836,151,103435,685,0
140015,1181,246,230010,935,0
140052,1934,345,548205,1589,0
140061,819,152,101384,667,0
140065,641,131,66810,510,0
140079,1342,282,298920,1060,0
140106,1876,359,544603,1517,0
140129,551,102,45798,449,0
140138,112,18,1692,94,0
140141,1552,299,374647,1253,0
140149,1558,313,389685,1245,0
140156,641,131,66810,510,0
140188,75,19,1064,56,0
140190,64,16,768,48,0
140194,1204,251,239203,953,0
140195,714,137,79049,577,0
140196,1876,359,544603,1517,0
140199,1411,281,317530,1130,0
140209,54,14,560,40,0
140214,36,10,260,26,0
140216,1296,252,263088,1044,0
140244,714,137,79049,577,0
140261,1829,353,521028,1476,0
140278,193,39,6006,154,0
140287,1204,251,239203,953,0
140305,1025,201,165624,824,0
140306,539,101,44238,438,0
140307,548,102,45492,446,0
140318,46,9,333,37,0
140326,595,120,57000,475,0
140327,821,171,111150,650,0
140364,395,72,23256,323,0
140366,516,103,42539,413,0
140369,405,82,26486,323,0
140385,1280,232,243136,1048,0
140389,778,163,100245,615,0
140395,1829,353,521028,1476,0
140398,1331,255,274380,1076,0
140403,463,83,31540,380,0
140419,865,167,116566,698,0
140448,778,163,100245,615,0
140453,1181,246,230010,935,0
140461,1025,201,165624,824,0
140465,1181,246,230010,935,0
140466,1876,359,544603,1517,0
140472,155,35,4200,120,0
140479,122,25,2425,97,0
140501,77,18,1062,59,0
140513,595,120,57000,475,0
140519,1204,251,239203,953,0
140521,595,120,57000,475,0
140543,31,9,198,22,0
140567,16,1,15,15,0
140569,1583,310,394630,1273,0
140573,552,113,49607,439,0
140598,323,55,14740,268,0
140606,771,137,86858,634,0
140616,1934,345,548205,1589,0
140632,1934,345,548205,1589,0
140641,19,3,48,16,0
140644,463,83,31540,380,0
140653,771,137,86858,634,0
140659,415,75,25500,340,0
140669,137,25,2800,112,0
140675,552,113,49607,439,0
140700,793,158,100330,635,0
140709,1280,232,243136,1048,0
140724,110,18,1656,92,0
140758,2102,402,683400,1700,0
140763,571,114,52098,457,0
140788,1296,252,263088,1044,0
140790,1876,359,544603,1517,0
140796,2102,402,683400,1700,0
140801,380,76,23104,304,0
140803,1181,246,230010,935,0
140808,61,13,624,48,0
140826,932,168,128352,764,0
140842,380,76,23104,304,0
140856,160,29,3799,131,0
140869,401,77,24948,324,0
140876,273,58,12470,215,0
140881,1296,252,263088,1044,0
140888,819,152,101384,667,0
140909,380,76,23104,304,0
140914,821,171,111150,650,0
140929,1558,313,389685,1245,0
140930,317,63,16002,254,0
140932,714,137,79049,577,0
140941,932,168,128352,764,0
140945,1583,310,394630,1273,0
140961,1934,345,548205,1589,0
140978,443,85,30430,358,0
140992,793,158,100330,635,0
140994,1829,353,521028,1476,0
141009,58,12,552,46,0
141021,2102,402,683400,1700,0
141060,346,76,20520,270,0
141069,1204,251,239203,953,0
141074,971,184,144808,787,0
141082,1558,313,389685,1245,0
141105,932,168,128352,764,0
141109,971,184,144808,787,0
141110,85,18,1206,67,0
141113,60,12,576,48,0
141132,539,101,44238,438,0
141137,1181,246,230010,935,0
141149,65,17,816,48,0
141152,463,83,31540,380,0
141165,865,167,116566,698,0
141176,1280,232,243136,1048,0
141191,145,23,2806,122,0
141195,1558,313,389685,1245,0
141208,1552,299,374647,1253,0
141240,1558,313,389685,1245,0
141256,821,143,96954,678,0
141269,1876,359,544603,1517,0
141280,1411,281,317530,1130,0
141283,1280,232,243136,1048,0
141285,1934,345,548205,1589,0
141287,1342,282,298920,1060,0
141289,1181,246,230010,935,0
141302,1876,359,544603,1517,0
141307,551,102,45798,449,0
141326,568,114,51756,454,0
141328,1583,310,394630,1273,0
141329,620,121,60379,499,0
141331,1552,299,374647,1253,0
141332,771,137,86858,634,0
141342,865,167,116566,698,0
141360,1204,251,239203,953,0
141372,120,24,2304,96,0
141378,1876,359,544603,1517,0
141383,1829,353,521028,1476,0
141385,321,54,14418,267,0
141444,410,76,25384,334,0
141448,836,151,103435,685,0
141454,767,144,89712,623,0
141458,185,36,5364,149,0
141464,137,25,2800,112,0
141474,317,63,16002,254,0
141475,61,13,624,48,0
141476,362,69,20217,293,0
141483,405,82,26486,323,0
141486,1934,345,548205,1589,0
141490,1078,198,174240,880,0
141493,1876,359,544603,1517,0
141494,548,102,45492,446,0
141500,40,9,279,31,0
141509,124,28,2688,96,0
141539,767,144,89712,623,0
141556,2102,402,683400,1700,0
141570,337,74,19462,263,0
141608,186,35,5285,151,0
141612,971,184,144808,787,0
141622,641,131,66810,510,0
141625,1657,315,422730,1342,0
141642,317,63,16002,254,0
141663,1934,345,548205,1589,0
141673,410,76,25384,334,0
141678,385,71,22294,314,0
141688,1078,198,174240,880,0
141690,495,87,35496,408,0
141692,1411,281,317530,1130,0
141699,315,56,14504,259,0
141700,1204,251,239203,953,0
141747,2102,402,683400,1700,0
141758,620,121,60379,499,0
141761,174,36,4968,138,0
141775,2102,402,683400,1700,0
141781,1541,306,377910,1235,0
141782,186,35,5285,151,0
141804,1829,353,521028,1476,0
141808,1078,198,174240,880,0
141821,1204,251,239203,953,0
141824,1657,315,422730,1342,0
141825,771,137,86858,634,0
141830,1280,232,243136,1048,0
141843,463,83,31540,380,0
141844,1558,313,389685,1245,0
141861,976,180,143280,796,0
141871,77,18,1062,59,0
141878,950,193,146101,757,0
141894,1541,306,377910,1235,0
141896,1934,345,548205,1589,0
141913,324,67,17219,257,0
141918,1583,310,394630,1273,0
141921,1558,313,389685,1245,0
141938,1829,353,521028,1476,0
141948,104,16,1408,88,0
141954,58,15,645,43,0
141958,236,50,9300,186,0
141964,793,158,100330,635,0
141971,1342,282,298920,1060,0
141999,30,6,144,24,0
142024,1078,198,174240,880,0
142031,571,114,52098,457,0
142056,971,184,144808,787,0
142064,932,168,128352,764,0
142066,1181,246,230010,935,0
142072,1331,255,274380,1076,0
142078,1411,281,317530,1130,0
142098,767,144,89712,623,0
142100,539,101,44238,438,0
142111,360,66,19404,294,0
142120,534,102,44064,432,0
142134,1331,255,274380,1076,0
142139,771,137,86858,634,0
142166,1558,313,389685,1245,0
142202,24,6,108,18,0
142204,373,74,22126,299,0
142221,1541,306,377910,1235,0
142224,72,14,812,58,0
142236,1934,345,548205,1589,0
142245,1558,313,389685,1245,0
142264,865,167,116566,698,0
142281,767,144,89712,623,0
142282,46,9,333,37,0
142285,821,143,96954,678,0
142307,821,143,96954,678,0
142313,122,20,2040,102,0
142353,976,180,143280,796,0
142361,61,9,468,52,0
142363,1829,353,521028,1476,0
142375,595,120,57000,475,0
142385,535,94,41454,441,0
142393,1934,345,548205,1589,0
142401,793,158,100330,635,0
142403,36,6,180,30,0
142430,572,130,57460,442,0
142441,54,14,560,40,0
142450,1876,359,544603,1517,0
142454,34,7,189,27,0
142459,105,16,1424,89,0
142469,337,74,19462,263,0
142471,127,29,2842,98,0
142477,61,11,550,50,0
142481,1876,359,544603,1517,0
142485,89,15,1110,74,0
142510,1025,201,165624,824,0
142553,793,158,100330,635,0
142563,620,121,60379,499,0
142568,620,121,60379,499,0
142570,595,121,57354,474,0
142577,20,3,51,17,0
142581,771,137,86858,634,0
142585,164,34,4420,130,0
142586,127,29,2842,98,0
142589,365,74,21534,291,0
142607,131,25,2650,106,0
142622,1829,353,521028,1476,0
142624,200,40,6400,160,0
142632,1934,345,548205,1589,0
142662,385,71,22294,314,0
142704,273,58,12470,215,0
142705,186,35,5285,151,0
142711,932,168,128352,764,0
142744,793,158,100330,635,0
142775,1262,259,259777,1003,0
142779,1829,353,521028,1476,0
142793,1078,198,174240,880,0
142795,1331,255,274380,1076,0
142796,865,167,116566,698,0
142798,821,143,96954,678,0
142824,595,120,57000,475,0
142829,23,2,42,21,0
142866,1934,345,548205,1589,0
142870,2102,402,683400,1700,0
142876,1583,310,394630,1273,0
142885,198,43,6665,155,0
142888,971,184,144808,787,0
142896,155,34,4114,121,0
142911,1558,313,389685,1245,0
142933,1876,359,544603,1517,0
142942,1280,232,243136,1048,0
142966,2102,402,683400,1700,0
142975,89,15,1110,74,0
142976,380,76,23104,304,0
142980,767,144,89712,623,0
142999,106,19,1653,87,0
143033,1934,345,548205,1589,0
143048,2102,402,683400,1700,0
143050,274,57,12369,217,0
143052,1331,255,274380,1076,0
143054,362,69,20217,293,0
143055,793,158,100330,635,0
143070,110,27,2241,83,0
143084,1829,353,521028,1476,0
143095,317,63,16002,254,0
143109,1876,359,544603,1517,0
143115,660,133,69928,527,0
143124,379,65,20410,314,0
143127,1541,306,377910,1235,0
143132,1342,282,298920,1060,0
143152,463,83,31540,380,0
143176,60,12,576,48,0
143189,88,17,1207,71,0
143194,1829,353,521028,1476,0
143206,1552,299,374647,1253,0
143252,1296,252,263088,1044,0
143254,323,55,14740,268,0
143257,463,83,31540,380,0
143261,273,58,12470,215,0
143276,1204,251,239203,953,0
143296,778,163,100245,615,0
143310,1934,345,548205,1589,0
143316,620,121,60379,499,0
143320,552,113,49607,439,0
143327,1342,282,298920,1060,0
143360,551,102,45798,449,0
143379,360,66,19404,294,0
143399,821,171,111150,650,0
143420,534,102,44064,432,0
143421,56,13,559,43,0
143444,1558,313,389685,1245,0
143445,595,121,57354,474,0
143464,1181,246,230010,935,0
143475,362,69,20217,293,0
143480,77,17,1020,60,0
143526,1558,313,389685,1245,0
143528,1876,359,544603,1517,0
143600,534,102,44064,432,0
143601,571,114,52098,457,0
143642,568,114,51756,454,0
143643,106,19,1653,87,0
143645,33,8,200,25,0
143667,821,171,111150,650,0
143671,1829,353,521028,1476,0
143697,119,25,2350,94,0
143702,2102,402,683400,1700,0
143721,1280,232,243136,1048,0
143724,1552,299,374647,1253,0
143737,362,69,20217,293,0
143743,185,36,5364,149,0
143774,2102,402,683400,1700,0
143775,1296,252,263088,1044,0
143781,571,114,52098,457,0
143783,1657,315,422730,1342,0
143814,1181,246,230010,935,0
143818,18,3,45,15,0
143824,568,114,51756,454,0
143866,1876,359,544603,1517,0
143872,1934,345,548205,1589,0
143879,1552,299,374647,1253,0
143882,1342,282,298920,1060,0
143902,77,12,780,65,0
143913,155,35,4200,120,0
143922,77,18,1062,59,0
143923,1552,299,374647,1253,0
143928,571,114,52098,457,0
143930,1296,252,263088,1044,0
143940,155,34,4114,121,0
143941,175,29,4234,146,0
143970,865,167,116566,698,0
143997,27,4,92,23,0
144001,366,70,20720,296,0
144014,1829,353,521028,1476,0
144018,101,20,1620,81,0
144053,15,4,44,11,0
144057,185,36,5364,149,0
144063,1078,198,174240,880,0
144072,1829,353,521028,1476,0
144075,1280,232,243136,1048,0
144103,819,152,101384,667,0
144105,819,152,101384,667,0
144119,1552,299,374647,1253,0
144147,821,143,96954,678,0
144148,552,113,49607,439,0
144149,148,24,2976,124,0
144156,865,167,116566,698,0
144166,1331,255,274380,1076,0
144184,1025,201,165624,824,0
144198,385,71,22294,314,0
144201,1411,281,317530,1130,0
144204,1342,282,298920,1060,0
144205,1025,201,165624,824,0
144212,1411,281,317530,1130,0
144240,497,97,38800,400,0
144252,1583,310,394630,1273,0
144262,1657,315,422730,1342,0
144264,135,30,3150,105,0
144279,1280,232,243136,1048,0
144335,1342,282,298920,1060,0
144337,1342,282,298920,1060,0
144339,317,63,16002,254,0
144349,198,43,6665,155,0
144388,932,168,128352,764,0
144408,2102,402,683400,1700,0
144431,932,168,128352,764,0
144435,122,20,2040,102,0
144437,1342,282,298920,1060,0
144438,1342,282,298920,1060,0
144452,273,58,12470,215,0
144477,193,39,6006,154,0
144504,1331,255,274380,1076,0
144518,976,180,143280,796,0
144533,110,18,1656,92,0
144536,771,137,86858,634,0
144549,865,167,116566,698,0
144551,1876,359,544603,1517,0
144555,127,29,2842,98,0
144573,69,14,770,55,0
144592,620,121,60379,499,0
144606,571,114,52098,457,0
144608,793,158,100330,635,0
144616,1876,359,544603,1517,0
144621,1829,353,521028,1476,0
144655,1583,310,394630,1273,0
144671,44,9,315,35,0
144673,568,114,51756,454,0
144683,321,54,14418,267,0
144697,31,8,184,23,0
144699,146,34,3808,112,0
144713,337,74,19462,263,0
144720,1025,201,165624,824,0
144730,405,82,26486,323,0
144750,134,30,3120,104,0
144751,778,163,100245,615,0
144755,1541,306,377910,1235,0
144772,1829,353,521028,1476,0
144791,1204,251,239203,953,0
144796,164,34,4420,130,0
144812,932,168,128352,764,0
144824,1296,252,263088,1044,0
144825,443,85,30430,358,0
144839,385,71,22294,314,0
144860,1934,345,548205,1589,0
144877,346,76,20520,270,0
144878,2102,402,683400,1700,0
144884,155,35,4200,120,0
144892,8,4,16,4,0
144920,1876,359,544603,1517,0
144955,1331,255,274380,1076,0
144960,1181,246,230010,935,0
144967,31,10,210,21,0
144979,1342,282,298920,1060,0
144994,186,35,5285,151,0
145007,324,67,17219,257,0
145015,976,180,143280,796,0
145016,1078,198,174240,880,0
145017,1025,201,165624,824,0
145023,1078,198,174240,880,0
145030,1411,281,317530,1130,0
145041,40,7,231,33,0
145049,415,75,25500,340,0
145093,1541,306,377910,1235,0
145098,194,39,6045,155,0
145104,1541,306,377910,1235,0
145110,1025,201,165624,824,0
145119,362,69,20217,293,0
145121,552,113,49607,439,0
145122,1583,310,394630,1273,0
145141,976,180,143280,796,0
145167,1876,359,544603,1517,0
145184,315,56,14504,259,0
145188,305,70,16450,235,0
145191,1583,310,394630,1273,0
145236,1934,345,548205,1589,0
145243,1331,255,274380,1076,0
145247,40,6,204,34,0
145268,1657,315,422730,1342,0
145281,1934,345,548205,1589,0
145284,1262,259,259777,1003,0
145307,198,43,6665,155,0
145311,641,131,66810,510,0
145314,405,82,26486,323,0
145332,1657,315,422730,1342,0
145334,37,11,286,26,0
145337,1583,310,394630,1273,0
145358,819,152,101384,667,0
145372,198,43,6665,155,0
145383,976,180,143280,796,0
145384,1078,198,174240,880,0
145398,360,66,19404,294,0
145402,1876,359,544603,1517,0
145419,1876,359,544603,1517,0
145424,1657,315,422730,1342,0
145426,1331,255,274380,1076,0
145430,1583,310,394630,1273,0
145434,1583,310,394630,1273,0
145442,548,102,45492,446,0
145443,516,103,42539,413,0
145458,1541,306,377910,1235,0
145468,85,18,1206,67,0
145473,127,29,2842,98,0
145481,1204,251,239203,953,0
145482,660,133,69928,527,0
145491,171,35,4760,136,0
145503,160,29,3799,131,0
145506,821,143,96954,678,0
145534,495,87,35496,408,0
145544,415,75,25500,340,0
145546,77,17,1020,60,0
145560,1078,198,174240,880,0
145577,1342,282,298920,1060,0
145596,164,34,4420,130,0
145626,1342,282,298920,1060,0
145636,22,6,96,16,0
145663,193,39,6006,154,0
145671,495,87,35496,408,0
145677,821,171,111150,650,0
145679,548,102,45492,446,0
145682,771,137,86858,634,0
145687,2102,402,683400,1700,0
145694,1078,198,174240,880,0
145723,767,144,89712,623,0
145742,273,58,12470,215,0
145750,1280,232,243136,1048,0
145762,61,14,658,47,0
145767,548,102,45492,446,0
145769,1181,246,230010,935,0
145774,551,102,45798,449,0
145781,252,45,9315,207,0
145784,113,20,1860,93,0
145794,15,4,44,11,0
145817,8,3,15,5,0
145825,1262,259,259777,1003,0
145828,819,152,101384,667,0
145832,15,3,36,12,0
145833,1876,359,544603,1517,0
145847,252,45,9315,207,0
145866,971,184,144808,787,0
145872,77,19,1102,58,0
145884,1934,345,548205,1589,0
145885,836,151,103435,685,0
145890,2102,402,683400,1700,0
145906,385,71,22294,314,0
145907,1934,345,548205,1589,0
145937,14,3,33,11,0
145948,976,180,143280,796,0
145950,821,171,111150,650,0
145962,119,22,2134,97,0
145970,1583,310,394630,1273,0
145973,198,43,6665,155,0
146002,1331,255,274380,1076,0
146010,1411,281,317530,1130,0
146015,113,20,1860,93,0
146020,1552,299,374647,1253,0
146036,534,102,44064,432,0
146038,200,40,6400,160,0
146039,68,15,795,53,0
146062,1583,310,394630,1273,0
146064,572,130,57460,442,0
146077,1181,246,230010,935,0
146082,552,113,49607,439,0
146085,2102,402,683400,1700,0
146112,516,103,42539,413,0
146133,1078,198,174240,880,0
146134,1331,255,274380,1076,0
146143,52,10,420,42,0
146149,1181,246,230010,935,0
146165,1025,201,165624,824,0
146181,443,85,30430,358,0
146187,1204,251,239203,953,0
146191,700,128,73216,572,0
146198,714,137,79049,577,0
146203,1552,299,374647,1253,0
146212,595,121,57354,474,0
146222,1552,299,374647,1253,0
146227,620,121,60379,499,0
146241,548,102,45492,446,0
146245,6,2,8,4,0
146272,571,114,52098,457,0
146274,865,167,116566,698,0
146284,976,180,143280,796,0
146286,155,27,3456,128,0
146302,77,18,1062,59,0
146307,1552,299,374647,1253,0
146309,119,25,2350,94,0
146313,1181,246,230010,935,0
146320,366,70,20720,296,0
146322,771,137,86858,634,0
146326,365,74,21534,291,0
146335,865,167,116566,698,0
146339,548,102,45492,446,0
146347,836,151,103435,685,0
146353,1558,313,389685,1245,0
146358,1657,315,422730,1342,0
146375,366,70,20720,296,0
146388,1411,281,317530,1130,0
146395,1181,246,230010,935,0
146396,1876,359,544603,1517,0
146402,395,72,23256,323,0
146407,535,94,41454,441,0
146449,932,168,128352,764,0
146452,572,130,57460,442,0
146462,771,137,86858,634,0
146467,305,70,16450,235,0
146477,1296,252,263088,1044,0
146478,1934,345,548205,1589,0
146487,2102,402,683400,1700,0
146499,194,39,6045,155,0
146514,548,102,45492,446,0
146568,865,167,116566,698,0
146576,1204,251,239203,953,0
146617,64,15,735,49,0
146619,620,121,60379,499,0
146625,700,128,73216,572,0
146639,767,144,89712,623,0
146664,198,43,6665,155,0
146714,539,101,44238,438,0
146724,107,19,1672,88,0
146737,373,74,22126,299,0
146741,1657,315,422730,1342,0
146769,1296,252,263088,1044,0
146772,821,143,96954,678,0
146773,572,130,57460,442,0
146789,2102,402,683400,1700,0
146801,1583,310,394630,1273,0
146805,971,184,144808,787,0
146812,1829,353,521028,1476,0
146821,1078,198,174240,880,0
146830,1025,201,165624,824,0
146835,1934,345,548205,1589,0
146853,865,167,116566,698,0
146856,548,102,45492,446,0
146864,360,66,19404,294,0
146874,572,130,57460,442,0
146882,1583,310,394630,1273,0
146884,1934,345,548205,1589,0
146895,346,76,20520,270,0
146896,1558,313,389685,1245,0
146913,1876,359,544603,1517,0
146923,1876,359,544603,1517,0
146928,380,76,23104,304,0
146933,1296,252,263088,1044,0
146939,1025,201,165624,824,0
146943,1331,255,274380,1076,0
146963,131,21,2310,110,0
146965,1411,281,317530,1130,0
146974,932,168,128352,764,0
146986,385,71,22294,314,0
146997,1078,198,174240,880,0
147018,1204,251,239203,953,0
147019,497,97,38800,400,0
147021,778,163,100245,615,0
147026,1411,281,317530,1130,0
147030,932,168,128352,764,0
147051,395,72,23256,323,0
147052,932,168,128352,764,0
147060,26,6,120,20,0
147061,1552,299,374647,1253,0
147065,360,66,19404,294,0
147080,1342,282,298920,1060,0
147092,155,34,4114,121,0
147099,1411,281,317530,1130,0
147101,516,103,42539,413,0
147119,1934,345,548205,1589,0
147139,1411,281,317530,1130,0
147155,1296,252,263088,1044,0
147163,1876,359,544603,1517,0
147174,346,76,20520,270,0
147180,1181,246,230010,935,0
147188,32,6,156,26,0
147193,321,54,14418,267,0
147199,1541,306,377910,1235,0
147205,33,7,182,26,0
147211,793,158,100330,635,0
147227,714,137,79049,577,0
147235,1342,282,298920,1060,0
147246,395,72,23256,323,0
147250,1204,251,239203,953,0
147253,227,44,8052,183,0
147256,274,57,12369,217,0
147267,1078,198,174240,880,0
147268,14,3,33,11,0
147271,1934,345,548205,1589,0
147275,186,35,5285,151,0
147284,362,69,20217,293,0
147303,771,137,86858,634,0
147316,1558,313,389685,1245,0
147320,516,103,42539,413,0
147326,2102,402,683400,1700,0
147327,2102,402,683400,1700,0
147331,72,14,812,58,0
147336,415,75,25500,340,0
147340,1876,359,544603,1517,0
147360,122,20,2040,102,0
147363,1204,251,239203,953,0
147393,971,184,144808,787,0
147396,865,167,116566,698,0
147405,767,144,89712,623,0
147423,595,121,57354,474,0
147426,1657,315,422730,1342,0
147436,1876,359,544603,1517,0
147438,71,15,840,56,0
147439,1583,310,394630,1273,0
147444,1934,345,548205,1589,0
147445,415,75,25500,340,0
147460,771,137,86858,634,0
147495,1262,259,259777,1003,0
147514,198,43,6665,155,0
147548,77,17,1020,60,0
147553,572,130,57460,442,0
147554,1296,252,263088,1044,0
147557,1262,259,259777,1003,0
147558,595,121,57354,474,0
147572,120,24,2304,96,0
147612,1204,251,239203,953,0
147615,463,83,31540,380,0
147674,1296,252,263088,1044,0
147676,534,102,44064,432,0
147694,69,14,770,55,0
147697,31,10,210,21,0
147708,1558,313,389685,1245,0
147748,932,168,128352,764,0
147779,1558,313,389685,1245,0
147797,1541,306,377910,1235,0
147798,620,121,60379,499,0
147805,620,121,60379,499,0
147808,144,29,3335,115,0
147816,1829,353,521028,1476,0
147821,1657,315,422730,1342,0
147826,2102,402,683400,1700,0
147832,346,76,20520,270,0
147847,1829,353,521028,1476,0
147894,595,120,57000,475,0
147903,568,114,51756,454,0
147908,778,163,100245,615,0
147917,1583,310,394630,1273,0
147926,1583,310,394630,1273,0
147928,1078,198,174240,880,0
147931,793,158,100330,635,0
147941,1657,315,422730,1342,0
147942,131,25,2650,106,0
147950,778,163,100245,615,0
147951,5,1,4,4,0
147969,107,18,1602,89,0
147976,1204,251,239203,953,0
147988,264,56,11648,208,0
148002,2102,402,683400,1700,0
148016,1025,201,165624,824,0
148026,415,75,25500,340,0
148036,121,27,2538,94,0
148040,1296,252,263088,1044,0
148044,32,7,175,25,0
148052,89,15,1110,74,0
148055,1262,259,259777,1003,0
148062,2102,402,683400,1700,0
148063,186,35,5285,151,0
148106,41,8,264,33,0
148110,971,184,144808,787,0
148111,660,133,69928,527,0
148114,1262,259,259777,1003,0
148115,1296,252,263088,1044,0
148161,405,82,26486,323,0
148175,1342,282,298920,1060,0
148188,1876,359,544603,1517,0
148191,660,133,69928,527,0
148209,102,20,1640,82,0
148214,236,50,9300,186,0
148227,315,56,14504,259,0
148249,1558,313,389685,1245,0
148260,1552,299,374647,1253,0
148261,315,56,14504,259,0
148266,700,128,73216,572,0
148271,1262,259,259777,1003,0
148306,227,44,8052,183,0
148308,1262,259,259777,1003,0
148312,1657,315,422730,1342,0
148320,405,82,26486,323,0
148348,23,5,90,18,0
148353,950,193,146101,757,0
148380,1342,282,298920,1060,0
148385,932,168,128352,764,0
148396,571,114,52098,457,0
148418,819,152,101384,667,0
148429,819,152,101384,667,0
148442,778,163,100245,615,0
148448,61,8,424,53,0
148449,315,56,14504,259,0
148450,1411,281,317530,1130,0
148451,548,102,45492,446,0
148453,236,50,9300,186,0
148466,44,9,315,35,0
148473,572,130,57460,442,0
148508,595,120,57000,475,0
148515,1934,345,548205,1589,0
148534,641,131,66810,510,0
148543,1296,252,263088,1044,0
148551,1876,359,544603,1517,0
148552,700,128,73216,572,0
148561,1181,246,230010,935,0
148563,37,10,270,27,0
148580,1025,201,165624,824,0
148589,1558,313,389685,1245,0
148600,1280,232,243136,1048,0
148628,660,133,69928,527,0
148662,193,39,6006,154,0
148675,571,114,52098,457,0
148676,30,6,144,24,0
148684,1657,315,422730,1342,0
148757,571,114,52098,457,0
148780,58,15,645,43,0
148783,595,120,57000,475,0
148795,1411,281,317530,1130,0
148803,819,152,101384,667,0
148829,1411,281,317530,1130,0
148836,282,50,11600,232,0
148839,1541,306,377910,1235,0
148851,767,144,89712,623,0
148855,7,2,10,5,0
148873,273,58,12470,215,0
148877,1181,246,230010,935,0
148904,2102,402,683400,1700,0
148909,31,7,168,24,0
148929,1411,281,317530,1130,0
148937,443,85,30430,358,0
148942,778,163,100245,615,0
148954,75,19,1064,56,0
148957,72,17,935,55,0
148964,641,131,66810,510,0
148979,836,151,103435,685,0
149007,572,130,57460,442,0
149013,552,113,49607,439,0
149015,552,113,49607,439,0
149021,865,167,116566,698,0
149034,971,184,144808,787,0
149035,395,72,23256,323,0
149038,55,11,484,44,0
149041,1583,310,394630,1273,0
149044,21,6,90,15,0
149045,1342,282,298920,1060,0
149090,2102,402,683400,1700,0
149094,551,102,45798,449,0
149115,620,121,60379,499,0
149123,373,74,22126,299,0
149131,778,163,100245,615,0
149159,410,76,25384,334,0
149173,317,63,16002,254,0
149176,1204,251,239203,953,0
149179,65,13,676,52,0
149180,1876,359,544603,1517,0
149184,48,10,380,38,0
149195,1934,345,548205,1589,0
149215,6,2,8,4,0
149227,714,137,79049,577,0
149246,1541,306,377910,1235,0
149263,1583,310,394630,1273,0
149266,1829,353,521028,1476,0
149274,71,15,840,56,0
149276,346,76,20520,270,0
149286,836,151,103435,685,0
149328,380,76,23104,304,0
149345,405,82,26486,323,0
149391,1876,359,544603,1517,0
149401,1296,252,263088,1044,0
149430,1876,359,544603,1517,0
149451,1829,353,521028,1476,0
149465,31,10,210,21,0
149475,552,113,49607,439,0
149480,932,168,128352,764,0
149512,1262,259,259777,1003,0
149514,660,133,69928,527,0
149518,379,65,20410,314,0
149548,379,65,20410,314,0
149551,274,57,12369,217,0
149552,778,163,100245,615,0
149563,2102,402,683400,1700,0
149565,1829,353,521028,1476,0
149566,865,167,116566,698,0
149572,1296,252,263088,1044,0
149576,1280,232,243136,1048,0
149580,1583,310,394630,1273,0
149592,1657,315,422730,1342,0
149612,821,143,96954,678,0
149645,548,102,45492,446,0
149654,821,143,96954,678,0
149666,1934,345,548205,1589,0
149668,264,56,11648,208,0
149689,107,18,1602,89,0
149709,1876,359,544603,1517,0
149723,660,133,69928,527,0
149724,463,83,31540,380,0
149725,821,143,96954,678,0
149738,346,76,20520,270,0
149740,362,69,20217,293,0
149749,1181,246,230010,935,0
149769,950,193,146101,757,0
149770,976,180,143280,796,0
149773,1558,313,389685,1245,0
149783,495,87,35496,408,0
149785,714,137,79049,577,0
149803,15,6,54,9,0
149807,155,35,4200,120,0
149811,568,114,51756,454,0
149825,1552,299,374647,1253,0
149835,25,5,100,20,0
149836,950,193,146101,757,0
149855,282,50,11600,232,0
149856,595,120,57000,475,0
149868,113,20,1860,93,0
149883,2102,402,683400,1700,0
149905,971,184,144808,787,0
149909,595,121,57354,474,0
149917,836,151,103435,685,0
149932,72,13,767,59,0
149954,1411,281,317530,1130,0
149963,539,101,44238,438,0
149972,1342,282,298920,1060,0
149978,186,35,5285,151,0
149981,33,8,200,25,0
149982,62,16,736,46,0
149992,767,144,89712,623,0
149997,1204,251,239203,953,0
150012,1934,345,548205,1589,0
150047,70,12,696,58,0
150050,821,143,96954,678,0
150065,976,180,143280,796,0
150090,18,6,72,12,0
150094,410,76,25384,334,0
150104,1552,299,374647,1253,0
150115,1934,345,548205,1589,0
150136,1829,353,521028,1476,0
150137,778,163,100245,615,0
150146,1331,255,274380,1076,0
150148,1583,310,394630,1273,0
150149,227,44,8052,183,0
150162,714,137,79049,577,0
150169,72,14,812,58,0
150170,700,128,73216,572,0
150180,767,144,89712,623,0
150191,1934,345,548205,1589,0
150194,660,133,69928,527,0
150199,346,76,20520,270,0
150206,1541,306,377910,1235,0
150208,1934,345,548205,1589,0
150234,551,102,45798,449,0
150249,337,74,19462,263,0
150274,641,131,66810,510,0
150281,1262,259,259777,1003,0
150306,1583,310,394630,1273,0
150320,659,132,69928,527,0
150333,1280,232,243136,1048,0
150338,595,120,57000,475,0
150350,620,121,60379,499,0
150365,155,35,4200,120,0
150389,700,128,73216,572,0
150395,1331,255,274380,1076,0
150399,2102,402,683400,1700,0
150405,120,24,2304,96,0
150408,1541,306,377910,1235,0
150412,97,22,1650,75,0
150415,932,168,128352,764,0
150421,971,184,144808,787,0
150422,1411,281,317530,1130,0
150429,865,167,116566,698,0
150431,68,12,672,56,0
150434,1204,251,239203,953,0
150442,2102,402,683400,1700,0
150448,1934,345,548205,1589,0
150449,1558,313,389685,1245,0
150457,1181,246,230010,935,0
150464,2102,402,683400,1700,0
150473,134,30,3120,104,0
150487,1411,281,317530,1130,0
150521,175,29,4234,146,0
150540,620,121,60379,499,0
150546,793,158,100330,635,0
150549,571,114,52098,457,0
150562,410,76,25384,334,0
150574,539,101,44238,438,0
150611,365,74,21534,291,0
150621,595,121,57354,474,0
150626,778,163,100245,615,0
150658,194,39,6045,155,0
150663,1331,255,274380,1076,0
150667,976,180,143280,796,0
150674,37,10,270,27,0
150676,102,20,1640,82,0
150685,317,63,16002,254,0
150688,976,180,143280,796,0
150690,1078,198,174240,880,0
150691,660,133,69928,527,0
150734,1280,232,243136,1048,0
150748,379,65,20410,314,0
150751,2102,402,683400,1700,0
150752,821,143,96954,678,0
150756,282,50,11600,232,0
150758,1262,259,259777,1003,0
150777,1025,201,165624,824,0
150779,950,193,146101,757,0
150798,1829,353,521028,1476,0
150802,620,121,60379,499,0
150805,1280,232,243136,1048,0
150809,1541,306,377910,1235,0
150819,1411,281,317530,1130,0
150833,535,94,41454,441,0
150839,37,11,286,26,0
150854,37,5,160,32,0
150897,1876,359,544603,1517,0
150957,595,121,57354,474,0
150965,1411,281,317530,1130,0
150999,2102,402,683400,1700,0
151010,1552,299,374647,1253,0
151012,185,36,5364,149,0
151028,34,7,189,27,0
151041,771,137,86858,634,0
151044,1181,246,230010,935,0
151052,950,193,146101,757,0
151056,2102,402,683400,1700,0
151075,26,8,144,18,0
151088,836,151,103435,685,0
151093,1078,198,174240,880,0
151096,1331,255,274380,1076,0
151100,127,29,2842,98,0
151110,660,133,69928,527,0
151135,1541,306,377910,1235,0
151142,68,15,795,53,0
151150,120,24,2304,96,0
151160,821,143,96954,678,0
151162,950,193,146101,757,0
151163,950,193,146101,757,0
151185,1411,281,317530,1130,0
151196,700,128,73216,572,0
151213,1829,353,521028,1476,0
151243,552,113,49607,439,0
151258,1296,252,263088,1044,0
151288,1558,313,389685,1245,0
151292,1541,306,377910,1235,0
151293,659,132,69928,527,0
151309,1331,255,274380,1076,0
151310,641,131,66810,510,0
151313,1558,313,389685,1245,0
151322,497,97,38800,400,0
151332,551,102,45798,449,0
151353,415,75,25500,340,0
151379,1876,359,544603,1517,0
151389,1181,246,230010,935,0
151408,274,57,12369,217,0
151417,155,35,4200,120,0
151418,362,69,20217,293,0
151429,1541,306,377910,1235,0
151469,144,29,3335,115,0
151486,61,13,624,48,0
151515,793,158,100330,635,0
151518,1657,315,422730,1342,0
151529,1342,282,298920,1060,0
151547,971,184,144808,787,0
151549,1342,282,298920,1060,0
151552,1342,282,298920,1060,0
151555,385,71,22294,314,0
151556,1262,259,259777,1003,0
151561,1558,313,389685,1245,0
151562,23,6,102,17,0
151565,410,76,25384,334,0
151573,1411,281,317530,1130,0
151576,121,27,2538,94,0
151589,1829,353,521028,1476,0
151597,134,30,3120,104,0
151617,714,137,79049,577,0
151623,62,16,736,46,0
151633,160,32,4096,128,0
151638,77,18,1062,59,0
151654,976,180,143280,796,0
151656,1411,281,317530,1130,0
151660,568,114,51756,454,0
151673,366,70,20720,296,0
151681,551,102,45798,449,0
151685,714,137,79049,577,0
151696,1331,255,274380,1076,0
151711,1411,281,317530,1130,0
151721,1934,345,548205,1589,0
151727,1552,299,374647,1253,0
151735,497,97,38800,400,0
151739,410,76,25384,334,0
151755,155,34,4114,121,0
151786,137,25,2800,112,0
151787,1204,251,239203,953,0
151790,516,103,42539,413,0
151794,932,168,128352,764,0
151808,1541,306,377910,1235,0
151819,1558,313,389685,1245,0
151841,539,101,44238,438,0
151854,836,151,103435,685,0
151856,1541,306,377910,1235,0
151868,1934,345,548205,1589,0
151873,61,13,624,48,0
151877,1552,299,374647,1253,0
151878,641,131,66810,510,0
151903,127,29,2842,98,0
151909,156,34,4148,122,0
151975,1876,359,544603,1517,0
151982,321,54,14418,267,0
151985,932,168,128352,764,0
151986,836,151,103435,685,0
152006,1204,251,239203,953,0
152013,976,180,143280,796,0
152028,1558,313,389685,1245,0
152029,552,113,49607,439,0
152042,1541,306,377910,1235,0
152043,1876,359,544603,1517,0
152071,836,151,103435,685,0
152072,1657,315,422730,1342,0
152082,1204,251,239203,953,0
152110,61,13,624,48,0
152111,122,22,2200,100,0
152115,771,137,86858,634,0
152116,1583,310,394630,1273,0
152120,401,77,24948,324,0
152121,2102,402,683400,1700,0
152130,305,70,16450,235,0
152133,89,15,1110,74,0
152145,932,168,128352,764,0
152148,2102,402,683400,1700,0
152203,1558,313,389685,1245,0
152204,1558,313,389685,1245,0
152226,1934,345,548205,1589,0
152253,950,193,146101,757,0
152259,113,24,2136,89,0
152262,714,137,79049,577,0
152263,227,44,8052,183,0
152275,1558,313,389685,1245,0
152286,950,193,146101,757,0
152294,135,30,3150,105,0
152300,1583,310,394630,1273,0
152309,171,35,4760,136,0
152331,104,16,1408,88,0
152338,379,65,20410,314,0
152375,568,114,51756,454,0
152414,865,167,116566,698,0
152424,571,114,52098,457,0
152437,552,113,49607,439,0
152440,572,130,57460,442,0
152447,365,74,21534,291,0
152456,1541,306,377910,1235,0
152458,821,171,111150,650,0
152467,700,128,73216,572,0
152479,1876,359,544603,1517,0
152482,976,180,143280,796,0
152502,865,167,116566,698,0
152525,571,114,52098,457,0
152526,171,35,4760,136,0
152529,64,15,735,49,0
152558,1558,313,389685,1245,0
152561,950,193,146101,757,0
152572,1657,315,422730,1342,0
152581,1558,313,389685,1245,0
152590,1541,306,377910,1235,0
152615,1331,255,274380,1076,0
152620,516,103,42539,413,0
152630,174,36,4968,138,0
152660,2102,402,683400,1700,0
152668,793,158,100330,635,0
152674,463,83,31540,380,0
152675,950,193,146101,757,0
152676,1541,306,377910,1235,0
152692,60,12,576,48,0
152703,17,6,66,11,0
152715,1342,282,298920,1060,0
152717,1829,353,521028,1476,0
152729,52,10,420,42,0
152745,572,130,57460,442,0
152747,18,5,65,13,0
152760,1181,246,230010,935,0
152764,72,14,812,58,0
152771,1342,282,298920,1060,0
152773,7,2,10,5,0
152806,551,102,45798,449,0
152812,68,15,795,53,0
152817,1541,306,377910,1235,0
152827,660,133,69928,527,0
152833,836,151,103435,685,0
152835,516,103,42539,413,0
152841,1829,353,521028,1476,0
152849,207,41,6806,166,0
152853,113,20,1860,93,0
152859,1411,281,317530,1130,0
152862,1541,306,377910,1235,0
152868,535,94,41454,441,0
152885,767,144,89712,623,0
152889,360,66,19404,294,0
152890,1331,255,274380,1076,0
152895,1541,306,377910,1235,0
152897,819,152,101384,667,0
152901,101,20,1620,81,0
152906,1280,232,243136,1048,0
152916,641,131,66810,510,0
152964,155,27,3456,128,0
152966,1657,315,422730,1342,0
152968,1583,310,394630,1273,0
152979,373,74,22126,299,0
152984,821,171,111150,650,0
152993,516,103,42539,413,0
153012,971,184,144808,787,0
153015,12,2,20,10,0
153019,568,114,51756,454,0
153020,88,17,1207,71,0
153025,1342,282,298920,1060,0
153032,819,152,101384,667,0
153047,121,27,2538,94,0
153108,174,36,4968,138,0
153117,1262,259,259777,1003,0
153126,405,82,26486,323,0
153130,1583,310,394630,1273,0
153147,119,22,2134,97,0
153149,160,32,4096,128,0
153151,641,131,66810,510,0
153161,700,128,73216,572,0
153163,1552,299,374647,1253,0
153170,443,85,30430,358,0
153178,410,76,25384,334,0
153182,2102,402,683400,1700,0
153187,2102,402,683400,1700,0
153192,659,132,69928,527,0
153220,410,76,25384,334,0
153229,1876,359,544603,1517,0
153234,362,69,20217,293,0
153246,1262,259,259777,1003,0
153282,1657,315,422730,1342,0
153298,282,50,11600,232,0
153303,24,6,108,18,0
153325,1552,299,374647,1253,0
153352,1342,282,298920,1060,0
153366,48,10,380,38,0
153367,971,184,144808,787,0
153370,516,103,42539,413,0
153392,14,3,33,11,0
153402,273,58,12470,215,0
153407,976,180,143280,796,0
153408,1583,310,394630,1273,0
153428,1411,281,317530,1130,0
153435,1552,299,374647,1253,0
153448,1876,359,544603,1517,0
153481,1280,232,243136,1048,0
153490,568,114,51756,454,0
153508,186,35,5285,151,0
153542,1657,315,422730,1342,0
153549,595,120,57000,475,0
153555,1934,345,548205,1589,0
153576,2102,402,683400,1700,0
153645,1296,252,263088,1044,0
153672,1280,232,243136,1048,0
153674,1541,306,377910,1235,0
153698,1552,299,374647,1253,0
153701,274,57,12369,217,0
153724,373,74,22126,299,0
153729,819,152,101384,667,0
153738,106,19,1653,87,0
153740,324,67,17219,257,0
153742,34,7,189,27,0
153758,415,75,25500,340,0
153761,1552,299,374647,1253,0
153775,1280,232,243136,1048,0
153788,1552,299,374647,1253,0
153796,778,163,100245,615,0
153805,976,180,143280,796,0
153829,155,35,4200,120,0
153849,155,35,4200,120,0
153856,26,8,144,18,0
153860,365,74,21534,291,0
153865,305,70,16450,235,0
153887,1078,198,174240,880,0
153913,535,94,41454,441,0
153914,1583,310,394630,1273,0
153920,1876,359,544603,1517,0
153921,1262,259,259777,1003,0
153936,1262,259,259777,1003,0
153941,415,75,25500,340,0
153954,405,82,26486,323,0
153959,767,144,89712,623,0
153964,1331,255,274380,1076,0
153977,568,114,51756,454,0
153980,1934,345,548205,1589,0
153996,321,54,14418,267,0
153997,405,82,26486,323,0
154036,1934,345,548205,1589,0
154055,1541,306,377910,1235,0
154064,1876,359,544603,1517,0
154069,568,114,51756,454,0
154085,1342,282,298920,1060,0
154087,1181,246,230010,935,0
154090,534,102,44064,432,0
154105,105,22,1826,83,0
154110,2102,402,683400,1700,0
154125,1934,345,548205,1589,0
154129,821,171,111150,650,0
154137,595,120,57000,475,0
154139,61,13,624,48,0
154149,568,114,51756,454,0
154166,175,29,4234,146,0
154170,2102,402,683400,1700,0
154180,976,180,143280,796,0
154188,122,25,2425,97,0
154197,20,5,75,15,0
154251,164,34,4420,130,0
154263,551,102,45798,449,0
154265,539,101,44238,438,0
154267,793,158,100330,635,0
154273,315,56,14504,259,0
154278,1829,353,521028,1476,0
154286,1296,252,263088,1044,0
154300,88,17,1207,71,0
154307,568,114,51756,454,0
154311,60,12,576,48,0
154316,102,20,1640,82,0
154318,1025,201,165624,824,0
154320,1331,255,274380,1076,0
154323,976,180,143280,796,0
154346,1829,353,521028,1476,0
154347,572,130,57460,442,0
154350,1829,353,521028,1476,0
154364,568,114,51756,454,0
154381,819,152,101384,667,0
154390,836,151,103435,685,0
154428,1552,299,374647,1253,0
154442,1342,282,298920,1060,0
154466,1204,251,239203,953,0
154469,793,158,100330,635,0
154481,395,72,23256,323,0
154489,346,76,20520,270,0
154492,1829,353,521028,1476,0
154499,971,184,144808,787,0
154501,1657,315,422730,1342,0
154518,217,44,7612,173,0
154533,595,120,57000,475,0
154549,1331,255,274380,1076,0
154554,198,43,6665,155,0
154557,1296,252,263088,1044,0
154590,1876,359,544603,1517,0
154606,410,76,25384,334,0
154616,641,131,66810,510,0
154639,1342,282,298920,1060,0
154644,1262,259,259777,1003,0
154649,1829,353,521028,1476,0
154656,1280,232,243136,1048,0
154679,595,120,57000,475,0
154689,595,120,57000,475,0
154696,1583,310,394630,1273,0
154702,274,57,12369,217,0
154713,1280,232,243136,1048,0
154719,360,66,19404,294,0
154726,127,29,2842,98,0
154756,68,15,795,53,0
154759,1541,306,377910,1235,0
154763,1262,259,259777,1003,0
154782,1280,232,243136,1048,0
154792,767,144,89712,623,0
154806,1296,252,263088,1044,0
154808,44,9,315,35,0
154815,1296,252,263088,1044,0
154823,1829,353,521028,1476,0
154825,548,102,45492,446,0
154839,1181,246,230010,935,0
154863,360,66,19404,294,0
154865,1280,232,243136,1048,0
154869,1558,313,389685,1245,0
154881,1876,359,544603,1517,0
154901,1558,313,389685,1245,0
154903,2102,402,683400,1700,0
154906,2102,402,683400,1700,0
154916,101,20,1620,81,0
154922,1552,299,374647,1253,0
154931,1280,232,243136,1048,0
154936,572,130,57460,442,0
154941,1204,251,239203,953,0
154943,1204,251,239203,953,0
154965,44,10,340,34,0
154976,134,30,3120,104,0
154977,793,158,100330,635,0
154984,1262,259,259777,1003,0
154986,122,25,2425,97,0
154993,1342,282,298920,1060,0
155005,568,114,51756,454,0
155026,19,3,48,16,0
155027,700,128,73216,572,0
155048,273,58,12470,215,0
155055,552,113,49607,439,0
155061,660,133,69928,527,0
155073,236,50,9300,186,0
155105,1331,255,274380,1076,0
155109,385,71,22294,314,0
155113,778,163,100245,615,0
155115,1204,251,239203,953,0
155117,148,24,2976,124,0
155125,62,16,736,46,0
155146,1296,252,263088,1044,0
155148,1934,345,548205,1589,0
155164,18,6,72,12,0
155185,1331,255,274380,1076,0
155187,1558,313,389685,1245,0
155202,1934,345,548205,1589,0
155203,2102,402,683400,1700,0
155204,185,36,5364,149,0
155209,282,50,11600,232,0
155211,1552,299,374647,1253,0
155219,321,54,14418,267,0
155223,317,63,16002,254,0
155228,568,114,51756,454,0
155244,410,76,25384,334,0
155245,1552,299,374647,1253,0
155259,1296,252,263088,1044,0
155268,274,57,12369,217,0
155270,568,114,51756,454,0
155275,1204,251,239203,953,0
155282,1558,313,389685,1245,0
155284,793,158,100330,635,0
155315,443,85,30430,358,0
155319,443,85,30430,358,0
155327,641,131,66810,510,0
155340,950,193,146101,757,0
155359,110,18,1656,92,0
155372,1280,232,243136,1048,0
155375,551,102,45798,449,0
155405,1342,282,298920,1060,0
155409,1583,310,394630,1273,0
155416,932,168,128352,764,0
155423,1262,259,259777,1003,0
155432,1876,359,544603,1517,0
155443,1558,313,389685,1245,0
155455,1181,246,230010,935,0
155456,571,114,52098,457,0
155477,714,137,79049,577,0
155493,44,10,340,34,0
155496,122,20,2040,102,0
155502,1342,282,298920,1060,0
155512,1280,232,243136,1048,0
155513,410,76,25384,334,0
155515,415,75,25500,340,0
155520,932,168,128352,764,0
155542,415,75,25500,340,0
155551,1025,201,165624,824,0
155563,88,17,1207,71,0
155567,976,180,143280,796,0
155588,1934,345,548205,1589,0
155591,771,137,86858,634,0
155607,819,152,101384,667,0
155622,11,2,18,9,0
155623,1342,282,298920,1060,0
155629,1829,353,521028,1476,0
155632,1078,198,174240,880,0
155665,1876,359,544603,1517,0
155681,2102,402,683400,1700,0
155688,714,137,79049,577,0
155693,1583,310,394630,1273,0
155719,175,29,4234,146,0
155730,410,76,25384,334,0
155734,620,121,60379,499,0
155736,1262,259,259777,1003,0
155739,1657,315,422730,1342,0
155741,164,34,4420,130,0
155776,551,102,45798,449,0
155781,1657,315,422730,1342,0
155798,65,13,676,52,0
155806,362,69,20217,293,0
155823,821,171,111150,650,0
155849,15,6,54,9,0
155855,778,163,100245,615,0
155875,971,184,144808,787,0
155877,323,55,14740,268,0
155880,1025,201,165624,824,0
155883,1657,315,422730,1342,0
155891,1934,345,548205,1589,0
155893,793,158,100330,635,0
155896,113,20,1860,93,0
155902,174,36,4968,138,0
155903,950,193,146101,757,0
155904,305,70,16450,235,0
155912,552,113,49607,439,0
155924,1342,282,298920,1060,0
155935,950,193,146101,757,0
155948,1829,353,521028,1476,0
155959,135,30,3150,105,0
155986,1204,251,239203,953,0
156011,120,24,2304,96,0
156018,1262,259,259777,1003,0
156028,1829,353,521028,1476,0
156084,1342,282,298920,1060,0
156130,58,15,645,43,0
156131,1934,345,548205,1589,0
156132,1876,359,544603,1517,0
156146,360,66,19404,294,0
156159,1262,259,259777,1003,0
156184,1262,259,259777,1003,0
156187,395,72,23256,323,0
156189,793,158,100330,635,0
156191,124,28,2688,96,0
156194,819,152,101384,667,0
156204,1296,252,263088,1044,0
156220,89,15,1110,74,0
156225,68,15,795,53,0
156245,1181,246,230010,935,0
156270,1829,353,521028,1476,0
156271,1552,299,374647,1253,0
156272,714,137,79049,577,0
156293,362,69,20217,293,0
156331,373,74,22126,299,0
156334,1262,259,259777,1003,0
156345,1829,353,521028,1476,0
156355,1342,282,298920,1060,0
156380,207,41,6806,166,0
156394,821,171,111150,650,0
156429,185,36,5364,149,0
156443,1411,281,317530,1130,0
156450,535,94,41454,441,0
156474,516,103,42539,413,0
156487,1829,353,521028,1476,0
156501,443,85,30430,358,0
156502,793,158,100330,635,0
156503,1934,345,548205,1589,0
156525,2102,402,683400,1700,0
156532,548,102,45492,446,0
156548,54,14,560,40,0
156556,714,137,79049,577,0
156559,1331,255,274380,1076,0
156562,1262,259,259777,1003,0
156596,552,113,49607,439,0
156603,1876,359,544603,1517,0
156615,1078,198,174240,880,0
156648,1204,251,239203,953,0
156650,1411,281,317530,1130,0
156651,131,21,2310,110,0
156680,595,120,57000,475,0
156688,70,12,696,58,0
156691,362,69,20217,293,0
156697,1331,255,274380,1076,0
156707,131,25,2650,106,0
156778,793,158,100330,635,0
156780,193,39,6006,154,0
156786,821,171,111150,650,0
156790,1876,359,544603,1517,0
156795,821,143,96954,678,0
156834,160,29,3799,131,0
156842,1876,359,544603,1517,0
156843,1552,299,374647,1253,0
156866,1583,310,394630,1273,0
156871,146,34,3808,112,0
156890,1078,198,174240,880,0
156902,660,133,69928,527,0
156908,568,114,51756,454,0
156909,1934,345,548205,1589,0
156916,1342,282,298920,1060,0
156922,571,114,52098,457,0
156956,273,58,12470,215,0
156970,71,15,840,56,0
156975,415,75,25500,340,0
157013,950,193,146101,757,0
157029,198,43,6665,155,0
157039,198,43,6665,155,0
157052,282,50,11600,232,0
157055,1657,315,422730,1342,0
157076,120,24,2304,96,0
157084,1411,281,317530,1130,0
157097,1204,251,239203,953,0
157098,1552,299,374647,1253,0
157108,1280,232,243136,1048,0
157109,1876,359,544603,1517,0
157119,379,65,20410,314,0
157120,1411,281,317530,1130,0
157155,32,6,156,26,0
157177,497,97,38800,400,0
157183,9,2,14,7,0
157211,2102,402,683400,1700,0
157217,1280,232,243136,1048,0
157223,548,102,45492,446,0
157230,1204,251,239203,953,0
157252,2102,402,683400,1700,0
157269,14,3,33,11,0
157273,366,70,20720,296,0
157277,337,74,19462,263,0
157281,1657,315,422730,1342,0
157302,771,137,86858,634,0
157343,1876,359,544603,1517,0
157345,1204,251,239203,953,0
157353,155,35,4200,120,0
157361,539,101,44238,438,0
157366,836,151,103435,685,0
157372,1262,259,259777,1003,0
157380,380,76,23104,304,0
157381,535,94,41454,441,0
157393,57,7,350,50,0
157399,16,4,48,12,0
157408,568,114,51756,454,0
157427,1541,306,377910,1235,0
157433,1025,201,165624,824,0
157436,1876,359,544603,1517,0
157453,1280,232,243136,1048,0
157456,395,72,23256,323,0
157467,365,74,21534,291,0
157471,1829,353,521028,1476,0
157473,77,12,780,65,0
157493,380,76,23104,304,0
157498,1541,306,377910,1235,0
157504,1025,201,165624,824,0
157511,1296,252,263088,1044,0
157525,48,10,380,38,0
157536,13,2,22,11,0
157537,1342,282,298920,1060,0
157539,1296,252,263088,1044,0
157547,193,39,6006,154,0
157552,282,50,11600,232,0
157564,595,121,57354,474,0
157580,595,120,57000,475,0
157598,1411,281,317530,1130,0
157600,971,184,144808,787,0
157635,105,22,1826,83,0
157636,156,34,4148,122,0
157650,273,58,12470,215,0
157658,2102,402,683400,1700,0
157664,1552,299,374647,1253,0
157678,641,131,66810,510,0
157682,1181,246,230010,935,0
157684,1541,306,377910,1235,0
157687,778,163,100245,615,0
157704,595,120,57000,475,0
157726,185,36,5364,149,0
157750,767,144,89712,623,0
157755,1657,315,422730,1342,0
157761,274,57,12369,217,0
157763,865,167,116566,698,0
157784,274,57,12369,217,0
157815,46,9,333,37,0
157826,346,76,20520,270,0
157830,771,137,86858,634,0
157832,1876,359,544603,1517,0
157841,568,114,51756,454,0
157849,2102,402,683400,1700,0
157859,572,130,57460,442,0
157862,1934,345,548205,1589,0
157878,1296,252,263088,1044,0
157898,865,167,116566,698,0
157911,1280,232,243136,1048,0
157920,112,18,1692,94,0
157927,1876,359,544603,1517,0
157929,1583,310,394630,1273,0
157942,1262,259,259777,1003,0
157947,793,158,100330,635,0
157953,778,163,100245,615,0
157957,1411,281,317530,1130,0
157980,1876,359,544603,1517,0
157983,2102,402,683400,1700,0
157991,155,35,4200,120,0
158009,1552,299,374647,1253,0
158013,274,57,12369,217,0
158032,346,76,20520,270,0
158092,714,137,79049,577,0
158141,821,143,96954,678,0
158144,1262,259,259777,1003,0
158174,323,55,14740,268,0
158196,1280,232,243136,1048,0
158198,1657,315,422730,1342,0
158209,36,10,260,26,0
158210,175,29,4234,146,0
158223,273,58,12470,215,0
158266,1262,259,259777,1003,0
158269,1583,310,394630,1273,0
158272,571,114,52098,457,0
158278,16,3,39,13,0
158282,236,50,9300,186,0
158287,415,75,25500,340,0
158288,1331,255,274380,1076,0
158293,700,128,73216,572,0
158300,1204,251,239203,953,0
158304,155,35,4200,120,0
158308,1583,310,394630,1273,0
158312,836,151,103435,685,0
158326,660,133,69928,527,0
158389,70,12,696,58,0
158400,595,120,57000,475,0
158410,127,29,2842,98,0
158424,552,113,49607,439,0
158449,1829,353,521028,1476,0
158472,496,132,34674,364,15228
158508,198,198,0,0,0
158511,39,39,0,0,0
158522,251,251,0,0,0
158553,28,28,0,0,0
158561,282,282,0,0,0
158570,310,310,0,0,0
158572,58,58,0,0,0
158585,120,120,0,0,0
158588,22,22,0,0,0
158595,102,102,0,0,0
158600,193,193,0,0,0
158603,36,36,0,0,0
158609,74,74,0,0,0
158610,97,97,0,0,0
158611,281,281,0,0,0
158617,85,85,0,0,0
158628,255,255,0,0,0
158649,167,167,0,0,0
158650,313,313,0,0,0
158660,180,180,0,0,0
158662,251,251,0,0,0
158666,310,310,0,0,0
158669,55,55,0,0,0
158700,131,131,0,0,0
158712,282,282,0,0,0
158718,27,27,0,0,0
158720,259,259,0,0,0
158737,13,13,0,0,0
158752,3,3,0,0,0
158767,281,281,0,0,0
158771,345,345,0,0,0
158799,152,152,0,0,0
158815,76,76,0,0,0
158827,402,402,0,0,0
158833,19,19,0,0,0
158839,50,50,0,0,0
158847,143,143,0,0,0
158898,345,345,0,0,0
158903,345,345,0,0,0
158940,30,30,0,0,0
158942,158,158,0,0,0
158951,402,402,0,0,0
159036,120,120,0,0,0
159044,24,24,0,0,0
159052,353,353,0,0,0
159054,18,18,0,0,0
159070,19,19,0,0,0
159075,3,3,0,0,0
159095,193,193,0,0,0
159096,128,128,0,0,0
159108,143,143,0,0,0
159115,281,281,0,0,0
159136,15,15,0,0,0
159142,144,144,0,0,0
159143,184,184,0,0,0
159154,69,69,0,0,0
159158,55,55,0,0,0
159164,137,137,0,0,0
159166,74,74,0,0,0
159169,2,2,0,0,0
159183,102,102,0,0,0
159186,259,259,0,0,0
159187,13,13,0,0,0
159191,163,163,0,0,0
159199,359,359,0,0,0
159218,402,402,0,0,0
159220,8,8,0,0,0
159221,282,282,0,0,0
159241,163,163,0,0,0
159244,315,315,0,0,0
159254,67,67,0,0,0
159261,97,97,0,0,0
159280,402,402,0,0,0
159281,70,70,0,0,0
159292,35,35,0,0,0
159335,232,232,0,0,0
159342,143,143,0,0,0
159345,143,143,0,0,0
159347,158,158,0,0,0
159348,121,121,0,0,0
159368,85,85,0,0,0
159373,137,137,0,0,0
159384,2,2,0,0,0
159394,184,184,0,0,0
159405,83,83,0,0,0
159412,345,345,0,0,0
159436,180,180,0,0,0
159452,9,9,0,0,0
159477,158,158,0,0,0
159481,87,87,0,0,0
159499,4,4,0,0,0
159514,313,313,0,0,0
159515,18,18,0,0,0
159520,19,19,0,0,0
159521,252,252,0,0,0
159532,251,251,0,0,0
159543,259,259,0,0,0
159550,17,17,0,0,0
159572,232,232,0,0,0
159576,72,72,0,0,0
159638,232,232,0,0,0
159646,102,102,0,0,0
159679,102,102,0,0,0
159690,310,310,0,0,0
159699,201,201,0,0,0
159711,345,345,0,0,0
159723,34,34,0,0,0
159730,137,137,0,0,0
159752,198,198,0,0,0
159762,114,114,0,0,0
159789,198,198,0,0,0
159791,12,12,0,0,0
159807,252,252,0,0,0
159809,158,158,0,0,0
159812,40,40,0,0,0
159818,246,246,0,0,0
159849,246,246,0,0,0
159855,76,76,0,0,0
159868,359,359,0,0,0
159874,281,281,0,0,0
159897,40,40,0,0,0
159907,359,359,0,0,0
159938,101,101,0,0,0
159959,313,313,0,0,0
159967,5,5,0,0,0
159976,299,299,0,0,0
160001,76,76,0,0,0
160008,315,315,0,0,0
160031,120,120,0,0,0
160040,77,77,0,0,0
160042,310,310,0,0,0
160050,65,65,0,0,0
160072,102,102,0,0,0
160078,103,103,0,0,0
160089,152,152,0,0,0
160091,158,158,0,0,0
160097,168,168,0,0,0
160098,102,102,0,0,0
160119,359,359,0,0,0
160123,6,6,0,0,0
160125,101,101,0,0,0
160138,359,359,0,0,0
160161,87,87,0,0,0
160166,22,22,0,0,0
160177,345,345,0,0,0
160187,94,94,0,0,0
160190,102,102,0,0,0
160200,167,167,0,0,0
160203,345,345,0,0,0
160205,22,22,0,0,0
160211,29,29,0,0,0
160218,163,163,0,0,0
160235,137,137,0,0,0
160253,85,85,0,0,0
160272,167,167,0,0,0
160301,7,7,0,0,0
160319,167,167,0,0,0
160322,402,402,0,0,0
160337,56,56,0,0,0
160339,184,184,0,0,0
160340,198,198,0,0,0
160344,77,77,0,0,0
160351,35,35,0,0,0
160357,193,193,0,0,0
160384,402,402,0,0,0
160390,8,8,0,0,0
160408,306,306,0,0,0
160413,353,353,0,0,0
160417,3,3,0,0,0
160425,259,259,0,0,0
160427,259,259,0,0,0
160435,246,246,0,0,0
160452,299,299,0,0,0
160464,65,65,0,0,0
160473,201,201,0,0,0
160475,17,17,0,0,0
160478,16,16,0,0,0
160494,255,255,0,0,0
160499,184,184,0,0,0
160501,310,310,0,0,0
160543,137,137,0,0,0
160546,402,402,0,0,0
160566,54,54,0,0,0
160567,359,359,0,0,0
160572,167,167,0,0,0
160582,359,359,0,0,0
160583,152,152,0,0,0
160584,168,168,0,0,0
160604,252,252,0,0,0
160614,102,102,0,0,0
160615,133,133,0,0,0
160623,76,76,0,0,0
160626,232,232,0,0,0
160633,313,313,0,0,0
160685,19,19,0,0,0
160690,193,193,0,0,0
160727,94,94,0,0,0
160730,345,345,0,0,0
160742,25,25,0,0,0
160777,65,65,0,0,0
160787,168,168,0,0,0
160799,85,85,0,0,0
160814,67,67,0,0,0
160836,168,168,0,0,0
160842,76,76,0,0,0
160851,151,151,0,0,0
160866,75,75,0,0,0
160872,306,306,0,0,0
160891,35,35,0,0,0
160906,121,121,0,0,0
160919,158,158,0,0,0
160940,25,25,0,0,0
160992,246,246,0,0,0
160993,70,70,0,0,0
160996,281,281,0,0,0
160998,232,232,0,0,0
161000,10,10,0,0,0
161002,35,35,0,0,0
161010,102,102,0,0,0
161012,44,44,0,0,0
161020,184,184,0,0,0
161022,353,353,0,0,0
161026,103,103,0,0,0
161034,15,15,0,0,0
161046,34,34,0,0,0
161049,359,359,0,0,0
161054,198,198,0,0,0
161059,34,34,0,0,0
161060,180,180,0,0,0
161068,137,137,0,0,0
161095,353,353,0,0,0
161106,152,152,0,0,0
161109,75,75,0,0,0
161110,15,15,0,0,0
161114,193,193,0,0,0
161134,76,76,0,0,0
161139,198,198,0,0,0
161150,35,35,0,0,0
161156,65,65,0,0,0
161190,345,345,0,0,0
161193,50,50,0,0,0
161202,120,120,0,0,0
161223,251,251,0,0,0
161233,15,15,0,0,0
161249,282,282,0,0,0
161260,246,246,0,0,0
161268,55,55,0,0,0
161288,201,201,0,0,0
161294,353,353,0,0,0
161301,167,167,0,0,0
161305,97,97,0,0,0
161311,76,76,0,0,0
161339,345,345,0,0,0
161346,103,103,0,0,0
161350,315,315,0,0,0
161353,29,29,0,0,0
161355,44,44,0,0,0
161358,76,76,0,0,0
161368,76,76,0,0,0
161377,25,25,0,0,0
161384,29,29,0,0,0
161387,246,246,0,0,0
161389,39,39,0,0,0
161396,34,34,0,0,0
161408,168,168,0,0,0
161426,180,180,0,0,0
161435,74,74,0,0,0
161440,45,45,0,0,0
161445,113,113,0,0,0
161464,306,306,0,0,0
161467,167,167,0,0,0
161488,252,252,0,0,0
161497,57,57,0,0,0
161504,151,151,0,0,0
161510,359,359,0,0,0
161531,5,5,0,0,0
161538,17,17,0,0,0
161539,12,12,0,0,0
161563,27,27,0,0,0
161566,15,15,0,0,0
161567,313,313,0,0,0
161571,130,130,0,0,0
161576,315,315,0,0,0
161579,299,299,0,0,0
161608,259,259,0,0,0
161609,130,130,0,0,0
161617,6,6,0,0,0
161622,19,19,0,0,0
161626,345,345,0,0,0
161630,121,121,0,0,0
161661,76,76,0,0,0
161671,34,34,0,0,0
161675,102,102,0,0,0
161678,402,402,0,0,0
161683,63,63,0,0,0
161691,313,313,0,0,0
161708,74,74,0,0,0
161713,130,130,0,0,0
161722,8,8,0,0,0
161738,359,359,0,0,0
161740,313,313,0,0,0
161745,97,97,0,0,0
161747,1,1,0,0,0
161756,255,255,0,0,0
161758,8,8,0,0,0
161771,76,76,0,0,0
161774,255,255,0,0,0
161777,114,114,0,0,0
161781,310,310,0,0,0
161790,310,310,0,0,0
161804,252,252,0,0,0
161813,255,255,0,0,0
161818,402,402,0,0,0
161824,282,282,0,0,0
161832,151,151,0,0,0
161861,259,259,0,0,0
161870,130,130,0,0,0
161874,313,313,0,0,0
161888,57,57,0,0,0
161899,133,133,0,0,0
161905,39,39,0,0,0
161927,299,299,0,0,0
161928,310,310,0,0,0
161931,121,121,0,0,0
161943,130,130,0,0,0
161950,130,130,0,0,0
161952,315,315,0,0,0
161960,180,180,0,0,0
161985,77,77,0,0,0
161992,251,251,0,0,0
161999,70,70,0,0,0
162001,55,55,0,0,0
162021,193,193,0,0,0
162034,137,137,0,0,0
162041,144,144,0,0,0
162050,20,20,0,0,0
162059,167,167,0,0,0
162069,167,167,0,0,0
162098,87,87,0,0,0
162099,66,66,0,0,0
162112,7,7,0,0,0
162113,198,198,0,0,0
162123,315,315,0,0,0
162125,313,313,0,0,0
162163,315,315,0,0,0
162169,65,65,0,0,0
162178,232,232,0,0,0
162185,168,168,0,0,0
162188,345,345,0,0,0
162200,171,171,0,0,0
162213,345,345,0,0,0
162248,158,158,0,0,0
162251,246,246,0,0,0
162260,315,315,0,0,0
162267,168,168,0,0,0
162269,83,83,0,0,0
162294,15,15,0,0,0
162301,15,15,0,0,0
162303,359,359,0,0,0
162321,255,255,0,0,0
162348,103,103,0,0,0
162364,359,359,0,0,0
162369,130,130,0,0,0
162373,345,345,0,0,0
162390,353,353,0,0,0
162393,299,299,0,0,0
162419,39,39,0,0,0
162423,306,306,0,0,0
162442,67,67,0,0,0
162495,232,232,0,0,0
162513,180,180,0,0,0
162524,14,14,0,0,0
162534,198,198,0,0,0
162550,306,306,0,0,0
162552,133,133,0,0,0
162570,56,56,0,0,0
162574,74,74,0,0,0
162583,168,168,0,0,0
162592,67,67,0,0,0
162599,128,128,0,0,0
162606,137,137,0,0,0
162618,114,114,0,0,0
162628,83,83,0,0,0
162639,74,74,0,0,0
162651,306,306,0,0,0
162664,43,43,0,0,0
162687,137,137,0,0,0
162690,67,67,0,0,0
162700,299,299,0,0,0
162703,353,353,0,0,0
162706,97,97,0,0,0
162712,11,11,0,0,0
162724,121,121,0,0,0
162732,184,184,0,0,0
162734,353,353,0,0,0
162752,76,76,0,0,0
162772,69,69,0,0,0
162797,310,310,0,0,0
162798,6,6,0,0,0
162814,255,255,0,0,0
162819,44,44,0,0,0
162835,143,143,0,0,0
162858,120,120,0,0,0
162864,201,201,0,0,0
162866,13,13,0,0,0
162868,87,87,0,0,0
162891,313,313,0,0,0
162933,50,50,0,0,0
162958,353,353,0,0,0
162971,259,259,0,0,0
162986,121,121,0,0,0
163008,76,76,0,0,0
163019,13,13,0,0,0
163028,143,143,0,0,0
163057,345,345,0,0,0
163066,35,35,0,0,0
163072,12,12,0,0,0
163134,11,11,0,0,0
163159,158,158,0,0,0
163160,152,152,0,0,0
163166,299,299,0,0,0
163192,402,402,0,0,0
163229,201,201,0,0,0
163244,345,345,0,0,0
163248,306,306,0,0,0
163251,345,345,0,0,0
163252,8,8,0,0,0
163253,252,252,0,0,0
163266,345,345,0,0,0
163274,50,50,0,0,0
163307,198,198,0,0,0
163309,65,65,0,0,0
163320,313,313,0,0,0
163325,121,121,0,0,0
163326,7,7,0,0,0
163337,184,184,0,0,0
163352,184,184,0,0,0
163353,201,201,0,0,0
163359,56,56,0,0,0
163364,82,82,0,0,0
163374,281,281,0,0,0
163388,168,168,0,0,0
163399,9,9,0,0,0
163403,310,310,0,0,0
163418,359,359,0,0,0
163419,102,102,0,0,0
163426,76,76,0,0,0
163438,310,310,0,0,0
163452,251,251,0,0,0
163467,259,259,0,0,0
163468,65,65,0,0,0
163486,25,25,0,0,0
163502,310,310,0,0,0
163506,128,128,0,0,0
163519,137,137,0,0,0
163522,6,6,0,0,0
163538,184,184,0,0,0
163576,72,72,0,0,0
163579,251,251,0,0,0
163587,22,22,0,0,0
163603,25,25,0,0,0
163607,32,32,0,0,0
163617,130,130,0,0,0
163623,83,83,0,0,0
163648,281,281,0,0,0
163665,144,144,0,0,0
163666,315,315,0,0,0
163673,167,167,0,0,0
163675,12,12,0,0,0
163684,103,103,0,0,0
163707,128,128,0,0,0
163759,353,353,0,0,0
163765,67,67,0,0,0
163776,10,10,0,0,0
163788,259,259,0,0,0
163796,345,345,0,0,0
163800,359,359,0,0,0
163805,6,6,0,0,0
163827,180,180,0,0,0
163833,201,201,0,0,0
163839,19,19,0,0,0
163846,310,310,0,0,0
163857,114,114,0,0,0
163861,77,77,0,0,0
163874,22,22,0,0,0
163885,17,17,0,0,0
163892,4,4,0,0,0
163910,315,315,0,0,0
163935,282,282,0,0,0
163986,158,158,0,0,0
163991,32,32,0,0,0
163992,24,24,0,0,0
163996,168,168,0,0,0
164024,121,121,0,0,0
164028,76,76,0,0,0
164029,74,74,0,0,0
164051,310,310,0,0,0
164075,310,310,0,0,0
164082,152,152,0,0,0
164103,87,87,0,0,0
164128,299,299,0,0,0
164138,70,70,0,0,0
164141,58,58,0,0,0
164143,180,180,0,0,0
164169,121,121,0,0,0
164203,313,313,0,0,0
164205,193,193,0,0,0
164216,353,353,0,0,0
164220,120,120,0,0,0
164231,18,18,0,0,0
164261,76,76,0,0,0
164262,56,56,0,0,0
164292,45,45,0,0,0
164295,76,76,0,0,0
164315,313,313,0,0,0
164322,281,281,0,0,0
164328,132,132,0,0,0
164347,133,133,0,0,0
164351,180,180,0,0,0
164356,306,306,0,0,0
164371,152,152,0,0,0
164394,232,232,0,0,0
164415,180,180,0,0,0
164422,259,259,0,0,0
164428,259,259,0,0,0
164438,2,2,0,0,0
164445,198,198,0,0,0
164450,77,77,0,0,0
164478,171,171,0,0,0
164482,345,345,0,0,0
164485,232,232,0,0,0
164489,152,152,0,0,0
164494,102,102,0,0,0
164495,402,402,0,0,0
164534,232,232,0,0,0
164538,299,299,0,0,0
164549,171,171,0,0,0
164552,180,180,0,0,0
164556,1,1,0,0,0
164560,102,102,0,0,0
164564,201,201,0,0,0
164568,17,17,0,0,0
164599,167,167,0,0,0
164606,198,198,0,0,0
164607,137,137,0,0,0
164608,29,29,0,0,0
164610,22,22,0,0,0
164634,198,198,0,0,0
164643,310,310,0,0,0
164656,353,353,0,0,0
164659,353,353,0,0,0
164665,4,4,0,0,0
164668,402,402,0,0,0
164734,44,44,0,0,0
164738,50,50,0,0,0
164787,17,17,0,0,0
164853,299,299,0,0,0
164863,402,402,0,0,0
164875,198,198,0,0,0
164883,34,34,0,0,0
164897,359,359,0,0,0
164905,102,102,0,0,0
164942,71,71,0,0,0
164950,114,114,0,0,0
164977,198,198,0,0,0
164997,4,4,0,0,0
165011,6,6,0,0,0
165029,259,259,0,0,0
165040,359,359,0,0,0
165043,36,36,0,0,0
165049,41,41,0,0,0
165062,232,232,0,0,0
165084,315,315,0,0,0
165102,345,345,0,0,0
165130,259,259,0,0,0
165131,40,40,0,0,0
165141,306,306,0,0,0
165159,259,259,0,0,0
165182,34,34,0,0,0
165194,402,402,0,0,0
165200,74,74,0,0,0
165206,281,281,0,0,0
165221,180,180,0,0,0
165223,168,168,0,0,0
165228,402,402,0,0,0
165237,345,345,0,0,0
165261,180,180,0,0,0
165268,281,281,0,0,0
165270,151,151,0,0,0
165276,76,76,0,0,0
165287,137,137,0,0,0
165294,259,259,0,0,0
165299,232,232,0,0,0
165309,246,246,0,0,0
165313,94,94,0,0,0
165314,259,259,0,0,0
165316,55,55,0,0,0
165331,39,39,0,0,0
165334,4,4,0,0,0
165339,402,402,0,0,0
165341,299,299,0,0,0
165343,94,94,0,0,0
165344,5,5,0,0,0
165347,152,152,0,0,0
165363,144,144,0,0,0
165379,102,102,0,0,0
165382,102,102,0,0,0
165388,29,29,0,0,0
165390,74,74,0,0,0
165400,282,282,0,0,0
165401,8,8,0,0,0
165405,359,359,0,0,0
165429,282,282,0,0,0
165430,402,402,0,0,0
165435,313,313,0,0,0
165456,144,144,0,0,0
165462,282,282,0,0,0
165496,180,180,0,0,0
165497,232,232,0,0,0
165499,130,130,0,0,0
165517,128,128,0,0,0
165550,4,4,0,0,0
165581,402,402,0,0,0
165603,315,315,0,0,0
165607,359,359,0,0,0
165609,137,137,0,0,0
165610,158,158,0,0,0
165613,246,246,0,0,0
165616,131,131,0,0,0
165631,27,27,0,0,0
165634,25,25,0,0,0
165658,313,313,0,0,0
165685,72,72,0,0,0
165708,281,281,0,0,0
165713,246,246,0,0,0
165714,15,15,0,0,0
165734,201,201,0,0,0
165737,22,22,0,0,0
165738,3,3,0,0,0
165754,137,137,0,0,0
165761,143,143,0,0,0
165763,232,232,0,0,0
165765,163,163,0,0,0
165787,70,70,0,0,0
165855,8,8,0,0,0
165879,75,75,0,0,0
165890,359,359,0,0,0
165897,24,24,0,0,0
165903,158,158,0,0,0
165906,25,25,0,0,0
165910,120,120,0,0,0
165917,143,143,0,0,0
165930,402,402,0,0,0
165933,39,39,0,0,0
165939,255,255,0,0,0
165943,306,306,0,0,0
165967,128,128,0,0,0
165977,4,4,0,0,0
165982,143,143,0,0,0
165986,193,193,0,0,0
165995,345,345,0,0,0
166005,306,306,0,0,0
166018,251,251,0,0,0
166026,259,259,0,0,0
166027,63,63,0,0,0
166028,35,35,0,0,0
166041,198,198,0,0,0
166090,36,36,0,0,0
166101,259,259,0,0,0
166106,402,402,0,0,0
166107,158,158,0,0,0
166128,299,299,0,0,0
166130,359,359,0,0,0
166141,193,193,0,0,0
166146,22,22,0,0,0
166158,58,58,0,0,0
166159,163,163,0,0,0
166185,184,184,0,0,0
166206,17,17,0,0,0
166214,8,8,0,0,0
166215,94,94,0,0,0
166223,128,128,0,0,0
166227,310,310,0,0,0
166230,259,259,0,0,0
166234,345,345,0,0,0
166240,50,50,0,0,0
166242,63,63,0,0,0
166252,4,4,0,0,0
166277,94,94,0,0,0
166317,359,359,0,0,0
166320,359,359,0,0,0
166324,282,282,0,0,0
166328,114,114,0,0,0
166346,55,55,0,0,0
166349,39,39,0,0,0
166356,29,29,0,0,0
166366,143,143,0,0,0
166378,137,137,0,0,0
166424,131,131,0,0,0
166440,34,34,0,0,0
166442,252,252,0,0,0
166445,158,158,0,0,0
166461,310,310,0,0,0
166466,359,359,0,0,0
166478,14,14,0,0,0
166483,171,171,0,0,0
166496,102,102,0,0,0
166499,345,345,0,0,0
166505,128,128,0,0,0
166514,158,158,0,0,0
166519,402,402,0,0,0
166537,55,55,0,0,0
166549,44,44,0,0,0
166555,113,113,0,0,0
166561,137,137,0,0,0
166570,171,171,0,0,0
166593,121,121,0,0,0
166599,353,353,0,0,0
166601,167,167,0,0,0
166604,44,44,0,0,0
166612,163,163,0,0,0
166616,402,402,0,0,0
166617,94,94,0,0,0
166623,198,198,0,0,0
166639,120,120,0,0,0
166670,71,71,0,0,0
166684,198,198,0,0,0
166702,41,41,0,0,0
166703,121,121,0,0,0
166714,22,22,0,0,0
166717,359,359,0,0,0
166725,29,29,0,0,0
166745,29,29,0,0,0
166753,281,281,0,0,0
166760,22,22,0,0,0
166762,246,246,0,0,0
166771,21,21,0,0,0
166778,281,281,0,0,0
166798,168,168,0,0,0
166835,310,310,0,0,0
166845,143,143,0,0,0
166853,201,201,0,0,0
166854,56,56,0,0,0
166857,345,345,0,0,0
166861,130,130,0,0,0
166867,102,102,0,0,0
166868,251,251,0,0,0
166874,45,45,0,0,0
166877,76,76,0,0,0
166882,5,5,0,0,0
166887,201,201,0,0,0
166890,6,6,0,0,0
166920,201,201,0,0,0
166921,15,15,0,0,0
166923,259,259,0,0,0
166924,3,3,0,0,0
166925,152,152,0,0,0
166935,44,44,0,0,0
166944,82,82,0,0,0
166964,74,74,0,0,0
166986,180,180,0,0,0
167002,102,102,0,0,0
167012,22,22,0,0,0
167015,282,282,0,0,0
167019,201,201,0,0,0
167049,15,15,0,0,0
167064,10,10,0,0,0
167066,246,246,0,0,0
167075,101,101,0,0,0
167090,246,246,0,0,0
167103,184,184,0,0,0
167125,359,359,0,0,0
167146,87,87,0,0,0
167149,315,315,0,0,0
167154,44,44,0,0,0
167158,36,36,0,0,0
167159,232,232,0,0,0
167165,20,20,0,0,0
167173,71,71,0,0,0
167179,97,97,0,0,0
167186,57,57,0,0,0
167203,281,281,0,0,0
167224,66,66,0,0,0
167241,251,251,0,0,0
167277,151,151,0,0,0
167286,120,120,0,0,0
167312,130,130,0,0,0
167313,345,345,0,0,0
167315,120,120,0,0,0
167329,137,137,0,0,0
167337,4,4,0,0,0
167347,313,313,0,0,0
167352,3,3,0,0,0
167371,313,313,0,0,0
167383,251,251,0,0,0
167384,120,120,0,0,0
167392,402,402,0,0,0
167406,25,25,0,0,0
167409,65,65,0,0,0
167421,75,75,0,0,0
167430,310,310,0,0,0
167463,74,74,0,0,0
167475,65,65,0,0,0
167491,281,281,0,0,0
167497,167,167,0,0,0
167508,6,6,0,0,0
167520,40,40,0,0,0
167525,128,128,0,0,0
167531,55,55,0,0,0
167559,74,74,0,0,0
167560,255,255,0,0,0
167564,359,359,0,0,0
167578,130,130,0,0,0
167586,359,359,0,0,0
167597,345,345,0,0,0
167611,171,171,0,0,0
167616,299,299,0,0,0
167617,72,72,0,0,0
167625,193,193,0,0,0
167629,137,137,0,0,0
167636,121,121,0,0,0
167641,184,184,0,0,0
167649,306,306,0,0,0
167651,102,102,0,0,0
167652,102,102,0,0,0
167673,345,345,0,0,0
167684,313,313,0,0,0
167689,353,353,0,0,0
167692,232,232,0,0,0
167693,121,121,0,0,0
167722,402,402,0,0,0
167723,72,72,0,0,0
167731,180,180,0,0,0
167739,306,306,0,0,0
167744,345,345,0,0,0
167745,114,114,0,0,0
167767,101,101,0,0,0
167768,114,114,0,0,0
167771,252,252,0,0,0
167772,54,54,0,0,0
167774,402,402,0,0,0
167780,144,144,0,0,0
167785,1,1,0,0,0
167786,71,71,0,0,0
167788,29,29,0,0,0
167796,133,133,0,0,0
167800,76,76,0,0,0
167803,255,255,0,0,0
167823,3,3,0,0,0
167824,255,255,0,0,0
167825,102,102,0,0,0
167826,315,315,0,0,0
167846,131,131,0,0,0
167850,8,8,0,0,0
167854,306,306,0,0,0
167856,306,306,0,0,0
167878,24,24,0,0,0
167880,27,27,0,0,0
167888,6,6,0,0,0
167899,246,246,0,0,0
167900,97,97,0,0,0
167901,353,353,0,0,0
167953,259,259,0,0,0
167955,102,102,0,0,0
167962,171,171,0,0,0
167970,171,171,0,0,0
167986,1,1,0,0,0
167988,313,313,0,0,0
167995,34,34,0,0,0
168008,167,167,0,0,0
168014,72,72,0,0,0
168019,180,180,0,0,0
168026,103,103,0,0,0
168037,232,232,0,0,0
168058,87,87,0,0,0
168064,85,85,0,0,0
168067,306,306,0,0,0
168072,83,83,0,0,0
168082,114,114,0,0,0
168086,299,299,0,0,0
168092,315,315,0,0,0
168116,168,168,0,0,0
168129,168,168,0,0,0
168130,281,281,0,0,0
168135,66,66,0,0,0
168136,114,114,0,0,0
168143,6,6,0,0,0
168145,315,315,0,0,0
168151,8,8,0,0,0
168158,171,171,0,0,0
168159,128,128,0,0,0
168160,184,184,0,0,0
168163,74,74,0,0,0
168170,43,43,0,0,0
168178,15,15,0,0,0
168190,25,25,0,0,0
168194,113,113,0,0,0
168198,22,22,0,0,0
168215,246,246,0,0,0
168231,17,17,0,0,0
168234,345,345,0,0,0
168239,17,17,0,0,0
168241,94,94,0,0,0
168251,102,102,0,0,0
168268,14,14,0,0,0
168276,35,35,0,0,0
168290,281,281,0,0,0
168291,143,143,0,0,0
168300,29,29,0,0,0
168302,83,83,0,0,0
168305,39,39,0,0,0
168315,251,251,0,0,0
168325,56,56,0,0,0
168328,282,282,0,0,0
168338,315,315,0,0,0
168363,34,34,0,0,0
168368,19,19,0,0,0
168371,102,102,0,0,0
168380,87,87,0,0,0
168392,402,402,0,0,0
168407,402,402,0,0,0
168418,17,17,0,0,0
168456,18,18,0,0,0
168468,128,128,0,0,0
168485,69,69,0,0,0
168488,315,315,0,0,0
168496,281,281,0,0,0
168515,198,198,0,0,0
168557,306,306,0,0,0
168574,345,345,0,0,0
168583,255,255,0,0,0
168610,12,12,0,0,0
168631,281,281,0,0,0
168637,310,310,0,0,0
168691,131,131,0,0,0
168694,167,167,0,0,0
168701,315,315,0,0,0
168703,402,402,0,0,0
168706,282,282,0,0,0
168717,50,50,0,0,0
168726,193,193,0,0,0
168729,76,76,0,0,0
168757,281,281,0,0,0
168777,315,315,0,0,0
168791,255,255,0,0,0
168820,313,313,0,0,0
168837,94,94,0,0,0
168840,39,39,0,0,0
168851,158,158,0,0,0
168862,30,30,0,0,0
168866,67,67,0,0,0
168869,163,163,0,0,0
168881,63,63,0,0,0
168886,281,281,0,0,0
168889,34,34,0,0,0
168892,306,306,0,0,0
168893,56,56,0,0,0
168897,121,121,0,0,0
168903,315,315,0,0,0
168904,15,15,0,0,0
168916,313,313,0,0,0
168920,131,131,0,0,0
168922,14,14,0,0,0
168948,353,353,0,0,0
168957,143,143,0,0,0
168962,152,152,0,0,0
168964,43,43,0,0,0
168970,315,315,0,0,0
169010,85,85,0,0,0
169027,11,11,0,0,0
169028,74,74,0,0,0
169039,359,359,0,0,0
169042,359,359,0,0,0
169043,22,22,0,0,0
169063,20,20,0,0,0
169066,232,232,0,0,0
169071,198,198,0,0,0
169076,345,345,0,0,0
169084,299,299,0,0,0
169085,45,45,0,0,0
169090,24,24,0,0,0
169097,246,246,0,0,0
169118,56,56,0,0,0
169123,180,180,0,0,0
169124,114,114,0,0,0
169130,152,152,0,0,0
169149,128,128,0,0,0
169155,103,103,0,0,0
169159,345,345,0,0,0
169163,17,17,0,0,0
169205,7,7,0,0,0
169206,180,180,0,0,0
169207,232,232,0,0,0
169222,74,74,0,0,0
169267,58,58,0,0,0
169269,252,252,0,0,0
169288,5,5,0,0,0
169290,144,144,0,0,0
169296,315,315,0,0,0
169301,55,55,0,0,0
169311,315,315,0,0,0
169316,74,74,0,0,0
169326,353,353,0,0,0
169331,313,313,0,0,0
169335,315,315,0,0,0
169339,27,27,0,0,0
169365,101,101,0,0,0
169379,315,315,0,0,0
169416,137,137,0,0,0
169431,299,299,0,0,0
169433,43,43,0,0,0
169434,29,29,0,0,0
169442,27,27,0,0,0
169452,282,282,0,0,0
169460,65,65,0,0,0
169486,15,15,0,0,0
169490,18,18,0,0,0
169506,76,76,0,0,0
169511,315,315,0,0,0
169542,193,193,0,0,0
169543,94,94,0,0,0
169573,131,131,0,0,0
169590,255,255,0,0,0
169602,402,402,0,0,0
169623,246,246,0,0,0
169624,359,359,0,0,0
169635,158,158,0,0,0
169643,151,151,0,0,0
169646,65,65,0,0,0
169649,152,152,0,0,0
169657,201,201,0,0,0
169670,180,180,0,0,0
169680,54,54,0,0,0
169699,102,102,0,0,0
169708,158,158,0,0,0
169718,25,25,0,0,0
169723,34,34,0,0,0
169728,152,152,0,0,0
169746,143,143,0,0,0
169802,310,310,0,0,0
169840,315,315,0,0,0
169855,58,58,0,0,0
169865,72,72,0,0,0
169875,83,83,0,0,0
169918,7,7,0,0,0
169988,7,7,0,0,0
169995,402,402,0,0,0
169997,345,345,0,0,0
170005,167,167,0,0,0
170010,345,345,0,0,0
170014,114,114,0,0,0
170017,310,310,0,0,0
170052,133,133,0,0,0
170058,152,152,0,0,0
170060,128,128,0,0,0
170066,315,315,0,0,0
170073,74,74,0,0,0
170076,281,281,0,0,0
170080,306,306,0,0,0
170083,158,158,0,0,0
170089,83,83,0,0,0
170100,158,158,0,0,0
170101,114,114,0,0,0
170118,198,198,0,0,0
170127,246,246,0,0,0
170136,66,66,0,0,0
170138,121,121,0,0,0
170159,359,359,0,0,0
170162,152,152,0,0,0
170168,167,167,0,0,0
170191,402,402,0,0,0
170213,306,306,0,0,0
170223,39,39,0,0,0
170231,114,114,0,0,0
170234,114,114,0,0,0
170260,87,87,0,0,0
170273,402,402,0,0,0
170288,313,313,0,0,0
170297,121,121,0,0,0
170332,56,56,0,0,0
170345,255,255,0,0,0
170365,97,97,0,0,0
170383,168,168,0,0,0
170395,25,25,0,0,0
170396,353,353,0,0,0
170426,114,114,0,0,0
170427,251,251,0,0,0
170437,345,345,0,0,0
170448,151,151,0,0,0
170459,299,299,0,0,0
170461,345,345,0,0,0
170473,103,103,0,0,0
170508,82,82,0,0,0
170524,345,345,0,0,0
170544,246,246,0,0,0
170545,29,29,0,0,0
170569,30,30,0,0,0
170570,2,2,0,0,0
170576,11,11,0,0,0
170598,131,131,0,0,0
170602,50,50,0,0,0
170616,23,23,0,0,0
170622,246,246,0,0,0
170631,251,251,0,0,0
170632,252,252,0,0,0
170657,144,144,0,0,0
170663,193,193,0,0,0
170691,306,306,0,0,0
170702,168,168,0,0,0
170710,345,345,0,0,0
170741,353,353,0,0,0
170742,17,17,0,0,0
170750,29,29,0,0,0
170771,44,44,0,0,0
170804,50,50,0,0,0
170811,198,198,0,0,0
170837,43,43,0,0,0
170869,193,193,0,0,0
170882,27,27,0,0,0
170893,15,15,0,0,0
170902,114,114,0,0,0
170921,353,353,0,0,0
170930,184,184,0,0,0
170964,66,66,0,0,0
170982,353,353,0,0,0
170985,246,246,0,0,0
170986,71,71,0,0,0
170987,402,402,0,0,0
171006,345,345,0,0,0
171009,259,259,0,0,0
171014,82,82,0,0,0
171017,282,282,0,0,0
171026,10,10,0,0,0
171036,11,11,0,0,0
171047,113,113,0,0,0
171050,282,282,0,0,0
171057,281,281,0,0,0
171061,15,15,0,0,0
171076,74,74,0,0,0
171095,103,103,0,0,0
171102,16,16,0,0,0
171116,158,158,0,0,0
171124,313,313,0,0,0
171136,120,120,0,0,0
171166,114,114,0,0,0
171177,15,15,0,0,0
171179,359,359,0,0,0
171193,87,87,0,0,0
171203,315,315,0,0,0
171219,54,54,0,0,0
171235,3,3,0,0,0
171244,158,158,0,0,0
171256,113,113,0,0,0
171265,12,12,0,0,0
171285,345,345,0,0,0
171346,24,24,0,0,0
171363,12,12,0,0,0
171364,282,282,0,0,0
171366,402,402,0,0,0
171376,74,74,0,0,0
171378,76,76,0,0,0
171382,310,310,0,0,0
171395,167,167,0,0,0
171397,57,57,0,0,0
171398,76,76,0,0,0
171401,163,163,0,0,0
171413,184,184,0,0,0
171416,180,180,0,0,0
171422,359,359,0,0,0
171451,299,299,0,0,0
171453,5,5,0,0,0
171467,281,281,0,0,0
171470,128,128,0,0,0
171474,130,130,0,0,0
171477,25,25,0,0,0
171478,3,3,0,0,0
171480,402,402,0,0,0
171481,76,76,0,0,0
171493,144,144,0,0,0
171534,313,313,0,0,0
171535,345,345,0,0,0
171543,232,232,0,0,0
171560,359,359,0,0,0
171603,4,4,0,0,0
171624,353,353,0,0,0
171634,113,113,0,0,0
171645,246,246,0,0,0
171663,19,19,0,0,0
171669,402,402,0,0,0
171673,359,359,0,0,0
171675,345,345,0,0,0
171684,114,114,0,0,0
171691,255,255,0,0,0
171747,158,158,0,0,0
171748,114,114,0,0,0
171765,315,315,0,0,0
171799,67,67,0,0,0
171803,163,163,0,0,0
171806,184,184,0,0,0
171823,102,102,0,0,0
171826,184,184,0,0,0
171847,27,27,0,0,0
171860,193,193,0,0,0
171875,402,402,0,0,0
171876,306,306,0,0,0
171885,50,50,0,0,0
171905,255,255,0,0,0
171908,306,306,0,0,0
171909,402,402,0,0,0
171910,121,121,0,0,0
171911,10,10,0,0,0
171914,121,121,0,0,0
171936,8,8,0,0,0
171942,56,56,0,0,0
171946,2,2,0,0,0
171950,167,167,0,0,0
171960,306,306,0,0,0
171981,82,82,0,0,0
171982,15,15,0,0,0
171990,137,137,0,0,0
172010,128,128,0,0,0
172013,71,71,0,0,0
172024,101,101,0,0,0
172028,43,43,0,0,0
172057,246,246,0,0,0
172075,282,282,0,0,0
172093,152,152,0,0,0
172105,74,74,0,0,0
172132,75,75,0,0,0
172136,101,101,0,0,0
172141,151,151,0,0,0
172142,252,252,0,0,0
172156,29,29,0,0,0
172171,198,198,0,0,0
172173,201,201,0,0,0
172182,74,74,0,0,0
172211,41,41,0,0,0
172213,15,15,0,0,0
172228,69,69,0,0,0
172236,97,97,0,0,0
172248,41,41,0,0,0
172261,310,310,0,0,0
172262,120,120,0,0,0
172277,74,74,0,0,0
172281,193,193,0,0,0
172285,201,201,0,0,0
172299,353,353,0,0,0
172306,198,198,0,0,0
172325,359,359,0,0,0
172340,251,251,0,0,0
172348,12,12,0,0,0
172351,18,18,0,0,0
172352,345,345,0,0,0
172356,22,22,0,0,0
172357,168,168,0,0,0
172368,103,103,0,0,0
172392,310,310,0,0,0
172393,3,3,0,0,0
172398,310,310,0,0,0
172412,69,69,0,0,0
172424,66,66,0,0,0
172427,74,74,0,0,0
172434,158,158,0,0,0
172435,121,121,0,0,0
172460,255,255,0,0,0
172464,281,281,0,0,0
172467,281,281,0,0,0
172478,158,158,0,0,0
172482,114,114,0,0,0
172488,113,113,0,0,0
172494,168,168,0,0,0
172506,70,70,0,0,0
172527,20,20,0,0,0
172537,137,137,0,0,0
172554,345,345,0,0,0
172576,14,14,0,0,0
172604,114,114,0,0,0
172624,313,313,0,0,0
172632,315,315,0,0,0
172637,43,43,0,0,0
172671,67,67,0,0,0
172678,232,232,0,0,0
172687,252,252,0,0,0
172688,103,103,0,0,0
172700,359,359,0,0,0
172701,359,359,0,0,0
172709,121,121,0,0,0
172749,255,255,0,0,0
172755,313,313,0,0,0
172762,232,232,0,0,0
172776,345,345,0,0,0
172781,36,36,0,0,0
172783,121,121,0,0,0
172785,144,144,0,0,0
172801,97,97,0,0,0
172810,201,201,0,0,0
172824,184,184,0,0,0
172830,121,121,0,0,0
172832,353,353,0,0,0
172857,252,252,0,0,0
172860,75,75,0,0,0
172863,315,315,0,0,0
172876,310,310,0,0,0
172886,163,163,0,0,0
172900,128,128,0,0,0
172903,43,43,0,0,0
172914,255,255,0,0,0
172917,36,36,0,0,0
172932,180,180,0,0,0
172956,22,22,0,0,0
172959,402,402,0,0,0
172994,74,74,0,0,0
173012,345,345,0,0,0
173034,130,130,0,0,0
173038,402,402,0,0,0
173040,3,3,0,0,0
173046,158,158,0,0,0
173051,29,29,0,0,0
173062,255,255,0,0,0
173073,158,158,0,0,0
173074,180,180,0,0,0
173094,137,137,0,0,0
173105,4,4,0,0,0
173113,184,184,0,0,0
173135,310,310,0,0,0
173168,76,76,0,0,0
173169,72,72,0,0,0
173178,201,201,0,0,0
173206,71,71,0,0,0
173208,306,306,0,0,0
173230,3,3,0,0,0
173234,402,402,0,0,0
173235,167,167,0,0,0
173239,113,113,0,0,0
173263,232,232,0,0,0
173266,82,82,0,0,0
173274,17,17,0,0,0
173277,76,76,0,0,0
173279,171,171,0,0,0
173307,163,163,0,0,0
173309,74,74,0,0,0
173310,345,345,0,0,0
173334,246,246,0,0,0
173339,71,71,0,0,0
173354,75,75,0,0,0
173357,313,313,0,0,0
173367,306,306,0,0,0
173382,158,158,0,0,0
173383,252,252,0,0,0
173390,313,313,0,0,0
173400,252,252,0,0,0
173401,137,137,0,0,0
173424,151,151,0,0,0
173429,168,168,0,0,0
173436,345,345,0,0,0
173454,281,281,0,0,0
173472,10,10,0,0,0
173473,40,40,0,0,0
173476,167,167,0,0,0
173481,402,402,0,0,0
173482,103,103,0,0,0
173488,65,65,0,0,0
173489,281,281,0,0,0
173510,57,57,0,0,0
173525,128,128,0,0,0
173530,44,44,0,0,0
173543,152,152,0,0,0
173548,306,306,0,0,0
173553,11,11,0,0,0
173555,299,299,0,0,0
173579,87,87,0,0,0
173592,306,306,0,0,0
173600,315,315,0,0,0
173607,137,137,0,0,0
173611,198,198,0,0,0
173618,353,353,0,0,0
173620,255,255,0,0,0
173624,36,36,0,0,0
173631,24,24,0,0,0
173657,121,121,0,0,0
173661,121,121,0,0,0
173680,315,315,0,0,0
173721,353,353,0,0,0
173730,97,97,0,0,0
173763,282,282,0,0,0
173770,310,310,0,0,0
173774,353,353,0,0,0
173776,345,345,0,0,0
173783,152,152,0,0,0
173788,353,353,0,0,0
173794,167,167,0,0,0
173795,137,137,0,0,0
173810,299,299,0,0,0
173812,310,310,0,0,0
173814,152,152,0,0,0
173824,306,306,0,0,0
173841,101,101,0,0,0
173860,132,132,0,0,0
173878,11,11,0,0,0
173880,310,310,0,0,0
173887,345,345,0,0,0
173895,282,282,0,0,0
173896,282,282,0,0,0
173902,101,101,0,0,0
173914,50,50,0,0,0
173919,255,255,0,0,0
173920,4,4,0,0,0
173923,131,131,0,0,0
173932,27,27,0,0,0
173952,132,132,0,0,0
173993,76,76,0,0,0
174007,114,114,0,0,0
174032,132,132,0,0,0
174043,29,29,0,0,0
174054,121,121,0,0,0
174058,12,12,0,0,0
174078,168,168,0,0,0
174083,36,36,0,0,0
174092,76,76,0,0,0
174100,198,198,0,0,0
174101,72,72,0,0,0
174111,87,87,0,0,0
174126,163,163,0,0,0
174133,345,345,0,0,0
174135,130,130,0,0,0
174139,201,201,0,0,0
174150,281,281,0,0,0
174159,168,168,0,0,0
174165,180,180,0,0,0
174174,16,16,0,0,0
174175,167,167,0,0,0
174182,83,83,0,0,0
174183,359,359,0,0,0
174195,353,353,0,0,0
174199,193,193,0,0,0
174201,402,402,0,0,0
174202,259,259,0,0,0
174212,144,144,0,0,0
174246,232,232,0,0,0
174257,132,132,0,0,0
174270,251,251,0,0,0
174272,353,353,0,0,0
174274,143,143,0,0,0
174275,198,198,0,0,0
174284,7,7,0,0,0
174305,345,345,0,0,0
174316,306,306,0,0,0
174323,246,246,0,0,0
174326,50,50,0,0,0
174348,6,6,0,0,0
174349,45,45,0,0,0
174359,23,23,0,0,0
174370,306,306,0,0,0
174380,345,345,0,0,0
174386,184,184,0,0,0
174417,281,281,0,0,0
174418,56,56,0,0,0
174427,259,259,0,0,0
174460,76,76,0,0,0
174483,36,36,0,0,0
174487,306,306,0,0,0
174490,101,101,0,0,0
174500,43,43,0,0,0
174509,402,402,0,0,0
174522,184,184,0,0,0
174527,299,299,0,0,0
174545,315,315,0,0,0
174547,259,259,0,0,0
174585,163,163,0,0,0
174598,402,402,0,0,0
174607,310,310,0,0,0
174609,193,193,0,0,0
174616,353,353,0,0,0
174617,36,36,0,0,0
174630,345,345,0,0,0
174638,69,69,0,0,0
174642,255,255,0,0,0
174652,152,152,0,0,0
174660,102,102,0,0,0
174676,72,72,0,0,0
174695,251,251,0,0,0
174700,299,299,0,0,0
174714,252,252,0,0,0
174728,103,103,0,0,0
174735,167,167,0,0,0
174738,282,282,0,0,0
174741,252,252,0,0,0
174746,29,29,0,0,0
174747,163,163,0,0,0
174748,152,152,0,0,0
174767,246,246,0,0,0
174769,402,402,0,0,0
174788,75,75,0,0,0
174809,402,402,0,0,0
174816,201,201,0,0,0
174817,251,251,0,0,0
174819,137,137,0,0,0
174826,36,36,0,0,0
174829,353,353,0,0,0
174837,12,12,0,0,0
174850,70,70,0,0,0
174861,54,54,0,0,0
174872,158,158,0,0,0
174879,10,10,0,0,0
174897,313,313,0,0,0
174926,70,70,0,0,0
174955,77,77,0,0,0
174962,29,29,0,0,0
174964,3,3,0,0,0
174970,85,85,0,0,0
174985,315,315,0,0,0
175001,102,102,0,0,0
175013,12,12,0,0,0
175033,137,137,0,0,0
175036,359,359,0,0,0
175053,359,359,0,0,0
175064,20,20,0,0,0
175069,40,40,0,0,0
175077,152,152,0,0,0
175080,281,281,0,0,0
175090,299,299,0,0,0
175091,120,120,0,0,0
175108,246,246,0,0,0
175112,36,36,0,0,0
175116,193,193,0,0,0
175125,137,137,0,0,0
175127,57,57,0,0,0
175132,132,132,0,0,0
175155,11,11,0,0,0
175184,56,56,0,0,0
175202,97,97,0,0,0
175212,15,15,0,0,0
175218,282,282,0,0,0
175223,121,121,0,0,0
175224,402,402,0,0,0
175229,72,72,0,0,0
175237,102,102,0,0,0
175254,282,282,0,0,0
175256,63,63,0,0,0
175259,282,282,0,0,0
175261,259,259,0,0,0
175274,252,252,0,0,0
175293,167,167,0,0,0
175296,180,180,0,0,0
175304,9,9,0,0,0
175305,306,306,0,0,0
175317,50,50,0,0,0
175328,353,353,0,0,0
175352,57,57,0,0,0
175361,103,103,0,0,0
175381,75,75,0,0,0
175387,1,1,0,0,0
175390,251,251,0,0,0
175393,137,137,0,0,0
175397,306,306,0,0,0
175403,25,25,0,0,0
175413,25,25,0,0,0
175422,50,50,0,0,0
175434,7,7,0,0,0
175436,353,353,0,0,0
175448,168,168,0,0,0
175458,353,353,0,0,0
175459,58,58,0,0,0
175489,143,143,0,0,0
175495,184,184,0,0,0
175499,306,306,0,0,0
175515,193,193,0,0,0
175516,3,3,0,0,0
175518,359,359,0,0,0
175519,76,76,0,0,0
175520,87,87,0,0,0
175521,20,20,0,0,0
175531,11,11,0,0,0
175540,151,151,0,0,0
175542,359,359,0,0,0
175548,359,359,0,0,0
175561,353,353,0,0,0
175570,282,282,0,0,0
175571,171,171,0,0,0
175575,74,74,0,0,0
175585,198,198,0,0,0
175604,353,353,0,0,0
175626,282,282,0,0,0
175633,345,345,0,0,0
175637,163,163,0,0,0
175641,20,20,0,0,0
175656,21,21,0,0,0
175661,167,167,0,0,0
175666,7,7,0,0,0
175667,12,12,0,0,0
175677,171,171,0,0,0
175682,66,66,0,0,0
175693,132,132,0,0,0
175700,137,137,0,0,0
175705,313,313,0,0,0
175706,1,1,0,0,0
175713,130,130,0,0,0
175729,101,101,0,0,0
175765,251,251,0,0,0
175779,77,77,0,0,0
175781,282,282,0,0,0
175788,193,193,0,0,0
175791,310,310,0,0,0
175805,143,143,0,0,0
175818,251,251,0,0,0
175819,65,65,0,0,0
175850,246,246,0,0,0
175853,7,7,0,0,0
175858,259,259,0,0,0
175879,25,25,0,0,0
175901,77,77,0,0,0
175910,167,167,0,0,0
175926,402,402,0,0,0
175939,151,151,0,0,0
175940,55,55,0,0,0
175965,15,15,0,0,0
175973,252,252,0,0,0
175974,306,306,0,0,0
175992,143,143,0,0,0
176002,310,310,0,0,0
176005,121,121,0,0,0
176006,255,255,0,0,0
176010,30,30,0,0,0
176013,144,144,0,0,0
176018,11,11,0,0,0
176032,3,3,0,0,0
176063,87,87,0,0,0
176087,87,87,0,0,0
176088,8,8,0,0,0
176098,315,315,0,0,0
176123,158,158,0,0,0
176127,232,232,0,0,0
176153,74,74,0,0,0
176155,2,2,0,0,0
176161,22,22,0,0,0
176174,76,76,0,0,0
176177,29,29,0,0,0
176191,402,402,0,0,0
176213,282,282,0,0,0
176222,13,13,0,0,0
176233,345,345,0,0,0
176234,282,282,0,0,0
176241,281,281,0,0,0
176249,63,63,0,0,0
176255,102,102,0,0,0
176258,345,345,0,0,0
176263,306,306,0,0,0
176278,55,55,0,0,0
176296,76,76,0,0,0
176314,299,299,0,0,0
176327,18,18,0,0,0
176331,255,255,0,0,0
176334,345,345,0,0,0
176339,313,313,0,0,0
176341,87,87,0,0,0
176346,137,137,0,0,0
176349,299,299,0,0,0
176365,313,313,0,0,0
176379,281,281,0,0,0
176386,315,315,0,0,0
176387,306,306,0,0,0
176388,198,198,0,0,0
176390,168,168,0,0,0
176398,87,87,0,0,0
176407,137,137,0,0,0
176425,201,201,0,0,0
176456,282,282,0,0,0
176466,345,345,0,0,0
176469,193,193,0,0,0
176472,151,151,0,0,0
176486,10,10,0,0,0
176514,259,259,0,0,0
176528,171,171,0,0,0
176529,402,402,0,0,0
176531,9,9,0,0,0
176535,69,69,0,0,0
176539,353,353,0,0,0
176540,143,143,0,0,0
176545,1,1,0,0,0
176563,184,184,0,0,0
176564,29,29,0,0,0
176572,315,315,0,0,0
176583,121,121,0,0,0
176589,353,353,0,0,0
176615,193,193,0,0,0
176620,152,152,0,0,0
176626,353,353,0,0,0
176652,158,158,0,0,0
176684,121,121,0,0,0
176690,76,76,0,0,0
176698,359,359,0,0,0
176703,137,137,0,0,0
176731,76,76,0,0,0
176733,137,137,0,0,0
176734,101,101,0,0,0
176739,15,15,0,0,0
176749,345,345,0,0,0
176760,168,168,0,0,0
176795,66,66,0,0,0
176796,137,137,0,0,0
176797,1,1,0,0,0
176805,345,345,0,0,0
176833,65,65,0,0,0
176860,168,168,0,0,0
176866,8,8,0,0,0
176867,281,281,0,0,0
176878,7,7,0,0,0
176893,299,299,0,0,0
176894,198,198,0,0,0
176918,246,246,0,0,0
176920,281,281,0,0,0
176928,94,94,0,0,0
176931,168,168,0,0,0
176938,167,167,0,0,0
176946,353,353,0,0,0
176953,85,85,0,0,0
176969,184,184,0,0,0
176980,251,251,0,0,0
176981,101,101,0,0,0
176982,70,70,0,0,0
176985,353,353,0,0,0
176987,143,143,0,0,0
176990,24,24,0,0,0
177001,45,45,0,0,0
177008,315,315,0,0,0
177010,163,163,0,0,0
177031,56,56,0,0,0
177032,77,77,0,0,0
177033,10,10,0,0,0
177043,402,402,0,0,0
177068,10,10,0,0,0
177096,282,282,0,0,0
177111,14,14,0,0,0
177118,71,71,0,0,0
177135,193,193,0,0,0
177190,41,41,0,0,0
177200,252,252,0,0,0
177203,184,184,0,0,0
177214,74,74,0,0,0
177218,281,281,0,0,0
177235,255,255,0,0,0
177241,14,14,0,0,0
177250,15,15,0,0,0
177268,168,168,0,0,0
177269,72,72,0,0,0
177270,2,2,0,0,0
177271,251,251,0,0,0
177273,353,353,0,0,0
177277,57,57,0,0,0
177283,3,3,0,0,0
177296,50,50,0,0,0
177321,359,359,0,0,0
177330,259,259,0,0,0
177353,251,251,0,0,0
177358,171,171,0,0,0
177366,167,167,0,0,0
177372,167,167,0,0,0
177394,315,315,0,0,0
177397,201,201,0,0,0
177415,163,163,0,0,0
177424,94,94,0,0,0
177427,54,54,0,0,0
177441,82,82,0,0,0
177442,76,76,0,0,0
177446,76,76,0,0,0
177452,353,353,0,0,0
177458,246,246,0,0,0
177479,167,167,0,0,0
177482,201,201,0,0,0
177485,246,246,0,0,0
177488,345,345,0,0,0
177492,143,143,0,0,0
177493,29,29,0,0,0
177513,313,313,0,0,0
177515,313,313,0,0,0
177520,45,45,0,0,0
177521,313,313,0,0,0
177537,402,402,0,0,0
177567,198,198,0,0,0
177580,114,114,0,0,0
177585,193,193,0,0,0
177589,27,27,0,0,0
177593,168,168,0,0,0
177594,132,132,0,0,0
177618,69,69,0,0,0
177634,402,402,0,0,0
177637,121,121,0,0,0
177645,97,97,0,0,0
177655,55,55,0,0,0
177656,1,1,0,0,0
177672,353,353,0,0,0
177703,171,171,0,0,0
177723,76,76,0,0,0
177776,402,402,0,0,0
177795,193,193,0,0,0
177801,251,251,0,0,0
177803,232,232,0,0,0
177822,359,359,0,0,0
177884,22,22,0,0,0
177896,282,282,0,0,0
177912,130,130,0,0,0
177925,252,252,0,0,0
177932,143,143,0,0,0
177940,75,75,0,0,0
177943,281,281,0,0,0
177950,3,3,0,0,0
177956,310,310,0,0,0
177960,9,9,0,0,0
177961,75,75,0,0,0
177992,281,281,0,0,0
177996,101,101,0,0,0
177999,121,121,0,0,0
178002,14,14,0,0,0
178010,402,402,0,0,0
178063,313,313,0,0,0
178075,101,101,0,0,0
178094,28,28,0,0,0
178098,63,63,0,0,0
178115,193,193,0,0,0
178119,17,17,0,0,0
178124,359,359,0,0,0
178131,299,299,0,0,0
178151,24,24,0,0,0
178162,8,8,0,0,0
178166,158,158,0,0,0
178185,71,71,0,0,0
178221,137,137,0,0,0
178231,259,259,0,0,0
178240,18,18,0,0,0
178250,114,114,0,0,0
178251,299,299,0,0,0
178263,315,315,0,0,0
178270,198,198,0,0,0
178291,353,353,0,0,0
178296,282,282,0,0,0
178318,20,20,0,0,0
178325,87,87,0,0,0
178336,359,359,0,0,0
178346,35,35,0,0,0
178347,17,17,0,0,0
178400,20,20,0,0,0
178406,232,232,0,0,0
178427,101,101,0,0,0
178428,137,137,0,0,0
178441,82,82,0,0,0
178480,359,359,0,0,0
178482,259,259,0,0,0
178493,74,74,0,0,0
178500,246,246,0,0,0
178509,299,299,0,0,0
178511,158,158,0,0,0
178525,168,168,0,0,0
178527,306,306,0,0,0
178534,151,151,0,0,0
178543,180,180,0,0,0
178571,113,113,0,0,0
178574,167,167,0,0,0
178579,345,345,0,0,0
178580,315,315,0,0,0
178587,359,359,0,0,0
178590,130,130,0,0,0
178591,137,137,0,0,0
178592,70,70,0,0,0
178597,184,184,0,0,0
178618,27,27,0,0,0
178624,313,313,0,0,0
178631,353,353,0,0,0
178650,114,114,0,0,0
178678,94,94,0,0,0
178692,25,25,0,0,0
178699,133,133,0,0,0
178704,345,345,0,0,0
178708,34,34,0,0,0
178718,22,22,0,0,0
178722,402,402,0,0,0
178768,167,167,0,0,0
178773,255,255,0,0,0
178778,252,252,0,0,0
178798,251,251,0,0,0
178801,252,252,0,0,0
178804,201,201,0,0,0
178813,402,402,0,0,0
178819,44,44,0,0,0
178827,56,56,0,0,0
178837,282,282,0,0,0
178848,17,17,0,0,0
178871,184,184,0,0,0
178876,27,27,0,0,0
178888,315,315,0,0,0
178914,65,65,0,0,0
178918,102,102,0,0,0
178964,83,83,0,0,0
178966,313,313,0,0,0
178970,151,151,0,0,0
178971,69,69,0,0,0
178975,184,184,0,0,0
178979,121,121,0,0,0
178982,310,310,0,0,0
178993,102,102,0,0,0
178996,310,310,0,0,0
178998,56,56,0,0,0
179016,76,76,0,0,0
179018,232,232,0,0,0
179044,102,102,0,0,0
179047,9,9,0,0,0
179048,35,35,0,0,0
179058,282,282,0,0,0
179059,359,359,0,0,0
179074,193,193,0,0,0
179077,137,137,0,0,0
179096,151,151,0,0,0
179136,299,299,0,0,0
179175,313,313,0,0,0
179194,56,56,0,0,0
179195,50,50,0,0,0
179204,402,402,0,0,0
179218,353,353,0,0,0
179259,35,35,0,0,0
179291,87,87,0,0,0
179308,232,232,0,0,0
179327,13,13,0,0,0
179337,70,70,0,0,0
179343,101,101,0,0,0
179369,16,16,0,0,0
179373,74,74,0,0,0
179374,137,137,0,0,0
179388,180,180,0,0,0
179407,83,83,0,0,0
179432,281,281,0,0,0
179443,137,137,0,0,0
179444,143,143,0,0,0
179446,1,1,0,0,0
179498,158,158,0,0,0
179519,58,58,0,0,0
179542,193,193,0,0,0
179555,246,246,0,0,0
179577,282,282,0,0,0
179603,87,87,0,0,0
179604,128,128,0,0,0
179618,306,306,0,0,0
179632,163,163,0,0,0
179650,35,35,0,0,0
179670,25,25,0,0,0
179685,313,313,0,0,0
179686,102,102,0,0,0
179694,87,87,0,0,0
179699,137,137,0,0,0
179700,359,359,0,0,0
179718,128,128,0,0,0
179722,315,315,0,0,0
179726,315,315,0,0,0
179732,402,402,0,0,0
179759,44,44,0,0,0
179762,143,143,0,0,0
179776,16,16,0,0,0
179783,9,9,0,0,0
179825,359,359,0,0,0
179828,259,259,0,0,0
179854,168,168,0,0,0
179875,281,281,0,0,0
179881,34,34,0,0,0
179887,137,137,0,0,0
179894,83,83,0,0,0
179898,133,133,0,0,0
179908,158,158,0,0,0
179917,94,94,0,0,0
179922,282,282,0,0,0
179933,193,193,0,0,0
179940,345,345,0,0,0
179948,232,232,0,0,0
179970,345,345,0,0,0
179983,22,22,0,0,0
179985,10,10,0,0,0
179991,85,85,0,0,0
179998,251,251,0,0,0
180023,65,65,0,0,0
180025,246,246,0,0,0
180039,345,345,0,0,0
180048,171,171,0,0,0
180059,14,14,0,0,0
180064,137,137,0,0,0
180066,114,114,0,0,0
180071,313,313,0,0,0
180072,152,152,0,0,0
180087,72,72,0,0,0
180122,45,45,0,0,0
180125,345,345,0,0,0
180127,76,76,0,0,0
180139,167,167,0,0,0
180159,353,353,0,0,0
180164,82,82,0,0,0
180169,259,259,0,0,0
180180,345,345,0,0,0
180201,87,87,0,0,0
180206,35,35,0,0,0
180220,201,201,0,0,0
180232,163,163,0,0,0
180235,306,306,0,0,0
180249,259,259,0,0,0
180329,345,345,0,0,0
180342,163,163,0,0,0
180366,22,22,0,0,0
180369,39,39,0,0,0
180386,75,75,0,0,0
180389,114,114,0,0,0
180399,102,102,0,0,0
180405,306,306,0,0,0
180419,76,76,0,0,0
180440,353,353,0,0,0
180447,232,232,0,0,0
180454,39,39,0,0,0
180465,3,3,0,0,0
180479,9,9,0,0,0
180483,251,251,0,0,0
180492,25,25,0,0,0
180515,113,113,0,0,0
180516,198,198,0,0,0
180517,13,13,0,0,0
180561,113,113,0,0,0
180562,101,101,0,0,0
180565,113,113,0,0,0
180590,201,201,0,0,0
180595,171,171,0,0,0
180616,251,251,0,0,0
180622,345,345,0,0,0
180627,130,130,0,0,0
180629,82,82,0,0,0
180630,121,121,0,0,0
180636,158,158,0,0,0
180659,101,101,0,0,0
180664,167,167,0,0,0
180677,252,252,0,0,0
180680,353,353,0,0,0
180687,184,184,0,0,0
180703,255,255,0,0,0
180713,315,315,0,0,0
180719,34,34,0,0,0
180721,113,113,0,0,0
180728,310,310,0,0,0
180760,76,76,0,0,0
180765,133,133,0,0,0
180771,18,18,0,0,0
180780,168,168,0,0,0
180801,163,163,0,0,0
180807,102,102,0,0,0
180816,121,121,0,0,0
180827,85,85,0,0,0
180834,114,114,0,0,0
180837,359,359,0,0,0
180843,113,113,0,0,0
180849,281,281,0,0,0
180853,402,402,0,0,0
180874,402,402,0,0,0
180897,359,359,0,0,0
180900,255,255,0,0,0
180902,151,151,0,0,0
180907,94,94,0,0,0
180914,76,76,0,0,0
180930,128,128,0,0,0
180932,252,252,0,0,0
180941,255,255,0,0,0
180961,171,171,0,0,0
180980,306,306,0,0,0
180981,345,345,0,0,0
180983,255,255,0,0,0
180989,44,44,0,0,0
180994,163,163,0,0,0
181008,74,74,0,0,0
181020,313,313,0,0,0
181036,8,8,0,0,0
181043,12,12,0,0,0
181059,167,167,0,0,0
181062,12,12,0,0,0
181065,259,259,0,0,0
181141,359,359,0,0,0
181154,25,25,0,0,0
181193,158,158,0,0,0
181199,143,143,0,0,0
181204,45,45,0,0,0
181205,246,246,0,0,0
181219,25,25,0,0,0
181224,45,45,0,0,0
181257,201,201,0,0,0
181258,167,167,0,0,0
181267,282,282,0,0,0
181271,282,282,0,0,0
181275,353,353,0,0,0
181281,152,152,0,0,0
181287,10,10,0,0,0
181299,16,16,0,0,0
181302,282,282,0,0,0
181309,151,151,0,0,0
181310,75,75,0,0,0
181311,402,402,0,0,0
181314,282,282,0,0,0
181318,198,198,0,0,0
181324,121,121,0,0,0
181327,144,144,0,0,0
181336,251,251,0,0,0
181343,313,313,0,0,0
181345,41,41,0,0,0
181354,87,87,0,0,0
181356,232,232,0,0,0
181357,299,299,0,0,0
181358,167,167,0,0,0
181368,29,29,0,0,0
181369,143,143,0,0,0
181397,133,133,0,0,0
181402,103,103,0,0,0
181410,402,402,0,0,0
181428,121,121,0,0,0
181429,167,167,0,0,0
181479,74,74,0,0,0
181480,102,102,0,0,0
181492,158,158,0,0,0
181498,193,193,0,0,0
181506,251,251,0,0,0
181508,76,76,0,0,0
181515,97,97,0,0,0
181538,12,12,0,0,0
181565,306,306,0,0,0
181572,151,151,0,0,0
181579,67,67,0,0,0
181603,10,10,0,0,0
181612,315,315,0,0,0
181613,20,20,0,0,0
181615,137,137,0,0,0
181642,313,313,0,0,0
181702,114,114,0,0,0
181708,40,40,0,0,0
181717,128,128,0,0,0
181735,2,2,0,0,0
181737,232,232,0,0,0
181758,137,137,0,0,0
181759,4,4,0,0,0
181778,87,87,0,0,0
181779,252,252,0,0,0
181783,345,345,0,0,0
181786,201,201,0,0,0
181787,40,40,0,0,0
181790,151,151,0,0,0
181821,167,167,0,0,0
181826,4,4,0,0,0
181838,232,232,0,0,0
181839,8,8,0,0,0
181840,10,10,0,0,0
181842,128,128,0,0,0
181861,152,152,0,0,0
181873,87,87,0,0,0
181891,120,120,0,0,0
181899,15,15,0,0,0
181912,29,29,0,0,0
181916,345,345,0,0,0
181923,255,255,0,0,0
181945,359,359,0,0,0
181946,9,9,0,0,0
181952,151,151,0,0,0
181953,120,120,0,0,0
181954,39,39,0,0,0
181968,299,299,0,0,0
181997,87,87,0,0,0
181999,41,41,0,0,0
182002,36,36,0,0,0
182006,193,193,0,0,0
182011,310,310,0,0,0
182012,41,41,0,0,0
182014,246,246,0,0,0
182020,345,345,0,0,0
182022,281,281,0,0,0
182045,246,246,0,0,0
182048,310,310,0,0,0
182054,171,171,0,0,0
182058,43,43,0,0,0
182066,281,281,0,0,0
182070,17,17,0,0,0
182081,252,252,0,0,0
182098,310,310,0,0,0
182102,76,76,0,0,0
182104,246,246,0,0,0
182117,85,85,0,0,0
182132,137,137,0,0,0
182139,198,198,0,0,0
182142,7,7,0,0,0
182173,299,299,0,0,0
182235,359,359,0,0,0
182249,299,299,0,0,0
182251,180,180,0,0,0
182272,130,130,0,0,0
182277,167,167,0,0,0
182310,315,315,0,0,0
182316,345,345,0,0,0
182321,251,251,0,0,0
182322,22,22,0,0,0
182348,30,30,0,0,0
182351,232,232,0,0,0
182352,102,102,0,0,0
182358,25,25,0,0,0
182384,1,1,0,0,0
182397,137,137,0,0,0
182401,27,27,0,0,0
182411,76,76,0,0,0
182428,345,345,0,0,0
182441,30,30,0,0,0
182455,77,77,0,0,0
182468,36,36,0,0,0
182478,163,163,0,0,0
182485,113,113,0,0,0
182493,75,75,0,0,0
182506,359,359,0,0,0
182519,313,313,0,0,0
182524,184,184,0,0,0
182531,83,83,0,0,0
182542,133,133,0,0,0
182553,313,313,0,0,0
182556,232,232,0,0,0
182563,313,313,0,0,0
182580,77,77,0,0,0
182584,402,402,0,0,0
182585,74,74,0,0,0
182589,18,18,0,0,0
182600,259,259,0,0,0
182611,121,121,0,0,0
182614,310,310,0,0,0
182620,56,56,0,0,0
182624,167,167,0,0,0
182626,310,310,0,0,0
182678,402,402,0,0,0
182690,22,22,0,0,0
182701,198,198,0,0,0
182727,3,3,0,0,0
182760,180,180,0,0,0
182764,193,193,0,0,0
182767,310,310,0,0,0
182782,22,22,0,0,0
182789,16,16,0,0,0
182799,20,20,0,0,0
182804,282,282,0,0,0
182805,121,121,0,0,0
182809,313,313,0,0,0
182826,97,97,0,0,0
182831,50,50,0,0,0
182844,353,353,0,0,0
182847,56,56,0,0,0
182849,102,102,0,0,0
182854,167,167,0,0,0
182863,12,12,0,0,0
182865,35,35,0,0,0
182868,259,259,0,0,0
182874,137,137,0,0,0
182880,232,232,0,0,0
182885,69,69,0,0,0
182890,167,167,0,0,0
182895,120,120,0,0,0
182916,103,103,0,0,0
182937,353,353,0,0,0
182946,74,74,0,0,0
182948,13,13,0,0,0
182949,198,198,0,0,0
182951,315,315,0,0,0
182971,151,151,0,0,0
182991,251,251,0,0,0
183005,158,158,0,0,0
183041,306,306,0,0,0
183053,259,259,0,0,0
183088,251,251,0,0,0
183097,252,252,0,0,0
183099,251,251,0,0,0
183103,359,359,0,0,0
183116,313,313,0,0,0
183154,17,17,0,0,0
183170,143,143,0,0,0
183179,133,133,0,0,0
183206,10,10,0,0,0
183209,251,251,0,0,0
183217,315,315,0,0,0
183236,102,102,0,0,0
183238,359,359,0,0,0
183241,72,72,0,0,0
183257,40,40,0,0,0
183289,359,359,0,0,0
183312,11,11,0,0,0
183343,137,137,0,0,0
183348,32,32,0,0,0
183365,232,232,0,0,0
183377,14,14,0,0,0
183378,171,171,0,0,0
183388,27,27,0,0,0
183406,198,198,0,0,0
183425,184,184,0,0,0
183426,299,299,0,0,0
183444,3,3,0,0,0
183451,163,163,0,0,0
183454,251,251,0,0,0
183468,359,359,0,0,0
183480,72,72,0,0,0
183482,313,313,0,0,0
183490,6,6,0,0,0
183498,198,198,0,0,0
183508,359,359,0,0,0
183531,101,101,0,0,0
183541,306,306,0,0,0
183574,120,120,0,0,0
183584,158,158,0,0,0
183596,56,56,0,0,0
183639,310,310,0,0,0
183648,71,71,0,0,0
183665,82,82,0,0,0
183687,35,35,0,0,0
183708,246,246,0,0,0
183713,353,353,0,0,0
183740,152,152,0,0,0
183748,353,353,0,0,0
183751,7,7,0,0,0
183759,193,193,0,0,0
183772,94,94,0,0,0
183782,130,130,0,0,0
183787,82,82,0,0,0
183794,313,313,0,0,0
183848,120,120,0,0,0
183870,315,315,0,0,0
183884,252,252,0,0,0
183892,359,359,0,0,0
183896,15,15,0,0,0
183900,168,168,0,0,0
183905,54,54,0,0,0
183920,315,315,0,0,0
183921,152,152,0,0,0
183924,193,193,0,0,0
183941,63,63,0,0,0
183943,359,359,0,0,0
183960,184,184,0,0,0
183973,201,201,0,0,0
183976,18,18,0,0,0
183979,252,252,0,0,0
183982,143,143,0,0,0
183989,94,94,0,0,0
183992,21,21,0,0,0
184006,1,1,0,0,0
184027,130,130,0,0,0
184030,402,402,0,0,0
184032,1,1,0,0,0
184040,137,137,0,0,0
184048,72,72,0,0,0
184054,19,19,0,0,0
184064,144,144,0,0,0
184069,120,120,0,0,0
184070,198,198,0,0,0
184077,315,315,0,0,0
184104,232,232,0,0,0
184107,246,246,0,0,0
184115,15,15,0,0,0
184125,184,184,0,0,0
184127,83,83,0,0,0
184129,171,171,0,0,0
184130,55,55,0,0,0
184148,251,251,0,0,0
184152,310,310,0,0,0
184160,74,74,0,0,0
184189,2,2,0,0,0
184192,345,345,0,0,0
184219,20,20,0,0,0
184221,345,345,0,0,0
184243,299,299,0,0,0
184245,63,63,0,0,0
184247,168,168,0,0,0
184263,151,151,0,0,0
184267,82,82,0,0,0
184272,252,252,0,0,0
184280,128,128,0,0,0
184291,16,16,0,0,0
184292,246,246,0,0,0
184305,120,120,0,0,0
184306,281,281,0,0,0
184309,143,143,0,0,0
184317,7,7,0,0,0
184336,171,171,0,0,0
184338,45,45,0,0,0
184341,130,130,0,0,0
184344,171,171,0,0,0
184354,74,74,0,0,0
184357,306,306,0,0,0
184360,232,232,0,0,0
184364,167,167,0,0,0
184365,144,144,0,0,0
184369,306,306,0,0,0
184378,102,102,0,0,0
184386,128,128,0,0,0
184401,102,102,0,0,0
184412,252,252,0,0,0
184416,67,67,0,0,0
184443,315,315,0,0,0
184464,67,67,0,0,0
184489,163,163,0,0,0
184493,167,167,0,0,0
184495,171,171,0,0,0
184497,17,17,0,0,0
184499,402,402,0,0,0
184500,143,143,0,0,0
184504,101,101,0,0,0
184557,180,180,0,0,0
184573,299,299,0,0,0
184582,74,74,0,0,0
184591,94,94,0,0,0
184606,246,246,0,0,0
184612,152,152,0,0,0
184616,232,232,0,0,0
184622,143,143,0,0,0
184623,246,246,0,0,0
184639,282,282,0,0,0
184640,282,282,0,0,0
184650,306,306,0,0,0
184651,144,144,0,0,0
184652,168,168,0,0,0
184659,259,259,0,0,0
184661,299,299,0,0,0
184663,44,44,0,0,0
184667,113,113,0,0,0
184668,50,50,0,0,0
184694,56,56,0,0,0
184710,72,72,0,0,0
184731,315,315,0,0,0
184743,2,2,0,0,0
184751,255,255,0,0,0
184752,9,9,0,0,0
184784,6,6,0,0,0
184800,114,114,0,0,0
184805,306,306,0,0,0
184825,18,18,0,0,0
184842,184,184,0,0,0
184848,54,54,0,0,0
184850,180,180,0,0,0
184861,67,67,0,0,0
184922,255,255,0,0,0
184927,12,12,0,0,0
184940,120,120,0,0,0
184959,67,67,0,0,0
184971,402,402,0,0,0
184981,353,353,0,0,0
185011,17,17,0,0,0
185022,5,5,0,0,0
185036,44,44,0,0,0
185049,102,102,0,0,0
185061,402,402,0,0,0
185067,128,128,0,0,0
185071,75,75,0,0,0
185079,315,315,0,0,0
185083,8,8,0,0,0
185102,120,120,0,0,0
185105,167,167,0,0,0
185128,198,198,0,0,0
185137,69,69,0,0,0
185138,163,163,0,0,0
185170,8,8,0,0,0
185172,3,3,0,0,0
185182,353,353,0,0,0
185183,131,131,0,0,0
185187,359,359,0,0,0
185189,313,313,0,0,0
185213,133,133,0,0,0
185219,184,184,0,0,0
185220,282,282,0,0,0
185227,255,255,0,0,0
185248,313,313,0,0,0
185261,313,313,0,0,0
185269,184,184,0,0,0
185293,114,114,0,0,0
185301,5,5,0,0,0
185307,180,180,0,0,0
185313,75,75,0,0,0
185323,255,255,0,0,0
185337,310,310,0,0,0
185341,201,201,0,0,0
185354,74,74,0,0,0
185365,75,75,0,0,0
185378,180,180,0,0,0
185381,299,299,0,0,0
185383,313,313,0,0,0
185387,345,345,0,0,0
185402,252,252,0,0,0
185406,54,54,0,0,0
185413,299,299,0,0,0
185416,252,252,0,0,0
185456,15,15,0,0,0
185466,152,152,0,0,0
185475,94,94,0,0,0
185494,15,15,0,0,0
185496,359,359,0,0,0
185502,102,102,0,0,0
185504,252,252,0,0,0
185513,74,74,0,0,0
185519,131,131,0,0,0
185520,137,137,0,0,0
185547,102,102,0,0,0
185562,39,39,0,0,0
185580,121,121,0,0,0
185601,87,87,0,0,0
185604,69,69,0,0,0
185607,85,85,0,0,0
185619,24,24,0,0,0
185626,131,131,0,0,0
185643,299,299,0,0,0
185650,114,114,0,0,0
185668,315,315,0,0,0
185675,143,143,0,0,0
185696,102,102,0,0,0
185703,15,15,0,0,0
185732,282,282,0,0,0
185734,10,10,0,0,0
185741,16,16,0,0,0
185750,252,252,0,0,0
185777,252,252,0,0,0
185779,32,32,0,0,0
185782,151,151,0,0,0
185795,282,282,0,0,0
185805,151,151,0,0,0
185817,345,345,0,0,0
185819,306,306,0,0,0
185823,171,171,0,0,0
185837,168,168,0,0,0
185849,9,9,0,0,0
185856,345,345,0,0,0
185864,345,345,0,0,0
185866,71,71,0,0,0
185871,163,163,0,0,0
185875,180,180,0,0,0
185902,137,137,0,0,0
185922,29,29,0,0,0
185928,310,310,0,0,0
185930,75,75,0,0,0
185939,83,83,0,0,0
185947,152,152,0,0,0
185955,67,67,0,0,0
185960,252,252,0,0,0
185963,16,16,0,0,0
185971,137,137,0,0,0
185975,28,28,0,0,0
185984,130,130,0,0,0
185987,10,10,0,0,0
185992,103,103,0,0,0
186013,39,39,0,0,0
186014,313,313,0,0,0
186020,180,180,0,0,0
186021,114,114,0,0,0
186034,71,71,0,0,0
186046,353,353,0,0,0
186054,255,255,0,0,0
186093,168,168,0,0,0
186110,102,102,0,0,0
186148,74,74,0,0,0
186152,171,171,0,0,0
186159,14,14,0,0,0
186168,313,313,0,0,0
186184,144,144,0,0,0
186203,152,152,0,0,0
186209,180,180,0,0,0
186213,9,9,0,0,0
186218,143,143,0,0,0
186228,359,359,0,0,0
186264,198,198,0,0,0
186267,151,151,0,0,0
186275,359,359,0,0,0
186281,121,121,0,0,0
186286,306,306,0,0,0
186289,345,345,0,0,0
186304,14,14,0,0,0
186306,131,131,0,0,0
186326,299,299,0,0,0
186332,255,255,0,0,0
186338,4,4,0,0,0
186355,299,299,0,0,0
186362,201,201,0,0,0
186373,74,74,0,0,0
186380,251,251,0,0,0
186382,27,27,0,0,0
186402,102,102,0,0,0
186425,8,8,0,0,0
186426,15,15,0,0,0
186427,201,201,0,0,0
186450,27,27,0,0,0
186477,27,27,0,0,0
186501,259,259,0,0,0
186507,97,97,0,0,0
186536,85,85,0,0,0
186540,232,232,0,0,0
186541,198,198,0,0,0
186544,50,50,0,0,0
186546,184,184,0,0,0
186552,201,201,0,0,0
186564,102,102,0,0,0
186565,29,29,0,0,0
186568,87,87,0,0,0
186574,353,353,0,0,0
186575,152,152,0,0,0
186589,22,22,0,0,0
186608,24,24,0,0,0
186625,131,131,0,0,0
186626,251,251,0,0,0
186629,259,259,0,0,0
186653,306,306,0,0,0
186671,137,137,0,0,0
186674,281,281,0,0,0
186680,74,74,0,0,0
186691,137,137,0,0,0
186698,40,40,0,0,0
186702,36,36,0,0,0
186703,131,131,0,0,0
186711,15,15,0,0,0
186714,315,315,0,0,0
186715,315,315,0,0,0
186721,198,198,0,0,0
186729,402,402,0,0,0
186738,353,353,0,0,0
186777,102,102,0,0,0
186786,24,24,0,0,0
186808,19,19,0,0,0
186815,167,167,0,0,0
186826,282,282,0,0,0
186831,132,132,0,0,0
186838,313,313,0,0,0
186840,151,151,0,0,0
186870,168,168,0,0,0
186908,131,131,0,0,0
186917,252,252,0,0,0
186928,345,345,0,0,0
186950,56,56,0,0,0
186951,232,232,0,0,0
186955,252,252,0,0,0
186962,193,193,0,0,0
186989,359,359,0,0,0
187012,15,15,0,0,0
187039,402,402,0,0,0
187046,102,102,0,0,0
187060,113,113,0,0,0
187070,58,58,0,0,0
187086,163,163,0,0,0
187096,143,143,0,0,0
187098,168,168,0,0,0
187105,128,128,0,0,0
187121,24,24,0,0,0
187124,113,113,0,0,0
187129,359,359,0,0,0
187133,137,137,0,0,0
187141,41,41,0,0,0
187154,94,94,0,0,0
187165,102,102,0,0,0
187170,24,24,0,0,0
187174,137,137,0,0,0
187196,310,310,0,0,0
187206,17,17,0,0,0
187233,131,131,0,0,0
187246,15,15,0,0,0
187262,168,168,0,0,0
187270,313,313,0,0,0
187276,168,168,0,0,0
187278,315,315,0,0,0
187283,168,168,0,0,0
187290,18,18,0,0,0
187294,345,345,0,0,0
187295,299,299,0,0,0
187307,114,114,0,0,0
187351,12,12,0,0,0
187354,24,24,0,0,0
187360,313,313,0,0,0
187371,359,359,0,0,0
187393,198,198,0,0,0
187398,310,310,0,0,0
187405,5,5,0,0,0
187417,184,184,0,0,0
187419,27,27,0,0,0
187423,168,168,0,0,0
187428,11,11,0,0,0
187430,57,57,0,0,0
187445,103,103,0,0,0
187447,259,259,0,0,0
187478,313,313,0,0,0
187482,306,306,0,0,0
187497,198,198,0,0,0
187502,27,27,0,0,0
187516,313,313,0,0,0
187526,121,121,0,0,0
187539,56,56,0,0,0
187560,310,310,0,0,0
187563,19,19,0,0,0
187572,114,114,0,0,0
187577,71,71,0,0,0
187593,201,201,0,0,0
187595,4,4,0,0,0
187596,45,45,0,0,0
187597,184,184,0,0,0
187603,299,299,0,0,0
187637,12,12,0,0,0
187663,313,313,0,0,0
187669,36,36,0,0,0
187684,232,232,0,0,0
187690,18,18,0,0,0
187693,359,359,0,0,0
187696,121,121,0,0,0
187700,198,198,0,0,0
187716,402,402,0,0,0
187727,252,252,0,0,0
187732,282,282,0,0,0
187755,310,310,0,0,0
187777,113,113,0,0,0
187791,66,66,0,0,0
187795,402,402,0,0,0
187813,45,45,0,0,0
187828,50,50,0,0,0
187842,168,168,0,0,0
187851,143,143,0,0,0
187879,402,402,0,0,0
187883,131,131,0,0,0
187885,310,310,0,0,0
187886,2,2,0,0,0
187915,137,137,0,0,0
187931,101,101,0,0,0
187937,121,121,0,0,0
187941,20,20,0,0,0
187946,402,402,0,0,0
187952,184,184,0,0,0
187958,103,103,0,0,0
187960,201,201,0,0,0
187981,22,22,0,0,0
187982,41,41,0,0,0
187990,69,69,0,0,0
187991,171,171,0,0,0
187998,168,168,0,0,0
188043,232,232,0,0,0
188050,130,130,0,0,0
188051,198,198,0,0,0
188096,255,255,0,0,0
188106,97,97,0,0,0
188112,306,306,0,0,0
188116,299,299,0,0,0
188118,299,299,0,0,0
188122,193,193,0,0,0
188145,402,402,0,0,0
188148,113,113,0,0,0
188162,255,255,0,0,0
188170,313,313,0,0,0
188173,151,151,0,0,0
188176,259,259,0,0,0
188179,306,306,0,0,0
188180,39,39,0,0,0
188194,246,246,0,0,0
188195,158,158,0,0,0
188210,130,130,0,0,0
188216,27,27,0,0,0
188233,7,7,0,0,0
188256,69,69,0,0,0
188298,83,83,0,0,0
188309,7,7,0,0,0
188340,14,14,0,0,0
188344,102,102,0,0,0
188358,12,12,0,0,0
188387,131,131,0,0,0
188391,36,36,0,0,0
188396,76,76,0,0,0
188416,121,121,0,0,0
188429,10,10,0,0,0
188430,82,82,0,0,0
188441,34,34,0,0,0
188467,120,120,0,0,0
188474,70,70,0,0,0
188508,184,184,0,0,0
188516,128,128,0,0,0
188517,102,102,0,0,0
188536,402,402,0,0,0
188547,120,120,0,0,0
188548,12,12,0,0,0
188549,198,198,0,0,0
188567,74,74,0,0,0
188576,74,74,0,0,0
188579,101,101,0,0,0
188605,299,299,0,0,0
188606,102,102,0,0,0
188622,359,359,0,0,0
188628,299,299,0,0,0
188629,143,143,0,0,0
188632,82,82,0,0,0
188656,251,251,0,0,0
188663,252,252,0,0,0
188684,103,103,0,0,0
188690,113,113,0,0,0
188691,101,101,0,0,0
188726,198,198,0,0,0
188732,35,35,0,0,0
188734,15,15,0,0,0
188743,24,24,0,0,0
188752,102,102,0,0,0
188763,69,69,0,0,0
188781,232,232,0,0,0
188800,17,17,0,0,0
188804,299,299,0,0,0
188815,184,184,0,0,0
188818,255,255,0,0,0
188846,10,10,0,0,0
188851,5,5,0,0,0
188853,353,353,0,0,0
188863,57,57,0,0,0
188880,2,2,0,0,0
188904,102,102,0,0,0
188908,11,11,0,0,0
188911,198,198,0,0,0
188946,201,201,0,0,0
188958,282,282,0,0,0
188961,232,232,0,0,0
188964,299,299,0,0,0
188973,50,50,0,0,0
188976,102,102,0,0,0
188987,83,83,0,0,0
188990,3,3,0,0,0
189023,163,163,0,0,0
189029,282,282,0,0,0
189033,232,232,0,0,0
189045,402,402,0,0,0
189051,130,130,0,0,0
189102,94,94,0,0,0
189106,131,131,0,0,0
189112,281,281,0,0,0
189127,56,56,0,0,0
189128,180,180,0,0,0
189134,281,281,0,0,0
189144,15,15,0,0,0
189145,43,43,0,0,0
189147,34,34,0,0,0
189151,12,12,0,0,0
189153,359,359,0,0,0
189155,22,22,0,0,0
189169,15,15,0,0,0
189170,39,39,0,0,0
189180,114,114,0,0,0
189186,282,282,0,0,0
189188,345,345,0,0,0
189193,345,345,0,0,0
189219,71,71,0,0,0
189225,67,67,0,0,0
189237,310,310,0,0,0
189238,11,11,0,0,0
189256,402,402,0,0,0
189264,137,137,0,0,0
189306,359,359,0,0,0
189311,232,232,0,0,0
189313,101,101,0,0,0
189327,299,299,0,0,0
189338,70,70,0,0,0
189341,198,198,0,0,0
189359,20,20,0,0,0
189363,29,29,0,0,0
189365,158,158,0,0,0
189371,2,2,0,0,0
189380,282,282,0,0,0
189381,353,353,0,0,0
189386,76,76,0,0,0
189402,144,144,0,0,0
189405,97,97,0,0,0
189413,151,151,0,0,0
189432,72,72,0,0,0
189443,77,77,0,0,0
189463,18,18,0,0,0
189465,121,121,0,0,0
189509,97,97,0,0,0
189510,151,151,0,0,0
189511,137,137,0,0,0
189524,255,255,0,0,0
189532,137,137,0,0,0
189533,184,184,0,0,0
189534,20,20,0,0,0
189535,310,310,0,0,0
189544,77,77,0,0,0
189550,306,306,0,0,0
189567,70,70,0,0,0
189568,57,57,0,0,0
189578,113,113,0,0,0
189594,193,193,0,0,0
189599,114,114,0,0,0
189602,137,137,0,0,0
189614,102,102,0,0,0
189619,251,251,0,0,0
189621,198,198,0,0,0
189646,402,402,0,0,0
189649,252,252,0,0,0
189652,184,184,0,0,0
189673,25,25,0,0,0
189691,281,281,0,0,0
189707,158,158,0,0,0
189715,44,44,0,0,0
189726,310,310,0,0,0
189743,171,171,0,0,0
189759,72,72,0,0,0
189787,143,143,0,0,0
189788,22,22,0,0,0
189794,13,13,0,0,0
189799,137,137,0,0,0
189803,152,152,0,0,0
189812,67,67,0,0,0
189828,353,353,0,0,0
189836,131,131,0,0,0
189845,70,70,0,0,0
189846,152,152,0,0,0
189854,29,29,0,0,0
189872,113,113,0,0,0
189874,251,251,0,0,0
189896,315,315,0,0,0
189904,359,359,0,0,0
189908,128,128,0,0,0
189916,158,158,0,0,0
189996,101,101,0,0,0
190000,345,345,0,0,0
190020,353,353,0,0,0
190029,45,45,0,0,0
190042,7,7,0,0,0
190055,251,251,0,0,0
190069,281,281,0,0,0
190077,43,43,0,0,0
190083,27,27,0,0,0
190090,143,143,0,0,0
190127,17,17,0,0,0
190136,71,71,0,0,0
190138,402,402,0,0,0
190143,251,251,0,0,0
190150,255,255,0,0,0
190151,299,299,0,0,0
190156,345,345,0,0,0
190158,306,306,0,0,0
190163,252,252,0,0,0
190198,299,299,0,0,0
190201,75,75,0,0,0
190204,143,143,0,0,0
190238,23,23,0,0,0
190247,306,306,0,0,0
190270,63,63,0,0,0
190275,120,120,0,0,0
190278,232,232,0,0,0
190289,74,74,0,0,0
190290,152,152,0,0,0
190295,299,299,0,0,0
190307,345,345,0,0,0
190314,246,246,0,0,0
190328,353,353,0,0,0
190338,180,180,0,0,0
190348,17,17,0,0,0
190381,71,71,0,0,0
190406,167,167,0,0,0
190407,8,8,0,0,0
190410,76,76,0,0,0
190413,282,282,0,0,0
190419,114,114,0,0,0
190421,54,54,0,0,0
190425,180,180,0,0,0
190452,306,306,0,0,0
190455,83,83,0,0,0
190461,40,40,0,0,0
190464,130,130,0,0,0
190502,198,198,0,0,0
190538,359,359,0,0,0
190540,14,14,0,0,0
190548,315,315,0,0,0
190565,255,255,0,0,0
190579,66,66,0,0,0
190598,11,11,0,0,0
190609,313,313,0,0,0
190615,11,11,0,0,0
190619,246,246,0,0,0
190632,252,252,0,0,0
190635,345,345,0,0,0
190640,137,137,0,0,0
190647,20,20,0,0,0
190656,171,171,0,0,0
190658,359,359,0,0,0
190663,184,184,0,0,0
190664,299,299,0,0,0
190665,359,359,0,0,0
190668,70,70,0,0,0
190680,77,77,0,0,0
190727,137,137,0,0,0
190731,282,282,0,0,0
190759,402,402,0,0,0
190761,113,113,0,0,0
190780,180,180,0,0,0
190816,82,82,0,0,0
190832,56,56,0,0,0
190856,85,85,0,0,0
190860,75,75,0,0,0
190863,252,252,0,0,0
190867,359,359,0,0,0
190879,34,34,0,0,0
190881,255,255,0,0,0
190890,152,152,0,0,0
190896,299,299,0,0,0
190904,353,353,0,0,0
190924,151,151,0,0,0
190942,102,102,0,0,0
190956,313,313,0,0,0
190981,158,158,0,0,0
190982,13,13,0,0,0
190998,359,359,0,0,0
191001,69,69,0,0,0
191043,4,4,0,0,0
191063,246,246,0,0,0
191076,57,57,0,0,0
191100,345,345,0,0,0
191103,359,359,0,0,0
191106,359,359,0,0,0
191109,315,315,0,0,0
191110,69,69,0,0,0
191136,77,77,0,0,0
191146,144,144,0,0,0
191149,103,103,0,0,0
191153,353,353,0,0,0
191160,121,121,0,0,0
191161,251,251,0,0,0
191181,167,167,0,0,0
191197,282,282,0,0,0
191201,345,345,0,0,0
191210,168,168,0,0,0
191213,252,252,0,0,0
191220,282,282,0,0,0
191222,50,50,0,0,0
191224,402,402,0,0,0
191260,54,54,0,0,0
191311,310,310,0,0,0
191383,3,3,0,0,0
191390,74,74,0,0,0
191394,25,25,0,0,0
191399,255,255,0,0,0
191406,315,315,0,0,0
191408,137,137,0,0,0
191410,14,14,0,0,0
191417,114,114,0,0,0
191443,306,306,0,0,0
191466,114,114,0,0,0
191478,121,121,0,0,0
191487,121,121,0,0,0
191492,63,63,0,0,0
191517,74,74,0,0,0
191518,66,66,0,0,0
191519,345,345,0,0,0
191521,353,353,0,0,0
191537,282,282,0,0,0
191570,18,18,0,0,0
191571,5,5,0,0,0
191574,232,232,0,0,0
191589,201,201,0,0,0
191603,306,306,0,0,0
191617,102,102,0,0,0
191620,299,299,0,0,0
191626,40,40,0,0,0
191630,246,246,0,0,0
191638,102,102,0,0,0
191654,359,359,0,0,0
191656,34,34,0,0,0
191667,251,251,0,0,0
191672,15,15,0,0,0
191691,345,345,0,0,0
191692,313,313,0,0,0
191694,65,65,0,0,0
191742,201,201,0,0,0
191748,137,137,0,0,0
191751,57,57,0,0,0
191769,76,76,0,0,0
191771,282,282,0,0,0
191782,65,65,0,0,0
191783,163,163,0,0,0
191784,251,251,0,0,0
191797,29,29,0,0,0
191799,315,315,0,0,0
191803,201,201,0,0,0
191812,315,315,0,0,0
191814,66,66,0,0,0
191819,13,13,0,0,0
191823,50,50,0,0,0
191838,24,24,0,0,0
191846,255,255,0,0,0
191848,44,44,0,0,0
191849,282,282,0,0,0
191877,184,184,0,0,0
191891,32,32,0,0,0
191914,97,97,0,0,0
191946,50,50,0,0,0
191952,193,193,0,0,0
191953,255,255,0,0,0
191986,34,34,0,0,0
192041,70,70,0,0,0
192047,171,171,0,0,0
192068,310,310,0,0,0
192074,353,353,0,0,0
192077,23,23,0,0,0
192092,103,103,0,0,0
192098,306,306,0,0,0
192112,151,151,0,0,0
192126,201,201,0,0,0
192162,101,101,0,0,0
192165,345,345,0,0,0
192169,87,87,0,0,0
192176,158,158,0,0,0
192183,184,184,0,0,0
192186,87,87,0,0,0
192193,345,345,0,0,0
192213,345,345,0,0,0
192261,45,45,0,0,0
192275,171,171,0,0,0
192280,232,232,0,0,0
192320,56,56,0,0,0
192324,201,201,0,0,0
192350,77,77,0,0,0
192358,255,255,0,0,0
192364,353,353,0,0,0
192374,28,28,0,0,0
192378,198,198,0,0,0
192381,67,67,0,0,0
192408,29,29,0,0,0
192413,152,152,0,0,0
192414,313,313,0,0,0
192422,35,35,0,0,0
192424,255,255,0,0,0
192432,74,74,0,0,0
192466,3,3,0,0,0
192478,246,246,0,0,0
192480,7,7,0,0,0
192483,85,85,0,0,0
192488,39,39,0,0,0
192500,306,306,0,0,0
192506,232,232,0,0,0
192515,137,137,0,0,0
192519,29,29,0,0,0
192524,281,281,0,0,0
192537,10,10,0,0,0
192553,143,143,0,0,0
192554,20,20,0,0,0
192571,255,255,0,0,0
192576,353,353,0,0,0
192578,75,75,0,0,0
192587,359,359,0,0,0
192593,359,359,0,0,0
192596,315,315,0,0,0
192607,19,19,0,0,0
192611,113,113,0,0,0
192614,144,144,0,0,0
192616,313,313,0,0,0
192630,402,402,0,0,0
192637,310,310,0,0,0
192669,16,16,0,0,0
192696,345,345,0,0,0
192699,74,74,0,0,0
192710,74,74,0,0,0
192712,19,19,0,0,0
192717,41,41,0,0,0
192719,29,29,0,0,0
192731,20,20,0,0,0
192752,137,137,0,0,0
192759,76,76,0,0,0
192771,71,71,0,0,0
192774,402,402,0,0,0
192784,25,25,0,0,0
192790,114,114,0,0,0
192796,151,151,0,0,0
192816,201,201,0,0,0
192821,114,114,0,0,0
192825,163,163,0,0,0
192836,3,3,0,0,0
192852,402,402,0,0,0
192868,402,402,0,0,0
192887,143,143,0,0,0
192892,193,193,0,0,0
192893,198,198,0,0,0
192896,137,137,0,0,0
192900,299,299,0,0,0
192906,353,353,0,0,0
192922,171,171,0,0,0
192924,201,201,0,0,0
192931,29,29,0,0,0
192964,151,151,0,0,0
192972,102,102,0,0,0
192984,101,101,0,0,0
192985,121,121,0,0,0
192998,87,87,0,0,0
193003,193,193,0,0,0
193004,83,83,0,0,0
193011,103,103,0,0,0
193021,313,313,0,0,0
193035,77,77,0,0,0
193042,359,359,0,0,0
193058,299,299,0,0,0
193059,10,10,0,0,0
193065,282,282,0,0,0
193067,198,198,0,0,0
193072,359,359,0,0,0
193087,180,180,0,0,0
193090,167,167,0,0,0
193098,35,35,0,0,0
193110,71,71,0,0,0
193118,163,163,0,0,0
193144,56,56,0,0,0
193162,70,70,0,0,0
193165,151,151,0,0,0
193169,29,29,0,0,0
193170,34,34,0,0,0
193172,315,315,0,0,0
193173,313,313,0,0,0
193190,282,282,0,0,0
193228,201,201,0,0,0
193243,299,299,0,0,0
193245,315,315,0,0,0
193259,282,282,0,0,0
193261,402,402,0,0,0
193273,1,1,0,0,0
193277,128,128,0,0,0
193283,11,11,0,0,0
193289,82,82,0,0,0
193292,27,27,0,0,0
193293,310,310,0,0,0
193296,29,29,0,0,0
193305,353,353,0,0,0
193334,39,39,0,0,0
193353,315,315,0,0,0
193357,151,151,0,0,0
193371,281,281,0,0,0
193375,94,94,0,0,0
193384,353,353,0,0,0
193390,345,345,0,0,0
193411,180,180,0,0,0
193412,359,359,0,0,0
193417,201,201,0,0,0
193431,359,359,0,0,0
193434,252,252,0,0,0
193447,180,180,0,0,0
193448,121,121,0,0,0
193486,15,15,0,0,0
193493,18,18,0,0,0
193506,306,306,0,0,0
193511,246,246,0,0,0
193514,171,171,0,0,0
193526,345,345,0,0,0
193531,255,255,0,0,0
193549,315,315,0,0,0
193550,144,144,0,0,0
193574,345,345,0,0,0
193577,102,102,0,0,0
193583,299,299,0,0,0
193598,232,232,0,0,0
193609,101,101,0,0,0
193616,74,74,0,0,0
193630,353,353,0,0,0
193663,72,72,0,0,0
193671,71,71,0,0,0
193687,345,345,0,0,0
193697,39,39,0,0,0
193733,259,259,0,0,0
193756,353,353,0,0,0
193761,158,158,0,0,0
193789,131,131,0,0,0
193790,75,75,0,0,0
193802,252,252,0,0,0
193806,13,13,0,0,0
193811,41,41,0,0,0
193823,8,8,0,0,0
193826,193,193,0,0,0
193828,102,102,0,0,0
193829,252,252,0,0,0
193847,310,310,0,0,0
193850,34,34,0,0,0
193864,144,144,0,0,0
193873,114,114,0,0,0
193875,17,17,0,0,0
193880,359,359,0,0,0
193892,198,198,0,0,0
193893,167,167,0,0,0
193925,345,345,0,0,0
193960,151,151,0,0,0
193969,152,152,0,0,0
193972,345,345,0,0,0
193975,97,97,0,0,0
193992,103,103,0,0,0
193998,193,193,0,0,0
194000,70,70,0,0,0
194022,128,128,0,0,0
194030,315,315,0,0,0
194031,69,69,0,0,0
194038,32,32,0,0,0
194043,87,87,0,0,0
194075,184,184,0,0,0
194091,359,359,0,0,0
194096,281,281,0,0,0
194097,345,345,0,0,0
194105,63,63,0,0,0
194108,11,11,0,0,0
194128,180,180,0,0,0
194135,313,313,0,0,0
194137,74,74,0,0,0
194147,35,35,0,0,0
194180,102,102,0,0,0
194182,306,306,0,0,0
194183,306,306,0,0,0
194216,102,102,0,0,0
194225,282,282,0,0,0
194233,281,281,0,0,0
194253,353,353,0,0,0
194259,232,232,0,0,0
194261,133,133,0,0,0
194267,281,281,0,0,0
194271,120,120,0,0,0
194275,281,281,0,0,0
194281,184,184,0,0,0
194285,251,251,0,0,0
194294,345,345,0,0,0
194306,54,54,0,0,0
194339,43,43,0,0,0
194347,167,167,0,0,0
194359,144,144,0,0,0
194362,143,143,0,0,0
194372,102,102,0,0,0
194380,353,353,0,0,0
194387,74,74,0,0,0
194421,252,252,0,0,0
194429,36,36,0,0,0
194430,315,315,0,0,0
194436,345,345,0,0,0
194453,251,251,0,0,0
194464,259,259,0,0,0
194480,310,310,0,0,0
194486,171,171,0,0,0
194492,94,94,0,0,0
194515,232,232,0,0,0
194518,114,114,0,0,0
194522,201,201,0,0,0
194534,313,313,0,0,0
194536,246,246,0,0,0
194541,201,201,0,0,0
194543,193,193,0,0,0
194565,8,8,0,0,0
194607,306,306,0,0,0
194610,128,128,0,0,0
194615,168,168,0,0,0
194626,359,359,0,0,0
194635,184,184,0,0,0
194640,18,18,0,0,0
194650,13,13,0,0,0
194657,43,43,0,0,0
194661,143,143,0,0,0
194682,313,313,0,0,0
194706,171,171,0,0,0
194711,15,15,0,0,0
194727,299,299,0,0,0
194730,163,163,0,0,0
194749,345,345,0,0,0
194759,180,180,0,0,0
194763,54,54,0,0,0
194788,137,137,0,0,0
194805,252,252,0,0,0
194811,252,252,0,0,0
194826,137,137,0,0,0
194842,120,120,0,0,0
194871,193,193,0,0,0
194896,85,85,0,0,0
194901,246,246,0,0,0
194906,24,24,0,0,0
194935,251,251,0,0,0
194936,313,313,0,0,0
194949,306,306,0,0,0
194965,180,180,0,0,0
194983,259,259,0,0,0
194996,87,87,0,0,0
195002,113,113,0,0,0
195015,255,255,0,0,0
195021,255,255,0,0,0
195022,184,184,0,0,0
195026,198,198,0,0,0
195031,19,19,0,0,0
195034,13,13,0,0,0
195050,315,315,0,0,0
195058,121,121,0,0,0
195062,128,128,0,0,0
195063,306,306,0,0,0
195064,3,3,0,0,0
195086,345,345,0,0,0
195087,137,137,0,0,0
195092,83,83,0,0,0
195103,41,41,0,0,0
195104,259,259,0,0,0
195113,10,10,0,0,0
195124,67,67,0,0,0
195126,76,76,0,0,0
195129,345,345,0,0,0
195134,251,251,0,0,0
195138,120,120,0,0,0
195158,359,359,0,0,0
195165,87,87,0,0,0
195198,19,19,0,0,0
195249,22,22,0,0,0
195268,120,120,0,0,0
195269,58,58,0,0,0
195270,121,121,0,0,0
195276,259,259,0,0,0
195277,35,35,0,0,0
195278,121,121,0,0,0
195289,71,71,0,0,0
195305,15,15,0,0,0
195307,152,152,0,0,0
195349,34,34,0,0,0
195354,359,359,0,0,0
195360,128,128,0,0,0
195369,345,345,0,0,0
195386,402,402,0,0,0
195390,201,201,0,0,0
195404,8,8,0,0,0
195412,74,74,0,0,0
195449,168,168,0,0,0
195455,171,171,0,0,0
195463,39,39,0,0,0
195472,310,310,0,0,0
195496,25,25,0,0,0
195500,353,353,0,0,0
195507,113,113,0,0,0
195513,180,180,0,0,0
195514,315,315,0,0,0
195515,144,144,0,0,0
195521,13,13,0,0,0
195524,83,83,0,0,0
195544,282,282,0,0,0
195549,313,313,0,0,0
195553,94,94,0,0,0
195565,353,353,0,0,0
195572,232,232,0,0,0
195573,9,9,0,0,0
195575,232,232,0,0,0
195582,180,180,0,0,0
195599,143,143,0,0,0
195602,121,121,0,0,0
195610,8,8,0,0,0
195622,75,75,0,0,0
195623,246,246,0,0,0
195663,8,8,0,0,0
195687,101,101,0,0,0
195702,34,34,0,0,0
195709,359,359,0,0,0
195732,128,128,0,0,0
195740,29,29,0,0,0
195741,151,151,0,0,0
195748,4,4,0,0,0
195754,1,1,0,0,0
195777,201,201,0,0,0
195782,180,180,0,0,0
195786,43,43,0,0,0
195805,306,306,0,0,0
195812,25,25,0,0,0
195828,120,120,0,0,0
195835,10,10,0,0,0
195836,20,20,0,0,0
195837,29,29,0,0,0
195848,76,76,0,0,0
195855,310,310,0,0,0
195873,133,133,0,0,0
195877,184,184,0,0,0
195880,402,402,0,0,0
195902,402,402,0,0,0
195913,130,130,0,0,0
195922,76,76,0,0,0
195926,21,21,0,0,0
195930,114,114,0,0,0
195931,35,35,0,0,0
195939,353,353,0,0,0
195950,299,299,0,0,0
195964,180,180,0,0,0
195983,180,180,0,0,0
195992,131,131,0,0,0
196015,36,36,0,0,0
196016,65,65,0,0,0
196030,168,168,0,0,0
196031,152,152,0,0,0
196036,15,15,0,0,0
196050,251,251,0,0,0
196064,143,143,0,0,0
196066,76,76,0,0,0
196070,255,255,0,0,0
196097,171,171,0,0,0
196117,29,29,0,0,0
196124,143,143,0,0,0
196143,359,359,0,0,0
196145,299,299,0,0,0
196150,114,114,0,0,0
196170,402,402,0,0,0
196176,69,69,0,0,0
196181,27,27,0,0,0
196207,102,102,0,0,0
196220,345,345,0,0,0
196248,281,281,0,0,0
196253,306,306,0,0,0
196266,7,7,0,0,0
196271,353,353,0,0,0
196279,252,252,0,0,0
196293,345,345,0,0,0
196317,184,184,0,0,0
196327,32,32,0,0,0
196331,131,131,0,0,0
196341,251,251,0,0,0
196353,282,282,0,0,0
196366,151,151,0,0,0
196369,22,22,0,0,0
196396,18,18,0,0,0
196400,313,313,0,0,0
196406,306,306,0,0,0
196416,143,143,0,0,0
196421,310,310,0,0,0
196463,56,56,0,0,0
196470,29,29,0,0,0
196478,313,313,0,0,0
196484,121,121,0,0,0
196493,306,306,0,0,0
196497,36,36,0,0,0
196502,94,94,0,0,0
196518,246,246,0,0,0
196521,39,39,0,0,0
196536,113,113,0,0,0
196554,151,151,0,0,0
196569,359,359,0,0,0
196574,137,137,0,0,0
196576,54,54,0,0,0
196585,359,359,0,0,0
196600,102,102,0,0,0
196630,158,158,0,0,0
196638,43,43,0,0,0
196639,121,121,0,0,0
196640,144,144,0,0,0
196652,67,67,0,0,0
196658,184,184,0,0,0
196659,77,77,0,0,0
196684,201,201,0,0,0
196697,6,6,0,0,0
196698,255,255,0,0,0
196704,232,232,0,0,0
196730,152,152,0,0,0
196732,168,168,0,0,0
196750,74,74,0,0,0
196772,57,57,0,0,0
196774,101,101,0,0,0
196796,198,198,0,0,0
196809,70,70,0,0,0
196818,251,251,0,0,0
196861,251,251,0,0,0
196875,168,168,0,0,0
196877,143,143,0,0,0
196881,137,137,0,0,0
196901,85,85,0,0,0
196915,25,25,0,0,0
196944,306,306,0,0,0
196954,299,299,0,0,0
196959,102,102,0,0,0
196968,23,23,0,0,0
196978,133,133,0,0,0
197002,35,35,0,0,0
197008,16,16,0,0,0
197027,144,144,0,0,0
197050,313,313,0,0,0
197065,15,15,0,0,0
197072,158,158,0,0,0
197108,310,310,0,0,0
197125,29,29,0,0,0
197130,163,163,0,0,0
197132,180,180,0,0,0
197133,353,353,0,0,0
197134,69,69,0,0,0
197162,163,163,0,0,0
197164,103,103,0,0,0
197169,1,1,0,0,0
197172,180,180,0,0,0
197181,17,17,0,0,0
197222,180,180,0,0,0
197228,65,65,0,0,0
197231,315,315,0,0,0
197234,103,103,0,0,0
197309,137,137,0,0,0
197319,251,251,0,0,0
197341,102,102,0,0,0
197370,180,180,0,0,0
197397,246,246,0,0,0
197409,36,36,0,0,0
197423,232,232,0,0,0
197438,359,359,0,0,0
197443,102,102,0,0,0
197471,101,101,0,0,0
197472,151,151,0,0,0
197479,144,144,0,0,0
197481,259,259,0,0,0
197489,259,259,0,0,0
197533,56,56,0,0,0
197535,5,5,0,0,0
197540,282,282,0,0,0
197547,259,259,0,0,0
197548,198,198,0,0,0
197555,232,232,0,0,0
197565,255,255,0,0,0
197567,255,255,0,0,0
197594,353,353,0,0,0
197602,76,76,0,0,0
197627,255,255,0,0,0
197647,114,114,0,0,0
197666,83,83,0,0,0
197677,70,70,0,0,0
197712,72,72,0,0,0
197732,255,255,0,0,0
197734,23,23,0,0,0
197738,63,63,0,0,0
197745,144,144,0,0,0
197752,15,15,0,0,0
197756,30,30,0,0,0
197757,41,41,0,0,0
197766,232,232,0,0,0
197771,353,353,0,0,0
197779,167,167,0,0,0
197781,55,55,0,0,0
197792,151,151,0,0,0
197794,306,306,0,0,0
197805,12,12,0,0,0
197820,11,11,0,0,0
197821,281,281,0,0,0
197829,8,8,0,0,0
197841,246,246,0,0,0
197860,5,5,0,0,0
197869,315,315,0,0,0
197872,313,313,0,0,0
197884,168,168,0,0,0
197887,56,56,0,0,0
197902,152,152,0,0,0
197942,10,10,0,0,0
197945,143,143,0,0,0
197966,299,299,0,0,0
197978,15,15,0,0,0
197982,313,313,0,0,0
198008,168,168,0,0,0
198071,27,27,0,0,0
198117,5,5,0,0,0
198128,137,137,0,0,0
198139,232,232,0,0,0
198143,306,306,0,0,0
198151,121,121,0,0,0
198168,77,77,0,0,0
198170,151,151,0,0,0
198177,137,137,0,0,0
198184,259,259,0,0,0
198186,120,120,0,0,0
198187,3,3,0,0,0
198192,28,28,0,0,0
198209,6,6,0,0,0
198212,8,8,0,0,0
198219,76,76,0,0,0
198229,345,345,0,0,0
198234,55,55,0,0,0
198235,402,402,0,0,0
198271,252,252,0,0,0
198277,313,313,0,0,0
198289,402,402,0,0,0
198291,133,133,0,0,0
198300,16,16,0,0,0
198308,313,313,0,0,0
198311,198,198,0,0,0
198313,20,20,0,0,0
198314,299,299,0,0,0
198333,19,19,0,0,0
198346,15,15,0,0,0
198352,56,56,0,0,0
198370,180,180,0,0,0
198384,7,7,0,0,0
198390,198,198,0,0,0
198391,87,87,0,0,0
198392,70,70,0,0,0
198411,299,299,0,0,0
198425,310,310,0,0,0
198452,34,34,0,0,0
198456,19,19,0,0,0
198457,121,121,0,0,0
198489,20,20,0,0,0
198509,2,2,0,0,0
198516,133,133,0,0,0
198519,168,168,0,0,0
198523,315,315,0,0,0
198526,101,101,0,0,0
198527,252,252,0,0,0
198533,310,310,0,0,0
198549,28,28,0,0,0
198566,11,11,0,0,0
198588,114,114,0,0,0
198611,345,345,0,0,0
198619,255,255,0,0,0
198620,310,310,0,0,0
198654,180,180,0,0,0
198683,281,281,0,0,0
198689,2,2,0,0,0
198695,76,76,0,0,0
198703,133,133,0,0,0
198704,306,306,0,0,0
198705,75,75,0,0,0
198713,101,101,0,0,0
198717,121,121,0,0,0
198720,114,114,0,0,0
198731,315,315,0,0,0
198736,306,306,0,0,0
198743,163,163,0,0,0
198745,252,252,0,0,0
198752,24,24,0,0,0
198759,103,103,0,0,0
198768,14,14,0,0,0
198769,184,184,0,0,0
198781,74,74,0,0,0
198785,310,310,0,0,0
198797,359,359,0,0,0
198799,13,13,0,0,0
198806,158,158,0,0,0
198822,63,63,0,0,0
198831,167,167,0,0,0
198848,29,29,0,0,0
198853,97,97,0,0,0
198861,359,359,0,0,0
198865,201,201,0,0,0
198866,201,201,0,0,0
198874,10,10,0,0,0
198880,259,259,0,0,0
198881,299,299,0,0,0
198890,353,353,0,0,0
198894,232,232,0,0,0
198903,137,137,0,0,0
198910,17,17,0,0,0
198936,102,102,0,0,0
198939,184,184,0,0,0
198946,251,251,0,0,0
198980,7,7,0,0,0
198984,67,67,0,0,0
198990,113,113,0,0,0
198993,313,313,0,0,0
199014,281,281,0,0,0
199020,71,71,0,0,0
199045,252,252,0,0,0
199050,28,28,0,0,0
199069,4,4,0,0,0
199109,10,10,0,0,0
199129,168,168,0,0,0
199137,168,168,0,0,0
199148,50,50,0,0,0
199159,114,114,0,0,0
199182,43,43,0,0,0
199192,7,7,0,0,0
199203,299,299,0,0,0
199218,299,299,0,0,0
199233,281,281,0,0,0
199242,353,353,0,0,0
199252,102,102,0,0,0
199262,4,4,0,0,0
199264,102,102,0,0,0
199283,198,198,0,0,0
199287,66,66,0,0,0
199294,193,193,0,0,0
199296,6,6,0,0,0
199303,27,27,0,0,0
199308,310,310,0,0,0
199310,281,281,0,0,0
199311,85,85,0,0,0
199320,97,97,0,0,0
199329,353,353,0,0,0
199332,306,306,0,0,0
199344,63,63,0,0,0
199348,252,252,0,0,0
199363,17,17,0,0,0
199369,143,143,0,0,0
199375,25,25,0,0,0
199383,168,168,0,0,0
199394,252,252,0,0,0
199398,8,8,0,0,0
199412,55,55,0,0,0
199421,353,353,0,0,0
199426,198,198,0,0,0
199432,17,17,0,0,0
199443,345,345,0,0,0
199456,102,102,0,0,0
199457,120,120,0,0,0
199458,94,94,0,0,0
199479,313,313,0,0,0
199481,97,97,0,0,0
199526,402,402,0,0,0
199530,71,71,0,0,0
199531,152,152,0,0,0
199558,310,310,0,0,0
199575,167,167,0,0,0
199578,9,9,0,0,0
199603,94,94,0,0,0
199613,310,310,0,0,0
199617,30,30,0,0,0
199623,58,58,0,0,0
199629,114,114,0,0,0
199650,201,201,0,0,0
199656,131,131,0,0,0
199658,313,313,0,0,0
199666,29,29,0,0,0
199678,11,11,0,0,0
199690,65,65,0,0,0
199695,201,201,0,0,0
199700,345,345,0,0,0
199705,143,143,0,0,0
199710,158,158,0,0,0
199720,130,130,0,0,0
199754,76,76,0,0,0
199761,102,102,0,0,0
199776,402,402,0,0,0
199780,8,8,0,0,0
199795,18,18,0,0,0
199803,359,359,0,0,0
199808,102,102,0,0,0
199822,310,310,0,0,0
199824,67,67,0,0,0
199825,39,39,0,0,0
199850,4,4,0,0,0
199853,252,252,0,0,0
199858,168,168,0,0,0
199860,103,103,0,0,0
199886,353,353,0,0,0
199902,345,345,0,0,0
199919,36,36,0,0,0
199928,315,315,0,0,0
199933,255,255,0,0,0
199935,102,102,0,0,0
199953,359,359,0,0,0
199965,120,120,0,0,0
199967,198,198,0,0,0
199969,120,120,0,0,0
199975,315,315,0,0,0
199977,345,345,0,0,0
199989,67,67,0,0,0
199992,65,65,0,0,0
199998,44,44,0,0,0
200009,103,103,0,0,0
200012,158,158,0,0,0
200019,2,2,0,0,0
200023,252,252,0,0,0
200068,21,21,0,0,0
200081,255,255,0,0,0
200098,281,281,0,0,0
200103,137,137,0,0,0
200108,121,121,0,0,0
200124,114,114,0,0,0
200133,121,121,0,0,0
200161,72,72,0,0,0
200163,83,83,0,0,0
200167,14,14,0,0,0
200191,70,70,0,0,0
200202,184,184,0,0,0
200205,252,252,0,0,0
200221,77,77,0,0,0
200222,345,345,0,0,0
200225,5,5,0,0,0
200246,56,56,0,0,0
200251,353,353,0,0,0
200271,144,144,0,0,0
200273,198,198,0,0,0
200287,15,15,0,0,0
200291,255,255,0,0,0
200317,168,168,0,0,0
200333,359,359,0,0,0
200348,128,128,0,0,0
200369,151,151,0,0,0
200371,121,121,0,0,0
200386,39,39,0,0,0
200403,168,168,0,0,0
200407,193,193,0,0,0
200413,15,15,0,0,0
200423,310,310,0,0,0
200433,102,102,0,0,0
200463,168,168,0,0,0
200465,18,18,0,0,0
200473,359,359,0,0,0
200486,232,232,0,0,0
200503,4,4,0,0,0
200511,306,306,0,0,0
200523,313,313,0,0,0
200531,143,143,0,0,0
200534,74,74,0,0,0
200537,143,143,0,0,0
200547,45,45,0,0,0
200549,299,299,0,0,0
200562,85,85,0,0,0
200563,25,25,0,0,0
200568,359,359,0,0,0
200575,97,97,0,0,0
200592,12,12,0,0,0
200595,198,198,0,0,0
200602,402,402,0,0,0
200610,232,232,0,0,0
200621,299,299,0,0,0
200629,168,168,0,0,0
200642,57,57,0,0,0
200673,402,402,0,0,0
200687,299,299,0,0,0
200688,76,76,0,0,0
200690,121,121,0,0,0
200695,40,40,0,0,0
200741,198,198,0,0,0
200747,152,152,0,0,0
200765,66,66,0,0,0
200792,402,402,0,0,0
200794,151,151,0,0,0
200830,55,55,0,0,0
200831,259,259,0,0,0
200849,71,71,0,0,0
200863,167,167,0,0,0
200870,402,402,0,0,0
200899,114,114,0,0,0
200902,120,120,0,0,0
200912,402,402,0,0,0
200917,151,151,0,0,0
200922,74,74,0,0,0
200949,120,120,0,0,0
200988,158,158,0,0,0
200992,1,1,0,0,0
201007,94,94,0,0,0
201012,255,255,0,0,0
201028,76,76,0,0,0
201042,101,101,0,0,0
201043,40,40,0,0,0
201045,29,29,0,0,0
201051,299,299,0,0,0
201054,137,137,0,0,0
201057,310,310,0,0,0
201061,103,103,0,0,0
201070,15,15,0,0,0
201077,402,402,0,0,0
201083,193,193,0,0,0
201084,70,70,0,0,0
201087,75,75,0,0,0
201099,5,5,0,0,0
201120,246,246,0,0,0
201123,75,75,0,0,0
201142,35,35,0,0,0
201155,163,163,0,0,0
201168,114,114,0,0,0
201178,345,345,0,0,0
201179,180,180,0,0,0
201218,2,2,0,0,0
201220,315,315,0,0,0
201228,34,34,0,0,0
201231,36,36,0,0,0
201239,3,3,0,0,0
201253,39,39,0,0,0
201261,251,251,0,0,0
201265,94,94,0,0,0
201274,180,180,0,0,0
201275,345,345,0,0,0
201284,251,251,0,0,0
201293,14,14,0,0,0
201307,315,315,0,0,0
201317,120,120,0,0,0
201339,313,313,0,0,0
201341,55,55,0,0,0
201342,402,402,0,0,0
201343,299,299,0,0,0
201349,168,168,0,0,0
201360,353,353,0,0,0
201368,85,85,0,0,0
201414,16,16,0,0,0
201441,282,282,0,0,0
201450,246,246,0,0,0
201452,310,310,0,0,0
201455,128,128,0,0,0
201457,171,171,0,0,0
201459,113,113,0,0,0
201464,306,306,0,0,0
201472,282,282,0,0,0
201475,12,12,0,0,0
201485,65,65,0,0,0
201487,13,13,0,0,0
201494,402,402,0,0,0
201497,30,30,0,0,0
201514,69,69,0,0,0
201534,282,282,0,0,0
201548,201,201,0,0,0
201554,113,113,0,0,0
201564,167,167,0,0,0
201567,70,70,0,0,0
201590,66,66,0,0,0
201605,36,36,0,0,0
201612,82,82,0,0,0
201620,10,10,0,0,0
201624,113,113,0,0,0
201626,76,76,0,0,0
201635,44,44,0,0,0
201648,281,281,0,0,0
201651,315,315,0,0,0
201654,402,402,0,0,0
201656,306,306,0,0,0
201665,353,353,0,0,0
201698,114,114,0,0,0
201732,180,180,0,0,0
201734,7,7,0,0,0
201746,315,315,0,0,0
201779,198,198,0,0,0
201793,114,114,0,0,0
201794,281,281,0,0,0
201799,17,17,0,0,0
201826,36,36,0,0,0
201827,55,55,0,0,0
201830,2,2,0,0,0
201885,72,72,0,0,0
201887,402,402,0,0,0
201901,402,402,0,0,0
201927,137,137,0,0,0
201932,184,184,0,0,0
201935,402,402,0,0,0
201941,282,282,0,0,0
201953,299,299,0,0,0
201973,282,282,0,0,0
202017,152,152,0,0,0
202026,39,39,0,0,0
202027,281,281,0,0,0
202029,35,35,0,0,0
202061,131,131,0,0,0
202071,14,14,0,0,0
202088,128,128,0,0,0
202092,251,251,0,0,0
202093,306,306,0,0,0
202105,76,76,0,0,0
202116,27,27,0,0,0
202147,152,152,0,0,0
202159,22,22,0,0,0
202209,158,158,0,0,0
202210,152,152,0,0,0
202214,252,252,0,0,0
202217,281,281,0,0,0
202222,113,113,0,0,0
202226,299,299,0,0,0
202242,20,20,0,0,0
202251,77,77,0,0,0
202253,20,20,0,0,0
202256,151,151,0,0,0
202276,232,232,0,0,0
202299,58,58,0,0,0
202305,310,310,0,0,0
202309,167,167,0,0,0
202318,121,121,0,0,0
202324,15,15,0,0,0
202352,315,315,0,0,0
202382,163,163,0,0,0
202383,85,85,0,0,0
202388,17,17,0,0,0
202397,158,158,0,0,0
202406,259,259,0,0,0
202437,180,180,0,0,0
202446,359,359,0,0,0
202448,198,198,0,0,0
202464,114,114,0,0,0
202471,313,313,0,0,0
202480,299,299,0,0,0
202491,255,255,0,0,0
202496,121,121,0,0,0
202501,144,144,0,0,0
202503,102,102,0,0,0
202522,171,171,0,0,0
202526,180,180,0,0,0
202532,345,345,0,0,0
202545,34,34,0,0,0
202547,101,101,0,0,0
202554,4,4,0,0,0
202561,85,85,0,0,0
202564,184,184,0,0,0
202574,201,201,0,0,0
202614,12,12,0,0,0
202615,3,3,0,0,0
202621,132,132,0,0,0
202629,76,76,0,0,0
202647,132,132,0,0,0
202649,201,201,0,0,0
202650,282,282,0,0,0
202653,130,130,0,0,0
202672,57,57,0,0,0
202674,66,66,0,0,0
202675,345,345,0,0,0
202682,180,180,0,0,0
202684,246,246,0,0,0
202687,255,255,0,0,0
202715,306,306,0,0,0
202716,75,75,0,0,0
202720,313,313,0,0,0
202725,168,168,0,0,0
202731,171,171,0,0,0
202761,246,246,0,0,0
202770,19,19,0,0,0
202776,101,101,0,0,0
202777,402,402,0,0,0
202787,315,315,0,0,0
202818,54,54,0,0,0
202826,353,353,0,0,0
202834,121,121,0,0,0
202856,63,63,0,0,0
202857,6,6,0,0,0
202863,315,315,0,0,0
202875,168,168,0,0,0
202886,19,19,0,0,0
202888,27,27,0,0,0
202909,77,77,0,0,0
202922,121,121,0,0,0
202927,43,43,0,0,0
202935,402,402,0,0,0
202947,85,85,0,0,0
202949,44,44,0,0,0
202954,97,97,0,0,0
202969,345,345,0,0,0
202976,306,306,0,0,0
202982,75,75,0,0,0
202985,201,201,0,0,0
202998,102,102,0,0,0
203000,128,128,0,0,0
203004,76,76,0,0,0
203017,54,54,0,0,0
203024,102,102,0,0,0
203031,315,315,0,0,0
203037,56,56,0,0,0
203057,76,76,0,0,0
203069,299,299,0,0,0
203076,76,76,0,0,0
203077,299,299,0,0,0
203099,232,232,0,0,0
203110,120,120,0,0,0
203114,151,151,0,0,0
203119,143,143,0,0,0
203120,313,313,0,0,0
203129,8,8,0,0,0
203139,232,232,0,0,0
203156,359,359,0,0,0
203165,299,299,0,0,0
203167,102,102,0,0,0
203212,201,201,0,0,0
203220,232,232,0,0,0
203229,251,251,0,0,0
203266,345,345,0,0,0
203271,77,77,0,0,0
203277,306,306,0,0,0
203304,168,168,0,0,0
203318,306,306,0,0,0
203328,232,232,0,0,0
203342,255,255,0,0,0
203351,232,232,0,0,0
203356,259,259,0,0,0
203368,299,299,0,0,0
203371,259,259,0,0,0
203374,353,353,0,0,0
203382,137,137,0,0,0
203411,65,65,0,0,0
203412,353,353,0,0,0
203416,76,76,0,0,0
203435,353,353,0,0,0
203466,69,69,0,0,0
203475,74,74,0,0,0
203481,255,255,0,0,0
203505,24,24,0,0,0
203513,44,44,0,0,0
203539,167,167,0,0,0
203547,313,313,0,0,0
203550,353,353,0,0,0
203552,114,114,0,0,0
203559,252,252,0,0,0
203565,144,144,0,0,0
203568,282,282,0,0,0
203578,10,10,0,0,0
203599,103,103,0,0,0
203613,313,313,0,0,0
203633,54,54,0,0,0
203651,58,58,0,0,0
203653,131,131,0,0,0
203654,198,198,0,0,0
203672,15,15,0,0,0
203678,113,113,0,0,0
203685,120,120,0,0,0
203702,132,132,0,0,0
203717,251,251,0,0,0
203729,12,12,0,0,0
203730,56,56,0,0,0
203731,313,313,0,0,0
203733,121,121,0,0,0
203738,255,255,0,0,0
203747,282,282,0,0,0
203758,102,102,0,0,0
203766,232,232,0,0,0
203775,87,87,0,0,0
203776,97,97,0,0,0
203784,252,252,0,0,0
203792,168,168,0,0,0
203795,121,121,0,0,0
203806,43,43,0,0,0
203823,121,121,0,0,0
203824,345,345,0,0,0
203846,76,76,0,0,0
203857,193,193,0,0,0
203861,57,57,0,0,0
203870,10,10,0,0,0
203880,193,193,0,0,0
203884,315,315,0,0,0
203894,193,193,0,0,0
203896,65,65,0,0,0
203900,16,16,0,0,0
203907,74,74,0,0,0
203925,56,56,0,0,0
203938,22,22,0,0,0
203942,353,353,0,0,0
203954,345,345,0,0,0
203955,251,251,0,0,0
203956,252,252,0,0,0
203963,151,151,0,0,0
203972,54,54,0,0,0
203982,101,101,0,0,0
203988,345,345,0,0,0
204007,158,158,0,0,0
204009,57,57,0,0,0
204011,87,87,0,0,0
204016,310,310,0,0,0
204066,102,102,0,0,0
204100,259,259,0,0,0
204111,193,193,0,0,0
204150,15,15,0,0,0
204159,310,310,0,0,0
204173,310,310,0,0,0
204180,114,114,0,0,0
204192,252,252,0,0,0
204197,232,232,0,0,0
204208,402,402,0,0,0
204216,152,152,0,0,0
204221,97,97,0,0,0
204231,315,315,0,0,0
204238,102,102,0,0,0
204248,21,21,0,0,0
204249,63,63,0,0,0
204264,121,121,0,0,0
204265,58,58,0,0,0
204283,310,310,0,0,0
204294,310,310,0,0,0
204309,16,16,0,0,0
204318,76,76,0,0,0
204325,151,151,0,0,0
204330,353,353,0,0,0
204331,168,168,0,0,0
204337,15,15,0,0,0
204342,76,76,0,0,0
204348,313,313,0,0,0
204362,137,137,0,0,0
204382,402,402,0,0,0
204391,306,306,0,0,0
204392,345,345,0,0,0
204397,313,313,0,0,0
204405,72,72,0,0,0
204413,24,24,0,0,0
204425,74,74,0,0,0
204429,128,128,0,0,0
204432,34,34,0,0,0
204448,259,259,0,0,0
204452,167,167,0,0,0
204454,353,353,0,0,0
204458,102,102,0,0,0
204482,299,299,0,0,0
204502,121,121,0,0,0
204525,201,201,0,0,0
204544,85,85,0,0,0
204549,74,74,0,0,0
204566,198,198,0,0,0
204569,114,114,0,0,0
204575,167,167,0,0,0
204591,201,201,0,0,0
204603,232,232,0,0,0
204608,24,24,0,0,0
204617,66,66,0,0,0
204618,251,251,0,0,0
204626,102,102,0,0,0
204646,128,128,0,0,0
204665,102,102,0,0,0
204666,85,85,0,0,0
204677,282,282,0,0,0
204689,55,55,0,0,0
204693,7,7,0,0,0
204694,17,17,0,0,0
204705,180,180,0,0,0
204736,10,10,0,0,0
204739,168,168,0,0,0
204762,232,232,0,0,0
204770,76,76,0,0,0
204776,201,201,0,0,0
204778,167,167,0,0,0
204779,87,87,0,0,0
204796,103,103,0,0,0
204819,402,402,0,0,0
204829,30,30,0,0,0
204847,402,402,0,0,0
204857,30,30,0,0,0
204860,282,282,0,0,0
204864,102,102,0,0,0
204884,103,103,0,0,0
204890,313,313,0,0,0
204897,103,103,0,0,0
204922,168,168,0,0,0
204946,44,44,0,0,0
204970,310,310,0,0,0
204979,353,353,0,0,0
204980,36,36,0,0,0
205024,43,43,0,0,0
205044,402,402,0,0,0
205056,1,1,0,0,0
205069,102,102,0,0,0
205094,353,353,0,0,0
205104,34,34,0,0,0
205111,184,184,0,0,0
205113,28,28,0,0,0
205151,82,82,0,0,0
205171,70,70,0,0,0
205185,152,152,0,0,0
205198,143,143,0,0,0
205222,16,16,0,0,0
205228,72,72,0,0,0
205233,313,313,0,0,0
205246,180,180,0,0,0
205253,45,45,0,0,0
205265,315,315,0,0,0
205269,74,74,0,0,0
205273,137,137,0,0,0
205276,180,180,0,0,0
205286,120,120,0,0,0
205307,102,102,0,0,0
205310,63,63,0,0,0
205325,15,15,0,0,0
205353,114,114,0,0,0
205361,72,72,0,0,0
205378,152,152,0,0,0
205384,255,255,0,0,0
205395,359,359,0,0,0
205409,133,133,0,0,0
205440,252,252,0,0,0
205442,28,28,0,0,0
205449,13,13,0,0,0
205456,74,74,0,0,0
205463,359,359,0,0,0
205467,252,252,0,0,0
205474,137,137,0,0,0
205491,14,14,0,0,0
205498,50,50,0,0,0
205500,171,171,0,0,0
205504,66,66,0,0,0
205511,35,35,0,0,0
205521,255,255,0,0,0
205537,251,251,0,0,0
205544,54,54,0,0,0
205553,282,282,0,0,0
205559,252,252,0,0,0
205565,103,103,0,0,0
205581,167,167,0,0,0
205596,63,63,0,0,0
205602,402,402,0,0,0
205614,29,29,0,0,0
205631,70,70,0,0,0
205636,193,193,0,0,0
205647,251,251,0,0,0
205688,113,113,0,0,0
205690,282,282,0,0,0
205698,24,24,0,0,0
205699,43,43,0,0,0
205707,70,70,0,0,0
205739,282,282,0,0,0
205749,310,310,0,0,0
205751,193,193,0,0,0
205759,50,50,0,0,0
205764,163,163,0,0,0
205780,121,121,0,0,0
205789,137,137,0,0,0
205791,94,94,0,0,0
205796,34,34,0,0,0
205806,198,198,0,0,0
205833,70,70,0,0,0
205870,201,201,0,0,0
205873,74,74,0,0,0
205907,151,151,0,0,0
205909,19,19,0,0,0
205918,282,282,0,0,0
205919,66,66,0,0,0
205922,27,27,0,0,0
205968,4,4,0,0,0
206014,16,16,0,0,0
206022,27,27,0,0,0
206026,171,171,0,0,0
206031,10,10,0,0,0
206038,251,251,0,0,0
206047,158,158,0,0,0
206050,163,163,0,0,0
206068,151,151,0,0,0
206072,67,67,0,0,0
206081,299,299,0,0,0
206096,43,43,0,0,0
206114,19,19,0,0,0
206116,20,20,0,0,0
206120,56,56,0,0,0
206124,163,163,0,0,0
206130,43,43,0,0,0
206134,56,56,0,0,0
206140,198,198,0,0,0
206141,306,306,0,0,0
206151,353,353,0,0,0
206159,353,353,0,0,0
206162,315,315,0,0,0
206169,30,30,0,0,0
206171,41,41,0,0,0
206174,310,310,0,0,0
206202,5,5,0,0,0
206229,184,184,0,0,0
206232,137,137,0,0,0
206241,144,144,0,0,0
206268,313,313,0,0,0
206281,137,137,0,0,0
206291,15,15,0,0,0
206293,402,402,0,0,0
206301,27,27,0,0,0
206320,2,2,0,0,0
206326,299,299,0,0,0
206328,36,36,0,0,0
206331,167,167,0,0,0
206336,1,1,0,0,0
206343,299,299,0,0,0
206353,315,315,0,0,0
206369,402,402,0,0,0
206374,310,310,0,0,0
206377,35,35,0,0,0
206395,83,83,0,0,0
206400,114,114,0,0,0
206409,132,132,0,0,0
206411,168,168,0,0,0
206426,102,102,0,0,0
206436,120,120,0,0,0
206446,5,5,0,0,0
206449,128,128,0,0,0
206451,310,310,0,0,0
206454,44,44,0,0,0
206471,232,232,0,0,0
206503,16,16,0,0,0
206523,35,35,0,0,0
206525,359,359,0,0,0
206542,9,9,0,0,0
206548,402,402,0,0,0
206558,198,198,0,0,0
206570,359,359,0,0,0
206572,402,402,0,0,0
206584,232,232,0,0,0
206605,27,27,0,0,0
206629,152,152,0,0,0
206644,137,137,0,0,0
206659,72,72,0,0,0
206674,198,198,0,0,0
206685,133,133,0,0,0
206710,151,151,0,0,0
206715,58,58,0,0,0
206718,180,180,0,0,0
206723,131,131,0,0,0
206725,345,345,0,0,0
206732,232,232,0,0,0
206762,282,282,0,0,0
206776,259,259,0,0,0
206786,137,137,0,0,0
206790,85,85,0,0,0
206814,144,144,0,0,0
206815,251,251,0,0,0
206821,315,315,0,0,0
206834,359,359,0,0,0
206841,18,18,0,0,0
206852,151,151,0,0,0
206856,201,201,0,0,0
206863,158,158,0,0,0
206873,232,232,0,0,0
206898,184,184,0,0,0
206906,252,252,0,0,0
206924,152,152,0,0,0
206925,131,131,0,0,0
206936,55,55,0,0,0
206940,353,353,0,0,0
206941,4,4,0,0,0
206945,143,143,0,0,0
206950,353,353,0,0,0
206955,168,168,0,0,0
206985,50,50,0,0,0
206999,43,43,0,0,0
207005,85,85,0,0,0
207015,255,255,0,0,0
207023,14,14,0,0,0
207025,29,29,0,0,0
207031,232,232,0,0,0
207056,71,71,0,0,0
207060,313,313,0,0,0
207065,12,12,0,0,0
207066,130,130,0,0,0
207085,143,143,0,0,0
207086,402,402,0,0,0
207090,72,72,0,0,0
207108,120,120,0,0,0
207110,82,82,0,0,0
207113,232,232,0,0,0
207115,345,345,0,0,0
207125,252,252,0,0,0
207135,232,232,0,0,0
207154,55,55,0,0,0
207155,402,402,0,0,0
207171,4,4,0,0,0
207182,282,282,0,0,0
207194,353,353,0,0,0
207204,345,345,0,0,0
207211,299,299,0,0,0
207212,102,102,0,0,0
207227,359,359,0,0,0
207236,74,74,0,0,0
207270,313,313,0,0,0
207278,101,101,0,0,0
207286,246,246,0,0,0
207290,75,75,0,0,0
207302,22,22,0,0,0
207305,306,306,0,0,0
207335,39,39,0,0,0
207360,12,12,0,0,0
207365,281,281,0,0,0
207377,359,359,0,0,0
207382,168,168,0,0,0
207383,57,57,0,0,0
207398,310,310,0,0,0
207442,281,281,0,0,0
207502,7,7,0,0,0
207535,137,137,0,0,0
207552,85,85,0,0,0
207553,198,198,0,0,0
207560,15,15,0,0,0
207580,184,184,0,0,0
207602,198,198,0,0,0
207611,167,167,0,0,0
207622,313,313,0,0,0
207634,9,9,0,0,0
207641,137,137,0,0,0
207659,168,168,0,0,0
207670,193,193,0,0,0
207697,11,11,0,0,0
207705,252,252,0,0,0
207721,50,50,0,0,0
207722,299,299,0,0,0
207733,193,193,0,0,0
207738,6,6,0,0,0
207742,345,345,0,0,0
207768,299,299,0,0,0
207784,63,63,0,0,0
207789,7,7,0,0,0
207800,282,282,0,0,0
207804,39,39,0,0,0
207805,310,310,0,0,0
207808,359,359,0,0,0
207811,102,102,0,0,0
207834,82,82,0,0,0
207835,359,359,0,0,0
207836,184,184,0,0,0
207841,5,5,0,0,0
207843,259,259,0,0,0
207864,35,35,0,0,0
207870,251,251,0,0,0
207872,55,55,0,0,0
207874,167,167,0,0,0
207888,144,144,0,0,0
207895,167,167,0,0,0
207902,35,35,0,0,0
207924,101,101,0,0,0
207926,198,198,0,0,0
207941,201,201,0,0,0
207946,102,102,0,0,0
207964,163,163,0,0,0
207983,158,158,0,0,0
207992,259,259,0,0,0
208019,29,29,0,0,0
208036,353,353,0,0,0
208037,23,23,0,0,0
208054,163,163,0,0,0
208057,75,75,0,0,0
208065,402,402,0,0,0
208068,198,198,0,0,0
208070,193,193,0,0,0
208110,198,198,0,0,0
208130,198,198,0,0,0
208131,143,143,0,0,0
208134,315,315,0,0,0
208165,306,306,0,0,0
208168,50,50,0,0,0
208202,259,259,0,0,0
208243,180,180,0,0,0
208264,71,71,0,0,0
208267,163,163,0,0,0
208298,201,201,0,0,0
208308,113,113,0,0,0
208320,137,137,0,0,0
208322,121,121,0,0,0
208329,310,310,0,0,0
208333,15,15,0,0,0
208335,29,29,0,0,0
208353,251,251,0,0,0
208369,345,345,0,0,0
208373,252,252,0,0,0
208385,152,152,0,0,0
208390,315,315,0,0,0
208410,353,353,0,0,0
208418,198,198,0,0,0
208430,306,306,0,0,0
208437,121,121,0,0,0
208445,36,36,0,0,0
208463,232,232,0,0,0
208488,121,121,0,0,0
208492,74,74,0,0,0
208502,39,39,0,0,0
208526,359,359,0,0,0
208527,131,131,0,0,0
208537,114,114,0,0,0
208561,167,167,0,0,0
208564,402,402,0,0,0
208566,402,402,0,0,0
208578,168,168,0,0,0
208587,158,158,0,0,0
208612,15,15,0,0,0
208630,251,251,0,0,0
208639,246,246,0,0,0
208640,310,310,0,0,0
208647,345,345,0,0,0
208656,35,35,0,0,0
208664,180,180,0,0,0
208674,167,167,0,0,0
208688,27,27,0,0,0
208725,310,310,0,0,0
208743,4,4,0,0,0
208745,102,102,0,0,0
208748,27,27,0,0,0
208765,130,130,0,0,0
208779,113,113,0,0,0
208790,77,77,0,0,0
208793,282,282,0,0,0
208796,252,252,0,0,0
208800,7,7,0,0,0
208804,306,306,0,0,0
208807,102,102,0,0,0
208820,114,114,0,0,0
208835,12,12,0,0,0
208838,55,55,0,0,0
208844,163,163,0,0,0
208849,402,402,0,0,0
208864,171,171,0,0,0
208869,18,18,0,0,0
208877,102,102,0,0,0
208881,180,180,0,0,0
208922,137,137,0,0,0
208933,259,259,0,0,0
208945,255,255,0,0,0
208952,82,82,0,0,0
208972,168,168,0,0,0
208989,101,101,0,0,0
208994,281,281,0,0,0
209006,315,315,0,0,0
209026,402,402,0,0,0
209029,201,201,0,0,0
209042,102,102,0,0,0
209062,19,19,0,0,0
209105,313,313,0,0,0
209131,315,315,0,0,0
209141,259,259,0,0,0
209156,151,151,0,0,0
209158,121,121,0,0,0
209172,345,345,0,0,0
209186,74,74,0,0,0
209206,180,180,0,0,0
209217,10,10,0,0,0
209223,39,39,0,0,0
209233,246,246,0,0,0
209247,282,282,0,0,0
209250,353,353,0,0,0
209272,158,158,0,0,0
209273,313,313,0,0,0
209280,151,151,0,0,0
209340,41,41,0,0,0
209343,152,152,0,0,0
209369,193,193,0,0,0
209372,402,402,0,0,0
209386,76,76,0,0,0
209420,65,65,0,0,0
209427,299,299,0,0,0
209430,22,22,0,0,0
209432,39,39,0,0,0
209442,345,345,0,0,0
209446,103,103,0,0,0
209453,69,69,0,0,0
209468,345,345,0,0,0
209476,359,359,0,0,0
209482,353,353,0,0,0
209490,359,359,0,0,0
209502,55,55,0,0,0
209510,299,299,0,0,0
209512,25,25,0,0,0
209517,102,102,0,0,0
209535,193,193,0,0,0
209546,6,6,0,0,0
209552,97,97,0,0,0
209569,282,282,0,0,0
209594,315,315,0,0,0
209621,19,19,0,0,0
209639,158,158,0,0,0
209652,75,75,0,0,0
209663,402,402,0,0,0
209670,6,6,0,0,0
209672,56,56,0,0,0
209700,152,152,0,0,0
209707,113,113,0,0,0
209708,70,70,0,0,0
209719,313,313,0,0,0
209722,255,255,0,0,0
209730,20,20,0,0,0
209732,121,121,0,0,0
209740,28,28,0,0,0
209771,121,121,0,0,0
209773,259,259,0,0,0
209793,94,94,0,0,0
209794,402,402,0,0,0
209814,315,315,0,0,0
209815,313,313,0,0,0
209822,1,1,0,0,0
209836,299,299,0,0,0
209852,152,152,0,0,0
209855,402,402,0,0,0
209861,152,152,0,0,0
209872,306,306,0,0,0
209873,310,310,0,0,0
209880,201,201,0,0,0
209907,34,34,0,0,0
209921,101,101,0,0,0
209926,232,232,0,0,0
209929,232,232,0,0,0
209949,56,56,0,0,0
209957,306,306,0,0,0
209965,313,313,0,0,0
209971,35,35,0,0,0
210002,130,130,0,0,0
210003,43,43,0,0,0
210011,22,22,0,0,0
210024,246,246,0,0,0
210056,7,7,0,0,0
210064,72,72,0,0,0
210094,151,151,0,0,0
210104,74,74,0,0,0
210149,163,163,0,0,0
210158,41,41,0,0,0
210159,180,180,0,0,0
210160,113,113,0,0,0
210161,34,34,0,0,0
210163,102,102,0,0,0
210165,12,12,0,0,0
210169,128,128,0,0,0
210171,120,120,0,0,0
210183,167,167,0,0,0
210195,281,281,0,0,0
210217,252,252,0,0,0
210244,50,50,0,0,0
210251,151,151,0,0,0
210254,259,259,0,0,0
210260,193,193,0,0,0
210276,121,121,0,0,0
210283,3,3,0,0,0
210287,313,313,0,0,0
210294,94,94,0,0,0
210304,101,101,0,0,0
210315,259,259,0,0,0
210343,246,246,0,0,0
210349,22,22,0,0,0
210358,87,87,0,0,0
210360,41,41,0,0,0
210366,72,72,0,0,0
210369,315,315,0,0,0
210375,143,143,0,0,0
210376,128,128,0,0,0
210380,184,184,0,0,0
210437,25,25,0,0,0
210455,158,158,0,0,0
210457,133,133,0,0,0
210476,313,313,0,0,0
210490,252,252,0,0,0
210510,74,74,0,0,0
210514,56,56,0,0,0
210531,251,251,0,0,0
210540,15,15,0,0,0
210551,85,85,0,0,0
210561,246,246,0,0,0
210566,4,4,0,0,0
210574,315,315,0,0,0
210575,310,310,0,0,0
210604,345,345,0,0,0
210623,353,353,0,0,0
210630,315,315,0,0,0
210654,315,315,0,0,0
210668,137,137,0,0,0
210679,102,102,0,0,0
210689,70,70,0,0,0
210692,45,45,0,0,0
210694,102,102,0,0,0
210700,114,114,0,0,0
210703,167,167,0,0,0
210713,85,85,0,0,0
210720,57,57,0,0,0
210735,120,120,0,0,0
210758,359,359,0,0,0
210766,50,50,0,0,0
210782,281,281,0,0,0
210813,184,184,0,0,0
210822,74,74,0,0,0
210824,158,158,0,0,0
210860,282,282,0,0,0
210862,163,163,0,0,0
210865,198,198,0,0,0
210902,299,299,0,0,0
210904,353,353,0,0,0
210908,103,103,0,0,0
210913,402,402,0,0,0
210914,120,120,0,0,0
210928,85,85,0,0,0
210932,18,18,0,0,0
210939,255,255,0,0,0
210942,94,94,0,0,0
210948,70,70,0,0,0
210965,20,20,0,0,0
210970,9,9,0,0,0
210979,121,121,0,0,0
210981,121,121,0,0,0
210986,282,282,0,0,0
210991,281,281,0,0,0
211013,143,143,0,0,0
211020,18,18,0,0,0
211044,252,252,0,0,0
211060,281,281,0,0,0
211063,353,353,0,0,0
211070,252,252,0,0,0
211078,83,83,0,0,0
211085,402,402,0,0,0
211098,76,76,0,0,0
211105,103,103,0,0,0
211127,40,40,0,0,0
211128,58,58,0,0,0
211130,6,6,0,0,0
211149,259,259,0,0,0
211151,306,306,0,0,0
211153,22,22,0,0,0
211159,66,66,0,0,0
211162,315,315,0,0,0
211170,180,180,0,0,0
211187,130,130,0,0,0
211189,310,310,0,0,0
211192,246,246,0,0,0
211195,128,128,0,0,0
211200,17,17,0,0,0
211218,402,402,0,0,0
211250,113,113,0,0,0
211257,359,359,0,0,0
211262,21,21,0,0,0
211281,167,167,0,0,0
211284,306,306,0,0,0
211285,13,13,0,0,0
211286,402,402,0,0,0
211303,246,246,0,0,0
211325,76,76,0,0,0
211326,251,251,0,0,0
211327,113,113,0,0,0
211328,13,13,0,0,0
211341,281,281,0,0,0
211345,2,2,0,0,0
211353,103,103,0,0,0
211366,232,232,0,0,0
211391,10,10,0,0,0
211397,34,34,0,0,0
211426,315,315,0,0,0
211428,5,5,0,0,0
211429,151,151,0,0,0
211445,29,29,0,0,0
211447,359,359,0,0,0
211466,43,43,0,0,0
211471,12,12,0,0,0
211472,180,180,0,0,0
211477,282,282,0,0,0
211482,193,193,0,0,0
211486,114,114,0,0,0
211497,70,70,0,0,0
211501,310,310,0,0,0
211519,30,30,0,0,0
211531,137,137,0,0,0
211554,246,246,0,0,0
211568,102,102,0,0,0
211578,102,102,0,0,0
211589,193,193,0,0,0
211615,77,77,0,0,0
211616,18,18,0,0,0
211628,66,66,0,0,0
211634,193,193,0,0,0
211650,65,65,0,0,0
211663,171,171,0,0,0
211679,114,114,0,0,0
211680,14,14,0,0,0
211704,167,167,0,0,0
211711,131,131,0,0,0
211737,306,306,0,0,0
211744,14,14,0,0,0
211755,102,102,0,0,0
211778,121,121,0,0,0
211779,137,137,0,0,0
211782,76,76,0,0,0
211793,10,10,0,0,0
211796,121,121,0,0,0
211798,45,45,0,0,0
211816,282,282,0,0,0
211817,281,281,0,0,0
211819,345,345,0,0,0
211842,281,281,0,0,0
211846,163,163,0,0,0
211849,131,131,0,0,0
211892,255,255,0,0,0
211897,13,13,0,0,0
211922,35,35,0,0,0
211944,310,310,0,0,0
211965,120,120,0,0,0
211993,315,315,0,0,0
211994,168,168,0,0,0
211998,22,22,0,0,0
212000,74,74,0,0,0
212026,36,36,0,0,0
212039,143,143,0,0,0
212064,143,143,0,0,0
212066,315,315,0,0,0
212067,246,246,0,0,0
212068,70,70,0,0,0
212077,306,306,0,0,0
212080,72,72,0,0,0
212104,310,310,0,0,0
212105,193,193,0,0,0
212107,102,102,0,0,0
212118,16,16,0,0,0
212121,359,359,0,0,0
212123,22,22,0,0,0
212130,315,315,0,0,0
212147,56,56,0,0,0
212160,11,11,0,0,0
212171,128,128,0,0,0
212172,255,255,0,0,0
212173,402,402,0,0,0
212174,11,11,0,0,0
212198,21,21,0,0,0
212203,55,55,0,0,0
212204,310,310,0,0,0
212214,102,102,0,0,0
212216,252,252,0,0,0
212221,402,402,0,0,0
212238,282,282,0,0,0
212239,201,201,0,0,0
212255,193,193,0,0,0
212263,345,345,0,0,0
212291,255,255,0,0,0
212307,102,102,0,0,0
212309,306,306,0,0,0
212314,120,120,0,0,0
212315,18,18,0,0,0
212329,313,313,0,0,0
212332,282,282,0,0,0
212339,193,193,0,0,0
212347,121,121,0,0,0
212357,152,152,0,0,0
212367,201,201,0,0,0
212387,353,353,0,0,0
212413,201,201,0,0,0
212434,22,22,0,0,0
212486,29,29,0,0,0
212488,85,85,0,0,0
212510,131,131,0,0,0
212511,50,50,0,0,0
212512,21,21,0,0,0
212518,259,259,0,0,0
212527,168,168,0,0,0
212559,130,130,0,0,0
212571,198,198,0,0,0
212589,345,345,0,0,0
212594,54,54,0,0,0
212614,143,143,0,0,0
212634,77,77,0,0,0
212636,23,23,0,0,0
212639,252,252,0,0,0
212646,310,310,0,0,0
212654,18,18,0,0,0
212671,184,184,0,0,0
212692,232,232,0,0,0
212699,345,345,0,0,0
212703,232,232,0,0,0
212723,345,345,0,0,0
212725,143,143,0,0,0
212756,102,102,0,0,0
212758,246,246,0,0,0
212767,359,359,0,0,0
212777,76,76,0,0,0
212790,54,54,0,0,0
212804,184,184,0,0,0
212835,22,22,0,0,0
212849,36,36,0,0,0
212853,63,63,0,0,0
212862,201,201,0,0,0
212872,15,15,0,0,0
212874,8,8,0,0,0
212886,76,76,0,0,0
212915,27,27,0,0,0
212916,20,20,0,0,0
212929,34,34,0,0,0
212935,12,12,0,0,0
212943,402,402,0,0,0
212949,180,180,0,0,0
212952,34,34,0,0,0
212954,128,128,0,0,0
212960,151,151,0,0,0
212992,40,40,0,0,0
213002,345,345,0,0,0
213010,113,113,0,0,0
213024,137,137,0,0,0
213032,282,282,0,0,0
213034,66,66,0,0,0
213053,313,313,0,0,0
213071,67,67,0,0,0
213085,402,402,0,0,0
213108,39,39,0,0,0
213138,32,32,0,0,0
213150,29,29,0,0,0
213155,167,167,0,0,0
213179,306,306,0,0,0
213186,171,171,0,0,0
213207,101,101,0,0,0
213213,299,299,0,0,0
213214,13,13,0,0,0
213229,29,29,0,0,0
213237,259,259,0,0,0
213251,130,130,0,0,0
213260,143,143,0,0,0
213262,402,402,0,0,0
213268,41,41,0,0,0
213303,94,94,0,0,0
213305,359,359,0,0,0
213313,158,158,0,0,0
213336,198,198,0,0,0
213345,306,306,0,0,0
213360,315,315,0,0,0
213363,313,313,0,0,0
213378,299,299,0,0,0
213384,120,120,0,0,0
213398,72,72,0,0,0
213404,180,180,0,0,0
213406,306,306,0,0,0
213414,35,35,0,0,0
213447,137,137,0,0,0
213450,144,144,0,0,0
213468,27,27,0,0,0
213477,76,76,0,0,0
213482,310,310,0,0,0
213483,281,281,0,0,0
213491,128,128,0,0,0
213502,17,17,0,0,0
213510,17,17,0,0,0
213527,4,4,0,0,0
213528,8,8,0,0,0
213532,353,353,0,0,0
213538,41,41,0,0,0
213539,402,402,0,0,0
213547,44,44,0,0,0
213551,252,252,0,0,0
213552,198,198,0,0,0
213553,25,25,0,0,0
213554,299,299,0,0,0
213563,29,29,0,0,0
213601,17,17,0,0,0
213602,353,353,0,0,0
213629,41,41,0,0,0
213632,255,255,0,0,0
213645,56,56,0,0,0
213662,167,167,0,0,0
213666,83,83,0,0,0
213668,163,163,0,0,0
213685,402,402,0,0,0
213695,306,306,0,0,0
213697,299,299,0,0,0
213708,137,137,0,0,0
213720,21,21,0,0,0
213725,69,69,0,0,0
213739,359,359,0,0,0
213741,152,152,0,0,0
213753,402,402,0,0,0
213759,7,7,0,0,0
213782,23,23,0,0,0
213784,74,74,0,0,0
213789,25,25,0,0,0
213804,3,3,0,0,0
213805,180,180,0,0,0
213811,114,114,0,0,0
213822,74,74,0,0,0
213827,163,163,0,0,0
213836,77,77,0,0,0
213840,27,27,0,0,0
213850,9,9,0,0,0
213863,255,255,0,0,0
213866,246,246,0,0,0
213872,97,97,0,0,0
213878,132,132,0,0,0
213881,255,255,0,0,0
213882,255,255,0,0,0
213901,353,353,0,0,0
213918,180,180,0,0,0
213920,128,128,0,0,0
213922,402,402,0,0,0
213926,82,82,0,0,0
213932,402,402,0,0,0
213946,131,131,0,0,0
213962,55,55,0,0,0
213995,121,121,0,0,0
214014,252,252,0,0,0
214016,201,201,0,0,0
214021,137,137,0,0,0
214028,402,402,0,0,0
214044,281,281,0,0,0
214048,102,102,0,0,0
214054,97,97,0,0,0
214059,281,281,0,0,0
214069,133,133,0,0,0
214076,67,67,0,0,0
214079,299,299,0,0,0
214085,70,70,0,0,0
214094,313,313,0,0,0
214096,198,198,0,0,0
214118,313,313,0,0,0
214144,158,158,0,0,0
214146,2,2,0,0,0
214163,345,345,0,0,0
214171,16,16,0,0,0
214174,74,74,0,0,0
214190,359,359,0,0,0
214192,171,171,0,0,0
214195,313,313,0,0,0
214204,232,232,0,0,0
214217,184,184,0,0,0
214220,114,114,0,0,0
214223,57,57,0,0,0
214227,25,25,0,0,0
214241,310,310,0,0,0
214243,133,133,0,0,0
214246,315,315,0,0,0
214250,313,313,0,0,0
214253,246,246,0,0,0
214255,353,353,0,0,0
214261,9,9,0,0,0
214268,345,345,0,0,0
214283,14,14,0,0,0
214296,55,55,0,0,0
214319,101,101,0,0,0
214321,121,121,0,0,0
214322,120,120,0,0,0
214331,313,313,0,0,0
214335,232,232,0,0,0
214383,5,5,0,0,0
214394,113,113,0,0,0
214396,306,306,0,0,0
214399,184,184,0,0,0
214403,82,82,0,0,0
214421,114,114,0,0,0
214423,255,255,0,0,0
214442,103,103,0,0,0
214449,1,1,0,0,0
214459,114,114,0,0,0
214492,130,130,0,0,0
214499,259,259,0,0,0
214509,55,55,0,0,0
214513,151,151,0,0,0
214545,76,76,0,0,0
214546,137,137,0,0,0
214550,353,353,0,0,0
214569,6,6,0,0,0
214572,97,97,0,0,0
214576,313,313,0,0,0
214603,97,97,0,0,0
214609,7,7,0,0,0
214611,299,299,0,0,0
214627,12,12,0,0,0
214636,13,13,0,0,0
214685,167,167,0,0,0
214714,152,152,0,0,0
214720,184,184,0,0,0
214737,306,306,0,0,0
214742,143,143,0,0,0
214743,251,251,0,0,0
214748,137,137,0,0,0
214778,345,345,0,0,0
214814,137,137,0,0,0
214817,152,152,0,0,0
214818,137,137,0,0,0
214826,130,130,0,0,0
214834,39,39,0,0,0
214837,306,306,0,0,0
214840,281,281,0,0,0
214870,17,17,0,0,0
214880,246,246,0,0,0
214908,282,282,0,0,0
214915,315,315,0,0,0
214926,315,315,0,0,0
214934,232,232,0,0,0
214937,43,43,0,0,0
214955,7,7,0,0,0
214997,2,2,0,0,0
214998,252,252,0,0,0
215000,232,232,0,0,0
215007,281,281,0,0,0
215020,137,137,0,0,0
215049,198,198,0,0,0
215050,299,299,0,0,0
215057,101,101,0,0,0
215059,281,281,0,0,0
215063,259,259,0,0,0
215083,306,306,0,0,0
215103,130,130,0,0,0
215119,1,1,0,0,0
215130,70,70,0,0,0
215133,113,113,0,0,0
215151,121,121,0,0,0
215156,255,255,0,0,0
215169,310,310,0,0,0
215175,251,251,0,0,0
215192,359,359,0,0,0
215200,359,359,0,0,0
215202,252,252,0,0,0
215210,71,71,0,0,0
215221,246,246,0,0,0
215239,70,70,0,0,0
215249,163,163,0,0,0
215263,16,16,0,0,0
215273,74,74,0,0,0
215283,402,402,0,0,0
215286,359,359,0,0,0
215292,131,131,0,0,0
215296,103,103,0,0,0
215300,201,201,0,0,0
215302,12,12,0,0,0
215334,144,144,0,0,0
215341,63,63,0,0,0
215354,3,3,0,0,0
215357,184,184,0,0,0
215361,281,281,0,0,0
215363,131,131,0,0,0
215389,180,180,0,0,0
215421,55,55,0,0,0
215426,313,313,0,0,0
215437,232,232,0,0,0
215442,21,21,0,0,0
215445,201,201,0,0,0
215450,18,18,0,0,0
215461,87,87,0,0,0
215462,44,44,0,0,0
215465,151,151,0,0,0
215484,24,24,0,0,0
215487,6,6,0,0,0
215501,7,7,0,0,0
215510,72,72,0,0,0
215568,76,76,0,0,0
215569,246,246,0,0,0
215585,359,359,0,0,0
215588,359,359,0,0,0
215596,72,72,0,0,0
215620,198,198,0,0,0
215623,198,198,0,0,0
215636,193,193,0,0,0
215645,313,313,0,0,0
215652,152,152,0,0,0
215664,232,232,0,0,0
215670,137,137,0,0,0
215680,137,137,0,0,0
215681,3,3,0,0,0
215709,94,94,0,0,0
215711,7,7,0,0,0
215737,345,345,0,0,0
215743,63,63,0,0,0
215758,310,310,0,0,0
215764,9,9,0,0,0
215777,113,113,0,0,0
215804,282,282,0,0,0
215811,353,353,0,0,0
215819,34,34,0,0,0
215853,101,101,0,0,0
215856,151,151,0,0,0
215885,402,402,0,0,0
215897,54,54,0,0,0
215902,44,44,0,0,0
215912,315,315,0,0,0
215916,82,82,0,0,0
215919,151,151,0,0,0
215932,282,282,0,0,0
215934,310,310,0,0,0
215937,50,50,0,0,0
215956,94,94,0,0,0
215962,29,29,0,0,0
215964,101,101,0,0,0
215965,137,137,0,0,0
215976,72,72,0,0,0
215977,103,103,0,0,0
216000,345,345,0,0,0
216007,77,77,0,0,0
216018,315,315,0,0,0
216051,24,24,0,0,0
216053,168,168,0,0,0
216054,10,10,0,0,0
216066,114,114,0,0,0
216083,310,310,0,0,0
216106,353,353,0,0,0
216111,4,4,0,0,0
216112,299,299,0,0,0
216113,402,402,0,0,0
216127,163,163,0,0,0
216164,255,255,0,0,0
216165,102,102,0,0,0
216170,65,65,0,0,0
216173,22,22,0,0,0
216177,65,65,0,0,0
216206,310,310,0,0,0
216228,306,306,0,0,0
216231,282,282,0,0,0
216244,131,131,0,0,0
216245,121,121,0,0,0
216281,359,359,0,0,0
216308,251,251,0,0,0
216322,30,30,0,0,0
216326,151,151,0,0,0
216332,345,345,0,0,0
216348,39,39,0,0,0
216354,137,137,0,0,0
216359,25,25,0,0,0
216365,102,102,0,0,0
216370,252,252,0,0,0
216378,137,137,0,0,0
216382,306,306,0,0,0
216456,353,353,0,0,0
216458,259,259,0,0,0
216522,198,198,0,0,0
216527,402,402,0,0,0
216529,137,137,0,0,0
216562,281,281,0,0,0
216569,402,402,0,0,0
216585,131,131,0,0,0
216586,130,130,0,0,0
216589,29,29,0,0,0
216590,353,353,0,0,0
216593,306,306,0,0,0
216594,201,201,0,0,0
216616,97,97,0,0,0
216618,97,97,0,0,0
216630,180,180,0,0,0
216632,76,76,0,0,0
216680,102,102,0,0,0
216681,167,167,0,0,0
216689,198,198,0,0,0
216695,167,167,0,0,0
216699,345,345,0,0,0
216739,18,18,0,0,0
216747,67,67,0,0,0
216767,83,83,0,0,0
216774,55,55,0,0,0
216824,345,345,0,0,0
216868,315,315,0,0,0
216873,167,167,0,0,0
216874,128,128,0,0,0
216888,137,137,0,0,0
216896,299,299,0,0,0
216914,74,74,0,0,0
216954,8,8,0,0,0
216955,102,102,0,0,0
216957,70,70,0,0,0
216958,121,121,0,0,0
216968,168,168,0,0,0
216978,137,137,0,0,0
216981,17,17,0,0,0
216984,83,83,0,0,0
216985,167,167,0,0,0
216997,251,251,0,0,0
217014,353,353,0,0,0
217035,299,299,0,0,0
217045,66,66,0,0,0
217050,66,66,0,0,0
217053,167,167,0,0,0
217058,313,313,0,0,0
217059,44,44,0,0,0
217096,353,353,0,0,0
217102,19,19,0,0,0
217104,198,198,0,0,0
217105,143,143,0,0,0
217112,281,281,0,0,0
217122,151,151,0,0,0
217123,131,131,0,0,0
217127,306,306,0,0,0
217140,402,402,0,0,0
217147,255,255,0,0,0
217157,128,128,0,0,0
217160,255,255,0,0,0
217164,113,113,0,0,0
217169,259,259,0,0,0
217172,259,259,0,0,0
217182,131,131,0,0,0
217193,7,7,0,0,0
217215,45,45,0,0,0
217228,167,167,0,0,0
217232,353,353,0,0,0
217248,299,299,0,0,0
217251,19,19,0,0,0
217255,232,232,0,0,0
217262,353,353,0,0,0
217265,12,12,0,0,0
217282,201,201,0,0,0
217285,12,12,0,0,0
217287,25,25,0,0,0
217288,246,246,0,0,0
217322,58,58,0,0,0
217336,282,282,0,0,0
217345,14,14,0,0,0
217348,3,3,0,0,0
217356,232,232,0,0,0
217357,232,232,0,0,0
217365,359,359,0,0,0
217376,143,143,0,0,0
217379,353,353,0,0,0
217384,34,34,0,0,0
217440,345,345,0,0,0
217482,158,158,0,0,0
217516,259,259,0,0,0
217524,121,121,0,0,0
217541,102,102,0,0,0
217546,259,259,0,0,0
217548,353,353,0,0,0
217557,83,83,0,0,0
217560,11,11,0,0,0
217569,167,167,0,0,0
217570,402,402,0,0,0
217574,66,66,0,0,0
217575,25,25,0,0,0
217577,13,13,0,0,0
217581,306,306,0,0,0
217597,19,19,0,0,0
217601,168,168,0,0,0
217619,131,131,0,0,0
217634,255,255,0,0,0
217661,137,137,0,0,0
217665,66,66,0,0,0
217690,74,74,0,0,0
217696,114,114,0,0,0
217699,167,167,0,0,0
217704,16,16,0,0,0
217724,43,43,0,0,0
217727,74,74,0,0,0
217730,76,76,0,0,0
217737,359,359,0,0,0
217741,180,180,0,0,0
217744,310,310,0,0,0
217768,34,34,0,0,0
217770,20,20,0,0,0
217776,50,50,0,0,0
217814,44,44,0,0,0
217818,232,232,0,0,0
217819,345,345,0,0,0
217824,315,315,0,0,0
217834,282,282,0,0,0
217866,313,313,0,0,0
217872,29,29,0,0,0
217884,281,281,0,0,0
217893,345,345,0,0,0
217900,252,252,0,0,0
217902,45,45,0,0,0
217925,306,306,0,0,0
217935,167,167,0,0,0
217968,17,17,0,0,0
217969,252,252,0,0,0
217995,152,152,0,0,0
217998,167,167,0,0,0
218000,137,137,0,0,0
218002,402,402,0,0,0
218012,345,345,0,0,0
218024,167,167,0,0,0
218026,310,310,0,0,0
218030,259,259,0,0,0
218041,313,313,0,0,0
218059,184,184,0,0,0
218068,36,36,0,0,0
218071,353,353,0,0,0
218084,1,1,0,0,0
218105,44,44,0,0,0
218110,353,353,0,0,0
218116,193,193,0,0,0
218118,9,9,0,0,0
218149,56,56,0,0,0
218158,9,9,0,0,0
218166,55,55,0,0,0
218181,163,163,0,0,0
218182,1,1,0,0,0
218196,232,232,0,0,0
218201,359,359,0,0,0
218226,402,402,0,0,0
218234,144,144,0,0,0
218236,193,193,0,0,0
218240,310,310,0,0,0
218252,63,63,0,0,0
218259,1,1,0,0,0
218288,18,18,0,0,0
218294,353,353,0,0,0
218297,97,97,0,0,0
218302,18,18,0,0,0
218309,315,315,0,0,0
218316,101,101,0,0,0
218320,310,310,0,0,0
218329,2,2,0,0,0
218366,6,6,0,0,0
218373,55,55,0,0,0
218378,87,87,0,0,0
218389,113,113,0,0,0
218396,128,128,0,0,0
218399,259,259,0,0,0
218403,359,359,0,0,0
218408,137,137,0,0,0
218424,232,232,0,0,0
218428,246,246,0,0,0
218448,281,281,0,0,0
218463,74,74,0,0,0
218473,39,39,0,0,0
218479,121,121,0,0,0
218488,72,72,0,0,0
218498,114,114,0,0,0
218505,255,255,0,0,0
218514,252,252,0,0,0
218524,402,402,0,0,0
218530,255,255,0,0,0
218581,306,306,0,0,0
218587,282,282,0,0,0
218631,137,137,0,0,0
218640,72,72,0,0,0
218653,44,44,0,0,0
218655,299,299,0,0,0
218681,252,252,0,0,0
218689,29,29,0,0,0
218696,114,114,0,0,0
218739,313,313,0,0,0
218745,282,282,0,0,0
218747,171,171,0,0,0
218748,43,43,0,0,0
218755,167,167,0,0,0
218799,151,151,0,0,0
218801,39,39,0,0,0
218809,306,306,0,0,0
218817,54,54,0,0,0
218827,353,353,0,0,0
218830,69,69,0,0,0
218833,198,198,0,0,0
218848,144,144,0,0,0
218863,50,50,0,0,0
218877,158,158,0,0,0
218879,8,8,0,0,0
218880,97,97,0,0,0
218882,252,252,0,0,0
218902,201,201,0,0,0
218925,198,198,0,0,0
218930,4,4,0,0,0
218942,201,201,0,0,0
218959,193,193,0,0,0
218974,282,282,0,0,0
218976,315,315,0,0,0
218982,198,198,0,0,0
218989,7,7,0,0,0
218997,163,163,0,0,0
219001,353,353,0,0,0
219004,83,83,0,0,0
219005,193,193,0,0,0
219010,281,281,0,0,0
219039,255,255,0,0,0
219053,198,198,0,0,0
219059,5,5,0,0,0
219066,310,310,0,0,0
219094,402,402,0,0,0
219121,168,168,0,0,0
219131,168,168,0,0,0
219135,19,19,0,0,0
219161,353,353,0,0,0
219163,345,345,0,0,0
219233,82,82,0,0,0
219247,353,353,0,0,0
219251,353,353,0,0,0
219253,102,102,0,0,0
219254,44,44,0,0,0
219259,255,255,0,0,0
219274,114,114,0,0,0
219281,56,56,0,0,0
219327,402,402,0,0,0
219371,345,345,0,0,0
219379,310,310,0,0,0
219389,359,359,0,0,0
219390,85,85,0,0,0
219393,102,102,0,0,0
219399,310,310,0,0,0
219412,41,41,0,0,0
219420,15,15,0,0,0
219431,18,18,0,0,0
219443,114,114,0,0,0
219444,353,353,0,0,0
219455,87,87,0,0,0
219456,259,259,0,0,0
219457,180,180,0,0,0
219476,15,15,0,0,0
219498,259,259,0,0,0
219515,102,102,0,0,0
219519,2,2,0,0,0
219526,25,25,0,0,0
219534,152,152,0,0,0
219545,50,50,0,0,0
219548,402,402,0,0,0
219589,259,259,0,0,0
219591,102,102,0,0,0
219613,67,67,0,0,0
219619,57,57,0,0,0
219623,232,232,0,0,0
219635,315,315,0,0,0
219644,65,65,0,0,0
219648,131,131,0,0,0
219664,58,58,0,0,0
219676,402,402,0,0,0
219679,193,193,0,0,0
219683,167,167,0,0,0
219685,353,353,0,0,0
219691,299,299,0,0,0
219693,184,184,0,0,0
219698,102,102,0,0,0
219712,345,345,0,0,0
219722,299,299,0,0,0
219723,137,137,0,0,0
219735,180,180,0,0,0
219751,137,137,0,0,0
219752,252,252,0,0,0
219765,56,56,0,0,0
219781,299,299,0,0,0
219782,252,252,0,0,0
219785,7,7,0,0,0
219791,20,20,0,0,0
219803,34,34,0,0,0
219807,101,101,0,0,0
219814,180,180,0,0,0
219818,232,232,0,0,0
219823,76,76,0,0,0
219828,8,8,0,0,0
219835,184,184,0,0,0
219844,57,57,0,0,0
219846,345,345,0,0,0
219847,101,101,0,0,0
219848,306,306,0,0,0
219852,7,7,0,0,0
219862,25,25,0,0,0
219868,102,102,0,0,0
219883,76,76,0,0,0
219884,41,41,0,0,0
219887,281,281,0,0,0
219890,251,251,0,0,0
219896,158,158,0,0,0
219911,171,171,0,0,0
219925,282,282,0,0,0
219945,402,402,0,0,0
219949,299,299,0,0,0
219972,101,101,0,0,0
219983,345,345,0,0,0
219993,18,18,0,0,0
220024,120,120,0,0,0
220038,3,3,0,0,0
220051,299,299,0,0,0
220059,306,306,0,0,0
220079,315,315,0,0,0
220119,151,151,0,0,0
220124,359,359,0,0,0
220128,70,70,0,0,0
220130,180,180,0,0,0
220137,168,168,0,0,0
220143,402,402,0,0,0
220144,310,310,0,0,0
220148,151,151,0,0,0
220150,25,25,0,0,0
220162,313,313,0,0,0
220164,310,310,0,0,0
220185,281,281,0,0,0
220202,97,97,0,0,0
220209,259,259,0,0,0
220230,113,113,0,0,0
220233,353,353,0,0,0
220240,22,22,0,0,0
220258,72,72,0,0,0
220268,167,167,0,0,0
220271,345,345,0,0,0
220280,345,345,0,0,0
220287,41,41,0,0,0
220293,69,69,0,0,0
220326,345,345,0,0,0
220331,259,259,0,0,0
220346,128,128,0,0,0
220354,198,198,0,0,0
220356,310,310,0,0,0
220361,71,71,0,0,0
220368,281,281,0,0,0
220372,402,402,0,0,0
220373,20,20,0,0,0
220376,133,133,0,0,0
220383,359,359,0,0,0
220387,87,87,0,0,0
220391,25,25,0,0,0
220408,132,132,0,0,0
220443,184,184,0,0,0
220458,87,87,0,0,0
220483,359,359,0,0,0
220484,34,34,0,0,0
220489,1,1,0,0,0
220490,137,137,0,0,0
220493,114,114,0,0,0
220508,151,151,0,0,0
220514,315,315,0,0,0
220525,70,70,0,0,0
220538,20,20,0,0,0
220544,120,120,0,0,0
220556,114,114,0,0,0
220575,158,158,0,0,0
220584,6,6,0,0,0
220590,137,137,0,0,0
220598,144,144,0,0,0
220603,167,167,0,0,0
220607,299,299,0,0,0
220610,299,299,0,0,0
220623,201,201,0,0,0
220625,74,74,0,0,0
220640,137,137,0,0,0
220647,201,201,0,0,0
220651,167,167,0,0,0
220666,25,25,0,0,0
220677,28,28,0,0,0
220685,310,310,0,0,0
220705,50,50,0,0,0
220725,137,137,0,0,0
220731,299,299,0,0,0
220737,184,184,0,0,0
220747,246,246,0,0,0
220749,137,137,0,0,0
220750,310,310,0,0,0
220766,232,232,0,0,0
220774,35,35,0,0,0
220787,198,198,0,0,0
220795,232,232,0,0,0
220800,259,259,0,0,0
220806,299,299,0,0,0
220812,82,82,0,0,0
220817,102,102,0,0,0
220818,151,151,0,0,0
220840,101,101,0,0,0
220848,13,13,0,0,0
220868,10,10,0,0,0
220875,359,359,0,0,0
220889,255,255,0,0,0
220896,359,359,0,0,0
220900,20,20,0,0,0
220906,87,87,0,0,0
220924,259,259,0,0,0
220931,163,163,0,0,0
220933,74,74,0,0,0
220935,114,114,0,0,0
220978,345,345,0,0,0
220996,70,70,0,0,0
221001,74,74,0,0,0
221013,158,158,0,0,0
221044,345,345,0,0,0
221082,282,282,0,0,0
221102,151,151,0,0,0
221109,14,14,0,0,0
221113,23,23,0,0,0
221117,16,16,0,0,0
221125,282,282,0,0,0
221142,359,359,0,0,0
221146,353,353,0,0,0
221208,359,359,0,0,0
221209,137,137,0,0,0
221220,299,299,0,0,0
221221,137,137,0,0,0
221233,282,282,0,0,0
221250,35,35,0,0,0
221253,313,313,0,0,0
221296,255,255,0,0,0
221297,74,74,0,0,0
221304,402,402,0,0,0
221308,11,11,0,0,0
221311,306,306,0,0,0
221314,315,315,0,0,0
221325,121,121,0,0,0
221336,102,102,0,0,0
221342,74,74,0,0,0
221353,2,2,0,0,0
221361,114,114,0,0,0
221374,152,152,0,0,0
221388,25,25,0,0,0
221445,193,193,0,0,0
221471,76,76,0,0,0
221481,12,12,0,0,0
221483,75,75,0,0,0
221491,30,30,0,0,0
221519,167,167,0,0,0
221538,34,34,0,0,0
221544,198,198,0,0,0
221545,168,168,0,0,0
221560,259,259,0,0,0
221573,158,158,0,0,0
221578,299,299,0,0,0
221598,255,255,0,0,0
221599,251,251,0,0,0
221618,251,251,0,0,0
221643,76,76,0,0,0
221655,65,65,0,0,0
221660,306,306,0,0,0
221676,313,313,0,0,0
221682,252,252,0,0,0
221686,402,402,0,0,0
221688,167,167,0,0,0
221695,3,3,0,0,0
221709,19,19,0,0,0
221716,72,72,0,0,0
221717,72,72,0,0,0
221726,36,36,0,0,0
221736,281,281,0,0,0
221741,74,74,0,0,0
221775,15,15,0,0,0
221794,152,152,0,0,0
221801,144,144,0,0,0
221822,20,20,0,0,0
221829,252,252,0,0,0
221832,66,66,0,0,0
221834,246,246,0,0,0
221853,198,198,0,0,0
221882,167,167,0,0,0
221883,315,315,0,0,0
221901,97,97,0,0,0
221917,34,34,0,0,0
221920,97,97,0,0,0
221924,259,259,0,0,0
221925,143,143,0,0,0
221932,313,313,0,0,0
221939,310,310,0,0,0
221943,56,56,0,0,0
221956,246,246,0,0,0
221961,102,102,0,0,0
221982,76,76,0,0,0
221996,18,18,0,0,0
222000,74,74,0,0,0
222004,251,251,0,0,0
222007,359,359,0,0,0
222020,313,313,0,0,0
222022,12,12,0,0,0
222028,21,21,0,0,0
222034,184,184,0,0,0
222043,45,45,0,0,0
222044,102,102,0,0,0
222046,128,128,0,0,0
222073,299,299,0,0,0
222075,152,152,0,0,0
222106,128,128,0,0,0
222127,43,43,0,0,0
222134,310,310,0,0,0
222141,313,313,0,0,0
222145,313,313,0,0,0
222148,167,167,0,0,0
222160,137,137,0,0,0
222163,22,22,0,0,0
222173,193,193,0,0,0
222182,74,74,0,0,0
222186,22,22,0,0,0
222187,130,130,0,0,0
222211,120,120,0,0,0
222228,137,137,0,0,0
222233,102,102,0,0,0
222250,246,246,0,0,0
222261,359,359,0,0,0
222268,137,137,0,0,0
222285,69,69,0,0,0
222288,252,252,0,0,0
222289,345,345,0,0,0
222290,198,198,0,0,0
222345,7,7,0,0,0
222346,158,158,0,0,0
222354,71,71,0,0,0
222355,310,310,0,0,0
222377,7,7,0,0,0
222417,306,306,0,0,0
222419,35,35,0,0,0
222428,306,306,0,0,0
222430,4,4,0,0,0
222433,77,77,0,0,0
222435,12,12,0,0,0
222472,151,151,0,0,0
222495,128,128,0,0,0
222499,130,130,0,0,0
222501,281,281,0,0,0
222510,19,19,0,0,0
222539,151,151,0,0,0
222574,19,19,0,0,0
222593,87,87,0,0,0
222632,198,198,0,0,0
222633,163,163,0,0,0
222642,180,180,0,0,0
222662,82,82,0,0,0
222670,16,16,0,0,0
222679,121,121,0,0,0
222683,255,255,0,0,0
222684,158,158,0,0,0
222685,103,103,0,0,0
222688,6,6,0,0,0
222691,315,315,0,0,0
222693,251,251,0,0,0
222734,85,85,0,0,0
222760,114,114,0,0,0
222770,10,10,0,0,0
222779,67,67,0,0,0
222784,5,5,0,0,0
222798,198,198,0,0,0
222829,198,198,0,0,0
222834,8,8,0,0,0
222853,180,180,0,0,0
222857,184,184,0,0,0
222858,310,310,0,0,0
222867,180,180,0,0,0
222900,22,22,0,0,0
222941,102,102,0,0,0
222948,87,87,0,0,0
222949,30,30,0,0,0
222954,171,171,0,0,0
222963,255,255,0,0,0
222969,7,7,0,0,0
222982,45,45,0,0,0
223004,281,281,0,0,0
223008,313,313,0,0,0
223012,281,281,0,0,0
223025,151,151,0,0,0
223026,171,171,0,0,0
223028,120,120,0,0,0
223051,255,255,0,0,0
223055,402,402,0,0,0
223057,251,251,0,0,0
223062,132,132,0,0,0
223117,94,94,0,0,0
223130,313,313,0,0,0
223153,94,94,0,0,0
223166,36,36,0,0,0
223170,259,259,0,0,0
223186,259,259,0,0,0
223188,282,282,0,0,0
223190,193,193,0,0,0
223191,54,54,0,0,0
223200,251,251,0,0,0
223203,402,402,0,0,0
223225,282,282,0,0,0
223228,251,251,0,0,0
223231,30,30,0,0,0
223237,24,24,0,0,0
223249,246,246,0,0,0
223253,345,345,0,0,0
223266,11,11,0,0,0
223281,168,168,0,0,0
223289,152,152,0,0,0
223324,121,121,0,0,0
223345,131,131,0,0,0
223375,36,36,0,0,0
223396,144,144,0,0,0
223400,184,184,0,0,0
223407,35,35,0,0,0
223410,36,36,0,0,0
223422,232,232,0,0,0
223439,77,77,0,0,0
223450,299,299,0,0,0
223458,313,313,0,0,0
223462,193,193,0,0,0
223475,255,255,0,0,0
223492,259,259,0,0,0
223498,131,131,0,0,0
223534,120,120,0,0,0
223540,130,130,0,0,0
223573,359,359,0,0,0
223576,282,282,0,0,0
223583,299,299,0,0,0
223595,259,259,0,0,0
223599,252,252,0,0,0
223618,353,353,0,0,0
223622,50,50,0,0,0
223625,402,402,0,0,0
223637,180,180,0,0,0
223645,151,151,0,0,0
223653,18,18,0,0,0
223656,101,101,0,0,0
223662,30,30,0,0,0
223671,168,168,0,0,0
223677,193,193,0,0,0
223685,168,168,0,0,0
223690,13,13,0,0,0
223693,36,36,0,0,0
223697,198,198,0,0,0
223718,28,28,0,0,0
223721,102,102,0,0,0
223731,281,281,0,0,0
223739,353,353,0,0,0
223750,12,12,0,0,0
223752,94,94,0,0,0
223782,353,353,0,0,0
223785,94,94,0,0,0
223796,50,50,0,0,0
223825,402,402,0,0,0
223834,310,310,0,0,0
223845,74,74,0,0,0
223873,56,56,0,0,0
223876,72,72,0,0,0
223887,232,232,0,0,0
223894,72,72,0,0,0
223900,56,56,0,0,0
223904,310,310,0,0,0
223908,133,133,0,0,0
223910,306,306,0,0,0
223924,345,345,0,0,0
223929,246,246,0,0,0
223930,315,315,0,0,0
223939,306,306,0,0,0
223946,114,114,0,0,0
223947,251,251,0,0,0
223948,103,103,0,0,0
223950,246,246,0,0,0
223957,10,10,0,0,0
223970,282,282,0,0,0
223979,63,63,0,0,0
223980,121,121,0,0,0
223982,232,232,0,0,0
224002,15,15,0,0,0
224014,232,232,0,0,0
224022,102,102,0,0,0
224028,132,132,0,0,0
224030,345,345,0,0,0
224031,102,102,0,0,0
224065,313,313,0,0,0
224075,72,72,0,0,0
224105,2,2,0,0,0
224112,10,10,0,0,0
224113,87,87,0,0,0
224124,151,151,0,0,0
224138,163,163,0,0,0
224151,6,6,0,0,0
224153,102,102,0,0,0
224163,103,103,0,0,0
224175,121,121,0,0,0
224181,137,137,0,0,0
224182,9,9,0,0,0
224192,315,315,0,0,0
224205,232,232,0,0,0
224207,36,36,0,0,0
224220,281,281,0,0,0
224223,7,7,0,0,0
224231,54,54,0,0,0
224238,251,251,0,0,0
224250,310,310,0,0,0
224259,246,246,0,0,0
224267,281,281,0,0,0
224284,121,121,0,0,0
224286,65,65,0,0,0
224287,82,82,0,0,0
224301,21,21,0,0,0
224304,83,83,0,0,0
224310,7,7,0,0,0
224328,44,44,0,0,0
224372,282,282,0,0,0
224376,246,246,0,0,0
224377,137,137,0,0,0
224392,114,114,0,0,0
224414,74,74,0,0,0
224417,310,310,0,0,0
224430,168,168,0,0,0
224457,77,77,0,0,0
224463,313,313,0,0,0
224464,82,82,0,0,0
224472,246,246,0,0,0
224489,143,143,0,0,0
224490,402,402,0,0,0
224494,77,77,0,0,0
224503,167,167,0,0,0
224509,281,281,0,0,0
224518,36,36,0,0,0
224519,82,82,0,0,0
224524,6,6,0,0,0
224540,281,281,0,0,0
224553,313,313,0,0,0
224556,74,74,0,0,0
224559,144,144,0,0,0
224569,5,5,0,0,0
224570,69,69,0,0,0
224578,282,282,0,0,0
224602,246,246,0,0,0
224604,171,171,0,0,0
224631,66,66,0,0,0
224638,76,76,0,0,0
224643,353,353,0,0,0
224644,133,133,0,0,0
224648,232,232,0,0,0
224654,402,402,0,0,0
224661,306,306,0,0,0
224678,151,151,0,0,0
224683,74,74,0,0,0
224702,306,306,0,0,0
224708,359,359,0,0,0
224712,359,359,0,0,0
224740,76,76,0,0,0
224742,29,29,0,0,0
224764,15,15,0,0,0
224772,315,315,0,0,0
224776,121,121,0,0,0
224778,102,102,0,0,0
224779,13,13,0,0,0
224780,359,359,0,0,0
224787,50,50,0,0,0
224793,152,152,0,0,0
224813,281,281,0,0,0
224824,310,310,0,0,0
224832,259,259,0,0,0
224834,198,198,0,0,0
224836,251,251,0,0,0
224837,180,180,0,0,0
224861,198,198,0,0,0
224874,310,310,0,0,0
224881,198,198,0,0,0
224887,13,13,0,0,0
224903,299,299,0,0,0
224905,184,184,0,0,0
224912,144,144,0,0,0
224944,4,4,0,0,0
224961,14,14,0,0,0
224986,3,3,0,0,0
225008,299,299,0,0,0
225013,24,24,0,0,0
225017,94,94,0,0,0
225025,16,16,0,0,0
225050,246,246,0,0,0
225052,40,40,0,0,0
225085,251,251,0,0,0
225088,131,131,0,0,0
225097,315,315,0,0,0
225109,5,5,0,0,0
225112,121,121,0,0,0
225122,22,22,0,0,0
225145,345,345,0,0,0
225163,359,359,0,0,0
225169,282,282,0,0,0
225177,74,74,0,0,0
225181,259,259,0,0,0
225185,167,167,0,0,0
225212,83,83,0,0,0
225213,184,184,0,0,0
225214,315,315,0,0,0
225217,50,50,0,0,0
225234,345,345,0,0,0
225235,22,22,0,0,0
225244,198,198,0,0,0
225246,83,83,0,0,0
225269,77,77,0,0,0
225286,3,3,0,0,0
225301,44,44,0,0,0
225320,310,310,0,0,0
225341,131,131,0,0,0
225361,44,44,0,0,0
225376,3,3,0,0,0
225399,310,310,0,0,0
225412,15,15,0,0,0
225418,306,306,0,0,0
225424,198,198,0,0,0
225426,50,50,0,0,0
225444,36,36,0,0,0
225455,3,3,0,0,0
225472,345,345,0,0,0
225478,193,193,0,0,0
225510,71,71,0,0,0
225512,198,198,0,0,0
225529,97,97,0,0,0
225533,171,171,0,0,0
225545,43,43,0,0,0
225551,306,306,0,0,0
225569,313,313,0,0,0
225578,198,198,0,0,0
225602,158,158,0,0,0
225609,15,15,0,0,0
225632,313,313,0,0,0
225634,158,158,0,0,0
225636,310,310,0,0,0
225640,97,97,0,0,0
225642,299,299,0,0,0
225654,132,132,0,0,0
225660,67,67,0,0,0
225696,45,45,0,0,0
225706,198,198,0,0,0
225716,315,315,0,0,0
225724,34,34,0,0,0
225730,232,232,0,0,0
225745,67,67,0,0,0
225770,306,306,0,0,0
225780,167,167,0,0,0
225785,39,39,0,0,0
225793,66,66,0,0,0
225803,315,315,0,0,0
225807,13,13,0,0,0
225818,251,251,0,0,0
225819,56,56,0,0,0
225820,255,255,0,0,0
225843,163,163,0,0,0
225862,252,252,0,0,0
225869,102,102,0,0,0
225899,144,144,0,0,0
225906,58,58,0,0,0
225926,121,121,0,0,0
225938,87,87,0,0,0
225941,353,353,0,0,0
225942,281,281,0,0,0
225952,353,353,0,0,0
225953,168,168,0,0,0
225975,359,359,0,0,0
225987,137,137,0,0,0
225994,144,144,0,0,0
225996,55,55,0,0,0
225998,252,252,0,0,0
226008,11,11,0,0,0
226010,345,345,0,0,0
226041,158,158,0,0,0
226052,101,101,0,0,0
226059,83,83,0,0,0
226069,201,201,0,0,0
226072,30,30,0,0,0
226073,56,56,0,0,0
226074,259,259,0,0,0
226077,58,58,0,0,0
226079,151,151,0,0,0
226080,252,252,0,0,0
226087,35,35,0,0,0
226108,345,345,0,0,0
226113,310,310,0,0,0
226118,306,306,0,0,0
226119,65,65,0,0,0
226144,171,171,0,0,0
226152,252,252,0,0,0
226153,313,313,0,0,0
226161,56,56,0,0,0
226162,102,102,0,0,0
226175,6,6,0,0,0
226184,310,310,0,0,0
226189,201,201,0,0,0
226190,130,130,0,0,0
226232,137,137,0,0,0
226271,299,299,0,0,0
226288,143,143,0,0,0
226291,310,310,0,0,0
226297,168,168,0,0,0
226317,193,193,0,0,0
226342,246,246,0,0,0
226349,3,3,0,0,0
226365,77,77,0,0,0
226387,15,15,0,0,0
226406,29,29,0,0,0
226425,310,310,0,0,0
226428,44,44,0,0,0
226440,120,120,0,0,0
226444,77,77,0,0,0
226474,252,252,0,0,0
226482,251,251,0,0,0
226490,359,359,0,0,0
226497,114,114,0,0,0
226502,201,201,0,0,0
226517,184,184,0,0,0
226518,120,120,0,0,0
226522,144,144,0,0,0
226527,152,152,0,0,0
226534,232,232,0,0,0
226535,282,282,0,0,0
226538,246,246,0,0,0
226559,246,246,0,0,0
226562,281,281,0,0,0
226578,163,163,0,0,0
226586,151,151,0,0,0
226595,57,57,0,0,0
226604,246,246,0,0,0
226606,82,82,0,0,0
226608,77,77,0,0,0
226658,43,43,0,0,0
226660,65,65,0,0,0
226668,101,101,0,0,0
226683,5,5,0,0,0
226697,1,1,0,0,0
226698,7,7,0,0,0
226707,282,282,0,0,0
226714,9,9,0,0,0
226725,120,120,0,0,0
226727,14,14,0,0,0
226748,1,1,0,0,0
226751,20,20,0,0,0
226752,70,70,0,0,0
226771,133,133,0,0,0
226783,66,66,0,0,0
226784,158,158,0,0,0
226805,252,252,0,0,0
226837,120,120,0,0,0
226839,306,306,0,0,0
226840,402,402,0,0,0
226845,345,345,0,0,0
226848,359,359,0,0,0
226850,252,252,0,0,0
226851,11,11,0,0,0
226882,299,299,0,0,0
226885,63,63,0,0,0
226886,353,353,0,0,0
226900,255,255,0,0,0
226906,143,143,0,0,0
226908,306,306,0,0,0
226923,143,143,0,0,0
226937,70,70,0,0,0
226940,25,25,0,0,0
226941,201,201,0,0,0
226952,15,15,0,0,0
226967,35,35,0,0,0
226974,29,29,0,0,0
226993,158,158,0,0,0
226994,17,17,0,0,0
227003,168,168,0,0,0
227014,193,193,0,0,0
227050,97,97,0,0,0
227059,130,130,0,0,0
227076,158,158,0,0,0
227090,353,353,0,0,0
227092,310,310,0,0,0
227105,402,402,0,0,0
227108,114,114,0,0,0
227122,252,252,0,0,0
227141,315,315,0,0,0
227156,281,281,0,0,0
227165,184,184,0,0,0
227173,44,44,0,0,0
227186,255,255,0,0,0
227187,299,299,0,0,0
227189,310,310,0,0,0
227195,74,74,0,0,0
227219,167,167,0,0,0
227221,353,353,0,0,0
227228,55,55,0,0,0
227258,232,232,0,0,0
227259,113,113,0,0,0
227264,282,282,0,0,0
227285,3,3,0,0,0
227292,168,168,0,0,0
227293,76,76,0,0,0
227295,82,82,0,0,0
227303,193,193,0,0,0
227325,11,11,0,0,0
227330,10,10,0,0,0
227341,180,180,0,0,0
227347,402,402,0,0,0
227377,345,345,0,0,0
227391,15,15,0,0,0
227405,3,3,0,0,0
227422,70,70,0,0,0
227452,167,167,0,0,0
227467,281,281,0,0,0
227489,168,168,0,0,0
227502,97,97,0,0,0
227504,7,7,0,0,0
227542,359,359,0,0,0
227543,66,66,0,0,0
227553,359,359,0,0,0
227556,353,353,0,0,0
227585,201,201,0,0,0
227586,70,70,0,0,0
227595,251,251,0,0,0
227601,14,14,0,0,0
227612,131,131,0,0,0
227620,137,137,0,0,0
227634,353,353,0,0,0
227641,9,9,0,0,0
227646,133,133,0,0,0
227659,252,252,0,0,0
227661,144,144,0,0,0
227687,71,71,0,0,0
227689,180,180,0,0,0
227692,2,2,0,0,0
227725,27,27,0,0,0
227735,201,201,0,0,0
227757,255,255,0,0,0
227777,315,315,0,0,0
227820,5,5,0,0,0
227821,246,246,0,0,0
227823,402,402,0,0,0
227835,56,56,0,0,0
227845,143,143,0,0,0
227851,6,6,0,0,0
227857,131,131,0,0,0
227862,94,94,0,0,0
227887,345,345,0,0,0
227902,255,255,0,0,0
227904,198,198,0,0,0
227919,40,40,0,0,0
227922,103,103,0,0,0
227936,11,11,0,0,0
227955,310,310,0,0,0
227960,131,131,0,0,0
227997,306,306,0,0,0
228006,114,114,0,0,0
228017,259,259,0,0,0
228023,198,198,0,0,0
228047,20,20,0,0,0
228050,345,345,0,0,0
228060,87,87,0,0,0
228067,11,11,0,0,0
228074,163,163,0,0,0
228086,281,281,0,0,0
228107,120,120,0,0,0
228112,281,281,0,0,0
228118,152,152,0,0,0
228119,3,3,0,0,0
228139,152,152,0,0,0
228158,143,143,0,0,0
228160,353,353,0,0,0
228198,255,255,0,0,0
228199,10,10,0,0,0
228214,180,180,0,0,0
228221,232,232,0,0,0
228223,232,232,0,0,0
228236,57,57,0,0,0
228242,102,102,0,0,0
228257,11,11,0,0,0
228263,18,18,0,0,0
228272,11,11,0,0,0
228279,255,255,0,0,0
228287,310,310,0,0,0
228293,94,94,0,0,0
228296,306,306,0,0,0
228312,251,251,0,0,0
228326,82,82,0,0,0
228357,82,82,0,0,0
228393,114,114,0,0,0
228399,2,2,0,0,0
228412,74,74,0,0,0
228433,114,114,0,0,0
228444,9,9,0,0,0
228449,184,184,0,0,0
228461,359,359,0,0,0
228463,345,345,0,0,0
228489,259,259,0,0,0
228516,255,255,0,0,0
228528,1,1,0,0,0
228547,29,29,0,0,0
228549,39,39,0,0,0
228558,152,152,0,0,0
228561,167,167,0,0,0
228565,76,76,0,0,0
228574,12,12,0,0,0
228598,252,252,0,0,0
228610,50,50,0,0,0
228623,114,114,0,0,0
228641,345,345,0,0,0
228642,35,35,0,0,0
228655,246,246,0,0,0
228657,17,17,0,0,0
228666,94,94,0,0,0
228671,353,353,0,0,0
228675,74,74,0,0,0
228677,353,353,0,0,0
228694,353,353,0,0,0
228702,17,17,0,0,0
228707,163,163,0,0,0
228708,251,251,0,0,0
228715,85,85,0,0,0
228717,130,130,0,0,0
228738,137,137,0,0,0
228741,74,74,0,0,0
228752,232,232,0,0,0
228757,255,255,0,0,0
228771,74,74,0,0,0
228789,114,114,0,0,0
228793,45,45,0,0,0
228800,299,299,0,0,0
228832,18,18,0,0,0
228838,131,131,0,0,0
228841,54,54,0,0,0
228847,83,83,0,0,0
228848,158,158,0,0,0
228855,152,152,0,0,0
228861,72,72,0,0,0
228866,75,75,0,0,0
228877,94,94,0,0,0
228892,7,7,0,0,0
228900,313,313,0,0,0
228910,29,29,0,0,0
228920,128,128,0,0,0
228924,310,310,0,0,0
228952,152,152,0,0,0
228968,180,180,0,0,0
228976,24,24,0,0,0
228981,65,65,0,0,0
228993,168,168,0,0,0
229003,85,85,0,0,0
229017,255,255,0,0,0
229045,120,120,0,0,0
229059,402,402,0,0,0
229064,299,299,0,0,0
229082,137,137,0,0,0
229083,201,201,0,0,0
229085,345,345,0,0,0
229090,114,114,0,0,0
229116,113,113,0,0,0
229133,87,87,0,0,0
229134,137,137,0,0,0
229153,54,54,0,0,0
229171,201,201,0,0,0
229179,168,168,0,0,0
229188,201,201,0,0,0
229191,246,246,0,0,0
229198,180,180,0,0,0
229203,7,7,0,0,0
229211,34,34,0,0,0
229221,114,114,0,0,0
229233,315,315,0,0,0
229248,246,246,0,0,0
229255,259,259,0,0,0
229291,35,35,0,0,0
229300,144,144,0,0,0
229305,3,3,0,0,0
229323,402,402,0,0,0
229325,120,120,0,0,0
229337,353,353,0,0,0
229372,171,171,0,0,0
229406,282,282,0,0,0
229409,102,102,0,0,0
229410,232,232,0,0,0
229411,232,232,0,0,0
229417,17,17,0,0,0
229441,152,152,0,0,0
229470,252,252,0,0,0
229481,353,353,0,0,0
229489,353,353,0,0,0
229515,255,255,0,0,0
229519,131,131,0,0,0
229535,55,55,0,0,0
229550,313,313,0,0,0
229558,137,137,0,0,0
229562,281,281,0,0,0
229570,131,131,0,0,0
229587,313,313,0,0,0
229591,345,345,0,0,0
229604,50,50,0,0,0
229605,313,313,0,0,0
229629,353,353,0,0,0
229662,101,101,0,0,0
229667,163,163,0,0,0
229676,402,402,0,0,0
229702,310,310,0,0,0
229704,315,315,0,0,0
229720,137,137,0,0,0
229734,63,63,0,0,0
229735,281,281,0,0,0
229745,85,85,0,0,0
229759,402,402,0,0,0
229761,315,315,0,0,0
229772,121,121,0,0,0
229782,36,36,0,0,0
229783,402,402,0,0,0
229784,39,39,0,0,0
229788,255,255,0,0,0
229801,232,232,0,0,0
229803,77,77,0,0,0
229807,310,310,0,0,0
229810,94,94,0,0,0
229812,77,77,0,0,0
229820,353,353,0,0,0
229865,137,137,0,0,0
229872,201,201,0,0,0
229894,29,29,0,0,0
229910,251,251,0,0,0
229927,43,43,0,0,0
229930,34,34,0,0,0
229944,152,152,0,0,0
229961,137,137,0,0,0
229982,45,45,0,0,0
230046,121,121,0,0,0
230048,246,246,0,0,0
230055,353,353,0,0,0
230112,3,3,0,0,0
230118,402,402,0,0,0
230124,101,101,0,0,0
230126,315,315,0,0,0
230131,71,71,0,0,0
230139,44,44,0,0,0
230141,113,113,0,0,0
230145,252,252,0,0,0
230150,255,255,0,0,0
230152,168,168,0,0,0
230156,198,198,0,0,0
230178,184,184,0,0,0
230180,29,29,0,0,0
230199,137,137,0,0,0
230231,30,30,0,0,0
230239,299,299,0,0,0
230249,359,359,0,0,0
230250,255,255,0,0,0
230257,41,41,0,0,0
230260,198,198,0,0,0
230267,315,315,0,0,0
230278,310,310,0,0,0
230289,232,232,0,0,0
230298,152,152,0,0,0
230312,259,259,0,0,0
230315,180,180,0,0,0
230317,251,251,0,0,0
230328,201,201,0,0,0
230340,144,144,0,0,0
230343,310,310,0,0,0
230352,315,315,0,0,0
230418,114,114,0,0,0
230419,75,75,0,0,0
230422,171,171,0,0,0
230433,83,83,0,0,0
230462,306,306,0,0,0
230467,3,3,0,0,0
230490,152,152,0,0,0
230518,34,34,0,0,0
230527,137,137,0,0,0
230530,19,19,0,0,0
230582,259,259,0,0,0
230591,282,282,0,0,0
230596,137,137,0,0,0
230599,259,259,0,0,0
230601,40,40,0,0,0
230620,315,315,0,0,0
230630,20,20,0,0,0
230642,74,74,0,0,0
230645,63,63,0,0,0
230659,353,353,0,0,0
230680,345,345,0,0,0
230691,171,171,0,0,0
230705,15,15,0,0,0
230706,8,8,0,0,0
230716,281,281,0,0,0
230720,402,402,0,0,0
230731,180,180,0,0,0
230732,121,121,0,0,0
230739,168,168,0,0,0
230741,345,345,0,0,0
230747,27,27,0,0,0
230754,20,20,0,0,0
230760,24,24,0,0,0
230768,74,74,0,0,0
230795,193,193,0,0,0
230796,72,72,0,0,0
230798,67,67,0,0,0
230801,255,255,0,0,0
230821,102,102,0,0,0
230841,67,67,0,0,0
230844,313,313,0,0,0
230857,359,359,0,0,0
230859,402,402,0,0,0
230860,71,71,0,0,0
230867,44,44,0,0,0
230873,143,143,0,0,0
230907,2,2,0,0,0
230938,299,299,0,0,0
230955,251,251,0,0,0
230966,55,55,0,0,0
230968,137,137,0,0,0
230972,74,74,0,0,0
230974,198,198,0,0,0
231034,201,201,0,0,0
231035,232,232,0,0,0
231038,76,76,0,0,0
231045,282,282,0,0,0
231055,70,70,0,0,0
231070,299,299,0,0,0
231074,158,158,0,0,0
231075,17,17,0,0,0
231084,56,56,0,0,0
231085,359,359,0,0,0
231091,259,259,0,0,0
231131,167,167,0,0,0
231134,102,102,0,0,0
231145,255,255,0,0,0
231146,27,27,0,0,0
231150,16,16,0,0,0
231164,24,24,0,0,0
231167,101,101,0,0,0
231173,137,137,0,0,0
231184,74,74,0,0,0
231189,232,232,0,0,0
231194,345,345,0,0,0
231196,137,137,0,0,0
231198,72,72,0,0,0
231207,345,345,0,0,0
231222,167,167,0,0,0
231227,102,102,0,0,0
231254,201,201,0,0,0
231259,29,29,0,0,0
231262,255,255,0,0,0
231271,255,255,0,0,0
231274,402,402,0,0,0
231289,151,151,0,0,0
231290,281,281,0,0,0
231291,11,11,0,0,0
231293,255,255,0,0,0
231300,201,201,0,0,0
231302,16,16,0,0,0
231308,232,232,0,0,0
231309,77,77,0,0,0
231322,152,152,0,0,0
231323,15,15,0,0,0
231332,180,180,0,0,0
231348,56,56,0,0,0
231354,163,163,0,0,0
231358,281,281,0,0,0
231361,306,306,0,0,0
231375,353,353,0,0,0
231392,8,8,0,0,0
231438,39,39,0,0,0
231450,63,63,0,0,0
231463,72,72,0,0,0
231470,246,246,0,0,0
231471,193,193,0,0,0
231477,281,281,0,0,0
231485,158,158,0,0,0
231486,35,35,0,0,0
231489,180,180,0,0,0
231524,353,353,0,0,0
231544,58,58,0,0,0
231545,144,144,0,0,0
231565,34,34,0,0,0
231577,27,27,0,0,0
231592,310,310,0,0,0
231609,143,143,0,0,0
231614,27,27,0,0,0
231627,180,180,0,0,0
231645,114,114,0,0,0
231649,114,114,0,0,0
231677,34,34,0,0,0
231690,58,58,0,0,0
231701,315,315,0,0,0
231743,113,113,0,0,0
231750,69,69,0,0,0
231756,299,299,0,0,0
231761,180,180,0,0,0
231764,102,102,0,0,0
231768,246,246,0,0,0
231825,201,201,0,0,0
231827,101,101,0,0,0
231836,4,4,0,0,0
231853,359,359,0,0,0
231856,306,306,0,0,0
231859,71,71,0,0,0
231861,121,121,0,0,0
231865,82,82,0,0,0
231872,168,168,0,0,0
231882,85,85,0,0,0
231883,282,282,0,0,0
231885,22,22,0,0,0
231901,315,315,0,0,0
231902,359,359,0,0,0
231913,255,255,0,0,0
231922,252,252,0,0,0
231931,353,353,0,0,0
231936,11,11,0,0,0
231946,18,18,0,0,0
231959,131,131,0,0,0
231960,232,232,0,0,0
231964,184,184,0,0,0
231969,56,56,0,0,0
231973,137,137,0,0,0
231995,306,306,0,0,0
231997,121,121,0,0,0
232007,353,353,0,0,0
232012,281,281,0,0,0
232017,151,151,0,0,0
232023,281,281,0,0,0
232034,57,57,0,0,0
232035,76,76,0,0,0
232044,67,67,0,0,0
232049,252,252,0,0,0
232057,315,315,0,0,0
232062,282,282,0,0,0
232101,281,281,0,0,0
232135,102,102,0,0,0
232137,102,102,0,0,0
232148,22,22,0,0,0
232150,168,168,0,0,0
232151,143,143,0,0,0
232165,103,103,0,0,0
232175,65,65,0,0,0
232190,402,402,0,0,0
232204,9,9,0,0,0
232213,34,34,0,0,0
232228,29,29,0,0,0
232243,75,75,0,0,0
232272,252,252,0,0,0
232274,27,27,0,0,0
232277,41,41,0,0,0
232285,143,143,0,0,0
232307,255,255,0,0,0
232309,184,184,0,0,0
232314,22,22,0,0,0
232320,12,12,0,0,0
232350,128,128,0,0,0
232353,15,15,0,0,0
232362,232,232,0,0,0
232373,180,180,0,0,0
232394,246,246,0,0,0
232400,255,255,0,0,0
232402,252,252,0,0,0
232418,345,345,0,0,0
232427,130,130,0,0,0
232434,171,171,0,0,0
232449,315,315,0,0,0
232455,121,121,0,0,0
232456,56,56,0,0,0
232458,114,114,0,0,0
232461,201,201,0,0,0
232507,18,18,0,0,0
232510,65,65,0,0,0
232516,282,282,0,0,0
232531,70,70,0,0,0
232546,252,252,0,0,0
232554,167,167,0,0,0
232555,152,152,0,0,0
232557,1,1,0,0,0
232566,402,402,0,0,0
232577,36,36,0,0,0
232586,152,152,0,0,0
232591,353,353,0,0,0
232601,143,143,0,0,0
232602,251,251,0,0,0
232631,144,144,0,0,0
232635,252,252,0,0,0
232637,167,167,0,0,0
232640,2,2,0,0,0
232644,82,82,0,0,0
232670,252,252,0,0,0
232684,22,22,0,0,0
232690,83,83,0,0,0
232693,255,255,0,0,0
232695,1,1,0,0,0
232701,143,143,0,0,0
232706,94,94,0,0,0
232721,198,198,0,0,0
232723,137,137,0,0,0
232724,310,310,0,0,0
232755,198,198,0,0,0
232768,43,43,0,0,0
232780,34,34,0,0,0
232791,39,39,0,0,0
232797,133,133,0,0,0
232809,132,132,0,0,0
232824,299,299,0,0,0
232835,193,193,0,0,0
232840,353,353,0,0,0
232857,193,193,0,0,0
232880,313,313,0,0,0
232910,144,144,0,0,0
232917,359,359,0,0,0
232924,8,8,0,0,0
232937,255,255,0,0,0
232956,11,11,0,0,0
232972,76,76,0,0,0
232976,28,28,0,0,0
232985,11,11,0,0,0
232989,21,21,0,0,0
233011,76,76,0,0,0
233022,128,128,0,0,0
233027,7,7,0,0,0
233034,85,85,0,0,0
233046,171,171,0,0,0
233047,310,310,0,0,0
233048,359,359,0,0,0
233071,306,306,0,0,0
233073,83,83,0,0,0
233098,2,2,0,0,0
233103,71,71,0,0,0
233121,34,34,0,0,0
233125,74,74,0,0,0
233128,55,55,0,0,0
233136,402,402,0,0,0
233155,114,114,0,0,0
233156,56,56,0,0,0
233159,359,359,0,0,0
233166,252,252,0,0,0
233171,180,180,0,0,0
233180,69,69,0,0,0
233213,137,137,0,0,0
233228,251,251,0,0,0
233230,83,83,0,0,0
233234,180,180,0,0,0
233240,5,5,0,0,0
233242,158,158,0,0,0
233256,313,313,0,0,0
233267,55,55,0,0,0
233270,71,71,0,0,0
233283,359,359,0,0,0
233292,45,45,0,0,0
233297,101,101,0,0,0
233298,198,198,0,0,0
233342,120,120,0,0,0
233356,144,144,0,0,0
233365,306,306,0,0,0
233380,180,180,0,0,0
233381,345,345,0,0,0
233383,121,121,0,0,0
233405,94,94,0,0,0
233412,18,18,0,0,0
233416,55,55,0,0,0
233421,121,121,0,0,0
233428,299,299,0,0,0
233456,67,67,0,0,0
233458,85,85,0,0,0
233473,345,345,0,0,0
233495,193,193,0,0,0
233513,34,34,0,0,0
233534,281,281,0,0,0
233543,310,310,0,0,0
233550,306,306,0,0,0
233551,282,282,0,0,0
233558,85,85,0,0,0
233577,313,313,0,0,0
233589,55,55,0,0,0
233635,310,310,0,0,0
233649,102,102,0,0,0
233662,87,87,0,0,0
233692,77,77,0,0,0
233698,137,137,0,0,0
233704,5,5,0,0,0
233723,70,70,0,0,0
233724,353,353,0,0,0
233731,313,313,0,0,0
233750,193,193,0,0,0
233762,114,114,0,0,0
233776,10,10,0,0,0
233780,310,310,0,0,0
233809,315,315,0,0,0
233817,180,180,0,0,0
233822,281,281,0,0,0
233840,251,251,0,0,0
233850,353,353,0,0,0
233858,50,50,0,0,0
233889,55,55,0,0,0
233897,101,101,0,0,0
233908,130,130,0,0,0
233913,114,114,0,0,0
233941,168,168,0,0,0
233948,137,137,0,0,0
233956,255,255,0,0,0
233965,281,281,0,0,0
233973,313,313,0,0,0
233976,102,102,0,0,0
234008,402,402,0,0,0
234010,299,299,0,0,0
234019,67,67,0,0,0
234021,39,39,0,0,0
234094,87,87,0,0,0
234097,65,65,0,0,0
234104,70,70,0,0,0
234179,143,143,0,0,0
234194,198,198,0,0,0
234202,152,152,0,0,0
234209,345,345,0,0,0
234216,143,143,0,0,0
234219,152,152,0,0,0
234227,152,152,0,0,0
234251,71,71,0,0,0
234253,75,75,0,0,0
234265,281,281,0,0,0
234274,198,198,0,0,0
234296,152,152,0,0,0
234319,299,299,0,0,0
234332,114,114,0,0,0
234361,83,83,0,0,0
234366,306,306,0,0,0
234370,143,143,0,0,0
234386,20,20,0,0,0
234388,193,193,0,0,0
234395,58,58,0,0,0
234433,163,163,0,0,0
234436,15,15,0,0,0
234438,7,7,0,0,0
234460,77,77,0,0,0
234479,353,353,0,0,0
234484,3,3,0,0,0
234488,259,259,0,0,0
234498,282,282,0,0,0
234508,44,44,0,0,0
234512,35,35,0,0,0
234542,315,315,0,0,0
234546,50,50,0,0,0
234551,6,6,0,0,0
234555,5,5,0,0,0
234565,310,310,0,0,0
234587,13,13,0,0,0
234598,94,94,0,0,0
234616,168,168,0,0,0
234630,40,40,0,0,0
234636,313,313,0,0,0
234641,359,359,0,0,0
234649,299,299,0,0,0
234659,402,402,0,0,0
234665,50,50,0,0,0
234666,85,85,0,0,0
234684,299,299,0,0,0
234690,45,45,0,0,0
234708,113,113,0,0,0
234718,180,180,0,0,0
234735,282,282,0,0,0
234736,121,121,0,0,0
234751,102,102,0,0,0
234767,15,15,0,0,0
234776,315,315,0,0,0
234816,201,201,0,0,0
234826,163,163,0,0,0
234828,198,198,0,0,0
234829,345,345,0,0,0
234836,8,8,0,0,0
234861,158,158,0,0,0
234899,27,27,0,0,0
234905,25,25,0,0,0
234917,158,158,0,0,0
234918,282,282,0,0,0
234919,2,2,0,0,0
234923,120,120,0,0,0
234927,345,345,0,0,0
234942,102,102,0,0,0
234952,54,54,0,0,0
234961,201,201,0,0,0
234967,255,255,0,0,0
234976,130,130,0,0,0
234980,102,102,0,0,0
234984,232,232,0,0,0
234990,82,82,0,0,0
234992,151,151,0,0,0
234995,39,39,0,0,0
235039,167,167,0,0,0
235054,12,12,0,0,0
235086,251,251,0,0,0
235108,18,18,0,0,0
235140,252,252,0,0,0
235141,315,315,0,0,0
235151,353,353,0,0,0
235154,130,130,0,0,0
235156,36,36,0,0,0
235162,34,34,0,0,0
235218,151,151,0,0,0
235233,353,353,0,0,0
235253,255,255,0,0,0
235259,315,315,0,0,0
235264,193,193,0,0,0
235292,313,313,0,0,0
235303,359,359,0,0,0
235320,72,72,0,0,0
235321,313,313,0,0,0
235340,32,32,0,0,0
235344,184,184,0,0,0
235355,152,152,0,0,0
235370,310,310,0,0,0
235391,255,255,0,0,0
235408,67,67,0,0,0
235409,310,310,0,0,0
235412,310,310,0,0,0
235442,184,184,0,0,0
235445,23,23,0,0,0
235454,402,402,0,0,0
235462,359,359,0,0,0
235491,281,281,0,0,0
235499,152,152,0,0,0
235524,315,315,0,0,0
235535,8,8,0,0,0
235537,306,306,0,0,0
235539,113,113,0,0,0
235549,82,82,0,0,0
235555,402,402,0,0,0
235557,132,132,0,0,0
235566,255,255,0,0,0
235571,76,76,0,0,0
235583,402,402,0,0,0
235607,103,103,0,0,0
235621,58,58,0,0,0
235632,71,71,0,0,0
235660,246,246,0,0,0
235678,168,168,0,0,0
235681,10,10,0,0,0
235683,76,76,0,0,0
235684,163,163,0,0,0
235685,255,255,0,0,0
235695,32,32,0,0,0
235699,281,281,0,0,0
235703,299,299,0,0,0
235705,120,120,0,0,0
235706,259,259,0,0,0
235720,255,255,0,0,0
235728,310,310,0,0,0
235742,113,113,0,0,0
235751,143,143,0,0,0
235752,121,121,0,0,0
235760,83,83,0,0,0
235767,282,282,0,0,0
235778,67,67,0,0,0
235784,83,83,0,0,0
235790,67,67,0,0,0
235800,15,15,0,0,0
235804,65,65,0,0,0
235809,14,14,0,0,0
235815,76,76,0,0,0
235816,56,56,0,0,0
235817,201,201,0,0,0
235823,163,163,0,0,0
235824,345,345,0,0,0
235831,35,35,0,0,0
235837,201,201,0,0,0
235855,76,76,0,0,0
235856,56,56,0,0,0
235881,158,158,0,0,0
235886,44,44,0,0,0
235890,163,163,0,0,0
235896,259,259,0,0,0
235899,74,74,0,0,0
235905,44,44,0,0,0
235907,18,18,0,0,0
235908,143,143,0,0,0
235920,30,30,0,0,0
235923,310,310,0,0,0
235928,7,7,0,0,0
235932,24,24,0,0,0
235934,56,56,0,0,0
235942,57,57,0,0,0
235952,130,130,0,0,0
235961,255,255,0,0,0
235969,345,345,0,0,0
235975,201,201,0,0,0
235978,359,359,0,0,0
235992,315,315,0,0,0
235999,2,2,0,0,0
236007,82,82,0,0,0
236014,171,171,0,0,0
236038,144,144,0,0,0
236039,402,402,0,0,0
236041,281,281,0,0,0
236066,56,56,0,0,0
236068,63,63,0,0,0
236073,402,402,0,0,0
236089,137,137,0,0,0
236091,201,201,0,0,0
236097,143,143,0,0,0
236119,345,345,0,0,0
236125,3,3,0,0,0
236132,255,255,0,0,0
236139,259,259,0,0,0
236155,65,65,0,0,0
236160,168,168,0,0,0
236177,167,167,0,0,0
236182,76,76,0,0,0
236187,69,69,0,0,0
236196,35,35,0,0,0
236211,184,184,0,0,0
236215,163,163,0,0,0
236271,50,50,0,0,0
236280,10,10,0,0,0
236295,10,10,0,0,0
236296,85,85,0,0,0
236298,76,76,0,0,0
236299,144,144,0,0,0
236302,50,50,0,0,0
236303,167,167,0,0,0
236333,85,85,0,0,0
236338,128,128,0,0,0
236344,299,299,0,0,0
236345,65,65,0,0,0
236365,120,120,0,0,0
236367,163,163,0,0,0
236370,74,74,0,0,0
236405,97,97,0,0,0
236410,184,184,0,0,0
236411,76,76,0,0,0
236412,128,128,0,0,0
236418,232,232,0,0,0
236423,281,281,0,0,0
236424,232,232,0,0,0
236440,345,345,0,0,0
236445,102,102,0,0,0
236452,144,144,0,0,0
236453,30,30,0,0,0
236475,251,251,0,0,0
236477,306,306,0,0,0
236481,6,6,0,0,0
236494,7,7,0,0,0
236498,35,35,0,0,0
236507,130,130,0,0,0
236511,259,259,0,0,0
236515,168,168,0,0,0
236531,313,313,0,0,0
236537,251,251,0,0,0
236569,6,6,0,0,0
236570,121,121,0,0,0
236572,246,246,0,0,0
236573,121,121,0,0,0
236574,251,251,0,0,0
236577,25,25,0,0,0
236585,132,132,0,0,0
236593,359,359,0,0,0
236595,306,306,0,0,0
236598,76,76,0,0,0
236606,402,402,0,0,0
236613,299,299,0,0,0
236618,193,193,0,0,0
236631,82,82,0,0,0
236644,313,313,0,0,0
236646,17,17,0,0,0
236655,259,259,0,0,0
236675,76,76,0,0,0
236692,251,251,0,0,0
236696,12,12,0,0,0
236703,313,313,0,0,0
236704,184,184,0,0,0
236707,114,114,0,0,0
236708,16,16,0,0,0
236711,75,75,0,0,0
236728,29,29,0,0,0
236739,310,310,0,0,0
236781,299,299,0,0,0
236801,184,184,0,0,0
236803,56,56,0,0,0
236815,30,30,0,0,0
236821,17,17,0,0,0
236832,16,16,0,0,0
236833,310,310,0,0,0
236854,57,57,0,0,0
236866,18,18,0,0,0
236892,6,6,0,0,0
236894,5,5,0,0,0
236899,167,167,0,0,0
236909,113,113,0,0,0
236944,306,306,0,0,0
236945,299,299,0,0,0
236950,34,34,0,0,0
236960,299,299,0,0,0
236969,102,102,0,0,0
236971,29,29,0,0,0
236986,359,359,0,0,0
236999,281,281,0,0,0
237000,114,114,0,0,0
237017,152,152,0,0,0
237020,255,255,0,0,0
237030,282,282,0,0,0
237035,167,167,0,0,0
237056,18,18,0,0,0
237091,24,24,0,0,0
237144,113,113,0,0,0
237175,232,232,0,0,0
237188,15,15,0,0,0
237193,8,8,0,0,0
237212,41,41,0,0,0
237219,25,25,0,0,0
237234,252,252,0,0,0
237240,281,281,0,0,0
237243,201,201,0,0,0
237244,137,137,0,0,0
237248,402,402,0,0,0
237251,57,57,0,0,0
237253,306,306,0,0,0
237255,130,130,0,0,0
237257,131,131,0,0,0
237275,353,353,0,0,0
237285,70,70,0,0,0
237287,345,345,0,0,0
237291,44,44,0,0,0
237299,16,16,0,0,0
237306,103,103,0,0,0
237308,201,201,0,0,0
237312,306,306,0,0,0
237322,144,144,0,0,0
237328,44,44,0,0,0
237335,10,10,0,0,0
237384,72,72,0,0,0
237393,143,143,0,0,0
237398,353,353,0,0,0
237403,41,41,0,0,0
237411,103,103,0,0,0
237412,102,102,0,0,0
237413,65,65,0,0,0
237420,310,310,0,0,0
237437,143,143,0,0,0
237450,66,66,0,0,0
237463,299,299,0,0,0
237474,151,151,0,0,0
237475,246,246,0,0,0
237477,201,201,0,0,0
237502,67,67,0,0,0
237508,180,180,0,0,0
237515,282,282,0,0,0
237522,281,281,0,0,0
237537,120,120,0,0,0
237540,137,137,0,0,0
237547,180,180,0,0,0
237553,251,251,0,0,0
237573,114,114,0,0,0
237577,19,19,0,0,0
237587,310,310,0,0,0
237588,82,82,0,0,0
237591,69,69,0,0,0
237611,137,137,0,0,0
237628,255,255,0,0,0
237631,251,251,0,0,0
237632,50,50,0,0,0
237634,180,180,0,0,0
237641,232,232,0,0,0
237642,359,359,0,0,0
237643,151,151,0,0,0
237661,8,8,0,0,0
237668,163,163,0,0,0
237686,50,50,0,0,0
237702,29,29,0,0,0
237760,345,345,0,0,0
237767,3,3,0,0,0
237775,359,359,0,0,0
237784,152,152,0,0,0
237785,131,131,0,0,0
237793,299,299,0,0,0
237813,359,359,0,0,0
237817,143,143,0,0,0
237824,87,87,0,0,0
237837,55,55,0,0,0
237840,102,102,0,0,0
237853,102,102,0,0,0
237864,171,171,0,0,0
237874,232,232,0,0,0
237883,353,353,0,0,0
237893,34,34,0,0,0
237896,20,20,0,0,0
237908,97,97,0,0,0
237924,17,17,0,0,0
237929,353,353,0,0,0
237966,97,97,0,0,0
237969,74,74,0,0,0
237979,255,255,0,0,0
237987,144,144,0,0,0
237996,44,44,0,0,0
238002,25,25,0,0,0
238005,12,12,0,0,0
238013,402,402,0,0,0
238028,65,65,0,0,0
238032,24,24,0,0,0
238063,132,132,0,0,0
238101,128,128,0,0,0
238105,168,168,0,0,0
238114,315,315,0,0,0
238125,34,34,0,0,0
238131,198,198,0,0,0
238158,402,402,0,0,0
238170,114,114,0,0,0
238189,82,82,0,0,0
238202,306,306,0,0,0
238205,137,137,0,0,0
238206,114,114,0,0,0
238212,29,29,0,0,0
238223,193,193,0,0,0
238229,232,232,0,0,0
238239,193,193,0,0,0
238247,299,299,0,0,0
238251,76,76,0,0,0
238260,114,114,0,0,0
238265,251,251,0,0,0
238271,83,83,0,0,0
238276,252,252,0,0,0
238282,198,198,0,0,0
238286,131,131,0,0,0
238299,259,259,0,0,0
238301,144,144,0,0,0
238304,144,144,0,0,0
238312,41,41,0,0,0
238341,198,198,0,0,0
238352,71,71,0,0,0
238363,70,70,0,0,0
238364,158,158,0,0,0
238374,359,359,0,0,0
238376,12,12,0,0,0
238377,299,299,0,0,0
238378,315,315,0,0,0
238385,83,83,0,0,0
238386,76,76,0,0,0
238395,299,299,0,0,0
238410,2,2,0,0,0
238417,13,13,0,0,0
238429,43,43,0,0,0
238448,168,168,0,0,0
238454,121,121,0,0,0
238458,75,75,0,0,0
238496,6,6,0,0,0
238497,353,353,0,0,0
238500,255,255,0,0,0
238504,167,167,0,0,0
238506,5,5,0,0,0
238507,315,315,0,0,0
238508,43,43,0,0,0
238515,24,24,0,0,0
238524,167,167,0,0,0
238528,102,102,0,0,0
238533,74,74,0,0,0
238534,306,306,0,0,0
238553,22,22,0,0,0
238559,184,184,0,0,0
238568,137,137,0,0,0
238578,101,101,0,0,0
238586,299,299,0,0,0
238601,353,353,0,0,0
238609,151,151,0,0,0
238628,74,74,0,0,0
238635,402,402,0,0,0
238638,15,15,0,0,0
238655,255,255,0,0,0
238659,232,232,0,0,0
238697,252,252,0,0,0
238720,171,171,0,0,0
238729,12,12,0,0,0
238732,9,9,0,0,0
238761,168,168,0,0,0
238766,144,144,0,0,0
238770,137,137,0,0,0
238802,315,315,0,0,0
238805,137,137,0,0,0
238820,151,151,0,0,0
238834,255,255,0,0,0
238841,151,151,0,0,0
238879,29,29,0,0,0
238880,171,171,0,0,0
238937,299,299,0,0,0
238971,102,102,0,0,0
238978,39,39,0,0,0
238982,83,83,0,0,0
239014,299,299,0,0,0
239015,345,345,0,0,0
239025,198,198,0,0,0
239058,310,310,0,0,0
239062,168,168,0,0,0
239064,77,77,0,0,0
239090,19,19,0,0,0
239101,252,252,0,0,0
239102,345,345,0,0,0
239116,13,13,0,0,0
239126,103,103,0,0,0
239131,193,193,0,0,0
239149,2,2,0,0,0
239159,198,198,0,0,0
239164,113,113,0,0,0
239244,143,143,0,0,0
239246,56,56,0,0,0
239256,345,345,0,0,0
239258,359,359,0,0,0
239267,184,184,0,0,0
239276,5,5,0,0,0
239291,168,168,0,0,0
239307,313,313,0,0,0
239337,16,16,0,0,0
239339,6,6,0,0,0
239346,130,130,0,0,0
239347,151,151,0,0,0
239350,282,282,0,0,0
239377,70,70,0,0,0
239383,43,43,0,0,0
239387,310,310,0,0,0
239408,6,6,0,0,0
239413,120,120,0,0,0
239414,163,163,0,0,0
239415,56,56,0,0,0
239417,70,70,0,0,0
239420,132,132,0,0,0
239424,252,252,0,0,0
239452,359,359,0,0,0
239454,50,50,0,0,0
239460,72,72,0,0,0
239470,10,10,0,0,0
239486,246,246,0,0,0
239530,128,128,0,0,0
239533,83,83,0,0,0
239545,19,19,0,0,0
239550,232,232,0,0,0
239554,137,137,0,0,0
239556,402,402,0,0,0
239567,45,45,0,0,0
239574,121,121,0,0,0
239601,35,35,0,0,0
239608,102,102,0,0,0
239611,35,35,0,0,0
239612,184,184,0,0,0
239620,102,102,0,0,0
239624,281,281,0,0,0
239627,310,310,0,0,0
239631,87,87,0,0,0
239633,313,313,0,0,0
239636,63,63,0,0,0
239644,25,25,0,0,0
239654,353,353,0,0,0
239666,299,299,0,0,0
239667,143,143,0,0,0
239670,137,137,0,0,0
239675,56,56,0,0,0
239677,193,193,0,0,0
239699,402,402,0,0,0
239702,16,16,0,0,0
239707,310,310,0,0,0
239714,69,69,0,0,0
239718,282,282,0,0,0
239724,306,306,0,0,0
239726,22,22,0,0,0
239729,20,20,0,0,0
239750,180,180,0,0,0
239757,97,97,0,0,0
239767,20,20,0,0,0
239768,143,143,0,0,0
239773,315,315,0,0,0
239783,359,359,0,0,0
239789,201,201,0,0,0
239858,22,22,0,0,0
239875,76,76,0,0,0
239887,19,19,0,0,0
239906,5,5,0,0,0
239937,193,193,0,0,0
239945,56,56,0,0,0
239965,128,128,0,0,0
239967,246,246,0,0,0
239968,17,17,0,0,0
239969,255,255,0,0,0
239972,193,193,0,0,0
239976,255,255,0,0,0
239977,198,198,0,0,0
239978,246,246,0,0,0
239998,180,180,0,0,0
240014,8,8,0,0,0
240029,259,259,0,0,0
240030,232,232,0,0,0
240034,87,87,0,0,0
240050,36,36,0,0,0
240057,74,74,0,0,0
240066,121,121,0,0,0
240118,43,43,0,0,0
240120,5,5,0,0,0
240190,143,143,0,0,0
240230,23,23,0,0,0
240243,18,18,0,0,0
240244,299,299,0,0,0
240268,94,94,0,0,0
240271,4,4,0,0,0
240272,193,193,0,0,0
240274,171,171,0,0,0
240280,282,282,0,0,0
240281,76,76,0,0,0
240283,120,120,0,0,0
240284,8,8,0,0,0
240285,255,255,0,0,0
240291,24,24,0,0,0
240294,232,232,0,0,0
240297,359,359,0,0,0
240301,6,6,0,0,0
240307,27,27,0,0,0
240309,17,17,0,0,0
240329,57,57,0,0,0
240354,299,299,0,0,0
240389,102,102,0,0,0
240400,22,22,0,0,0
240403,255,255,0,0,0
240411,131,131,0,0,0
240427,315,315,0,0,0
240429,131,131,0,0,0
240434,143,143,0,0,0
240441,167,167,0,0,0
240470,359,359,0,0,0
240476,259,259,0,0,0
240498,22,22,0,0,0
240499,310,310,0,0,0
240500,143,143,0,0,0
240503,76,76,0,0,0
240514,39,39,0,0,0
240520,57,57,0,0,0
240522,114,114,0,0,0
240529,168,168,0,0,0
240532,193,193,0,0,0
240602,158,158,0,0,0
240607,137,137,0,0,0
240616,144,144,0,0,0
240647,345,345,0,0,0
240659,66,66,0,0,0
240693,30,30,0,0,0
240713,353,353,0,0,0
240745,168,168,0,0,0
240757,2,2,0,0,0
240772,137,137,0,0,0
240773,74,74,0,0,0
240780,152,152,0,0,0
240781,345,345,0,0,0
240783,402,402,0,0,0
240804,29,29,0,0,0
240817,180,180,0,0,0
240818,130,130,0,0,0
240822,345,345,0,0,0
240868,132,132,0,0,0
240876,255,255,0,0,0
240877,402,402,0,0,0
240878,22,22,0,0,0
240895,313,313,0,0,0
240936,97,97,0,0,0
240974,83,83,0,0,0
240980,76,76,0,0,0
240984,137,137,0,0,0
240987,144,144,0,0,0
240995,74,74,0,0,0
240998,113,113,0,0,0
241018,359,359,0,0,0
241031,171,171,0,0,0
241051,310,310,0,0,0
241077,102,102,0,0,0
241118,102,102,0,0,0
241123,281,281,0,0,0
241159,151,151,0,0,0
241171,193,193,0,0,0
241187,281,281,0,0,0
241191,76,76,0,0,0
241196,13,13,0,0,0
241212,259,259,0,0,0
241223,137,137,0,0,0
241226,345,345,0,0,0
241231,252,252,0,0,0
241234,114,114,0,0,0
241261,359,359,0,0,0
241269,72,72,0,0,0
241270,1,1,0,0,0
241290,15,15,0,0,0
241300,9,9,0,0,0
241307,310,310,0,0,0
241321,113,113,0,0,0
241330,54,54,0,0,0
241331,85,85,0,0,0
241364,255,255,0,0,0
241368,69,69,0,0,0
241383,54,54,0,0,0
241391,315,315,0,0,0
241398,72,72,0,0,0
241400,34,34,0,0,0
241408,130,130,0,0,0
241412,359,359,0,0,0
241413,255,255,0,0,0
241415,113,113,0,0,0
241426,255,255,0,0,0
241428,70,70,0,0,0
241446,198,198,0,0,0
241464,299,299,0,0,0
241499,25,25,0,0,0
241570,97,97,0,0,0
241578,114,114,0,0,0
241595,18,18,0,0,0
241615,345,345,0,0,0
241626,1,1,0,0,0
241627,15,15,0,0,0
241646,94,94,0,0,0
241649,18,18,0,0,0
241664,69,69,0,0,0
241681,201,201,0,0,0
241696,29,29,0,0,0
241718,252,252,0,0,0
241742,114,114,0,0,0
241753,246,246,0,0,0
241756,128,128,0,0,0
241761,306,306,0,0,0
241807,168,168,0,0,0
241822,54,54,0,0,0
241846,152,152,0,0,0
241858,113,113,0,0,0
241885,137,137,0,0,0
241893,137,137,0,0,0
241898,144,144,0,0,0
241899,299,299,0,0,0
241918,359,359,0,0,0
241922,252,252,0,0,0
241923,167,167,0,0,0
241934,282,282,0,0,0
241958,198,198,0,0,0
241965,282,282,0,0,0
241969,77,77,0,0,0
241981,76,76,0,0,0
241983,131,131,0,0,0
241993,128,128,0,0,0
241995,13,13,0,0,0
242009,310,310,0,0,0
242013,163,163,0,0,0
242033,102,102,0,0,0
242038,87,87,0,0,0
242055,315,315,0,0,0
242058,71,71,0,0,0
242067,57,57,0,0,0
242074,22,22,0,0,0
242078,402,402,0,0,0
242088,144,144,0,0,0
242096,252,252,0,0,0
242101,36,36,0,0,0
242158,402,402,0,0,0
242161,353,353,0,0,0
242180,158,158,0,0,0
242185,56,56,0,0,0
242186,94,94,0,0,0
242201,82,82,0,0,0
242220,180,180,0,0,0
242223,313,313,0,0,0
242228,2,2,0,0,0
242247,10,10,0,0,0
242254,252,252,0,0,0
242257,232,232,0,0,0
242272,345,345,0,0,0
242276,345,345,0,0,0
242281,345,345,0,0,0
242285,120,120,0,0,0
242293,402,402,0,0,0
242307,359,359,0,0,0
242318,306,306,0,0,0
242327,56,56,0,0,0
242334,281,281,0,0,0
242342,39,39,0,0,0
242376,201,201,0,0,0
242391,72,72,0,0,0
242412,255,255,0,0,0
242437,137,137,0,0,0
242441,163,163,0,0,0
242442,402,402,0,0,0
242454,131,131,0,0,0
242475,246,246,0,0,0
242477,97,97,0,0,0
242479,315,315,0,0,0
242512,201,201,0,0,0
242515,9,9,0,0,0
242517,144,144,0,0,0
242518,313,313,0,0,0
242521,144,144,0,0,0
242525,299,299,0,0,0
242526,131,131,0,0,0
242529,158,158,0,0,0
242540,85,85,0,0,0
242553,252,252,0,0,0
242556,402,402,0,0,0
242563,45,45,0,0,0
242564,359,359,0,0,0
242572,3,3,0,0,0
242597,180,180,0,0,0
242622,72,72,0,0,0
242625,299,299,0,0,0
242631,255,255,0,0,0
242659,359,359,0,0,0
242663,359,359,0,0,0
242677,11,11,0,0,0
242680,402,402,0,0,0
242691,2,2,0,0,0
242707,133,133,0,0,0
242710,76,76,0,0,0
242716,74,74,0,0,0
242718,12,12,0,0,0
242725,402,402,0,0,0
242729,55,55,0,0,0
242739,281,281,0,0,0
242752,97,97,0,0,0
242758,35,35,0,0,0
242761,72,72,0,0,0
242766,251,251,0,0,0
242773,76,76,0,0,0
242778,193,193,0,0,0
242799,353,353,0,0,0
242803,17,17,0,0,0
242819,75,75,0,0,0
242833,12,12,0,0,0
242866,32,32,0,0,0
242870,282,282,0,0,0
242880,171,171,0,0,0
242883,16,16,0,0,0
242886,6,6,0,0,0
242894,11,11,0,0,0
242904,143,143,0,0,0
242906,3,3,0,0,0
242915,299,299,0,0,0
242924,201,201,0,0,0
242925,232,232,0,0,0
242926,359,359,0,0,0
242931,6,6,0,0,0
242940,180,180,0,0,0
242944,137,137,0,0,0
242957,144,144,0,0,0
242958,22,22,0,0,0
242961,16,16,0,0,0
242981,315,315,0,0,0
242983,246,246,0,0,0
242987,50,50,0,0,0
243011,251,251,0,0,0
243028,143,143,0,0,0
243033,246,246,0,0,0
243038,345,345,0,0,0
243043,201,201,0,0,0
243052,76,76,0,0,0
243065,83,83,0,0,0
243066,137,137,0,0,0
243089,163,163,0,0,0
243109,24,24,0,0,0
243121,29,29,0,0,0
243133,36,36,0,0,0
243137,310,310,0,0,0
243144,69,69,0,0,0
243147,16,16,0,0,0
243166,63,63,0,0,0
243189,85,85,0,0,0
243197,114,114,0,0,0
243200,345,345,0,0,0
243214,36,36,0,0,0
243223,171,171,0,0,0
243237,6,6,0,0,0
243240,102,102,0,0,0
243262,282,282,0,0,0
243267,198,198,0,0,0
243269,246,246,0,0,0
243272,67,67,0,0,0
243277,299,299,0,0,0
243303,1,1,0,0,0
243314,313,313,0,0,0
243321,299,299,0,0,0
243340,18,18,0,0,0
243372,70,70,0,0,0
243377,133,133,0,0,0
243385,18,18,0,0,0
243390,345,345,0,0,0
243392,23,23,0,0,0
243394,83,83,0,0,0
243397,121,121,0,0,0
243402,10,10,0,0,0
243403,180,180,0,0,0
243413,402,402,0,0,0
243421,345,345,0,0,0
243424,315,315,0,0,0
243439,12,12,0,0,0
243454,9,9,0,0,0
243473,2,2,0,0,0
243479,246,246,0,0,0
243480,74,74,0,0,0
243483,201,201,0,0,0
243487,144,144,0,0,0
243518,306,306,0,0,0
243539,299,299,0,0,0
243541,171,171,0,0,0
243543,144,144,0,0,0
243552,353,353,0,0,0
243560,345,345,0,0,0
243563,83,83,0,0,0
243564,137,137,0,0,0
243581,171,171,0,0,0
243586,6,6,0,0,0
243593,74,74,0,0,0
243596,359,359,0,0,0
243609,184,184,0,0,0
243617,345,345,0,0,0
243623,54,54,0,0,0
243628,252,252,0,0,0
243632,114,114,0,0,0
243639,12,12,0,0,0
243665,193,193,0,0,0
243676,232,232,0,0,0
243681,83,83,0,0,0
243686,281,281,0,0,0
243688,76,76,0,0,0
243699,281,281,0,0,0
243705,75,75,0,0,0
243707,29,29,0,0,0
243712,71,71,0,0,0
243722,313,313,0,0,0
243728,102,102,0,0,0
243732,193,193,0,0,0
243736,137,137,0,0,0
243743,25,25,0,0,0
243753,55,55,0,0,0
243772,359,359,0,0,0
243783,75,75,0,0,0
243785,35,35,0,0,0
243811,198,198,0,0,0
243854,259,259,0,0,0
243855,313,313,0,0,0
243887,259,259,0,0,0
243895,359,359,0,0,0
243907,87,87,0,0,0
243921,171,171,0,0,0
243931,85,85,0,0,0
243933,144,144,0,0,0
243934,359,359,0,0,0
243941,137,137,0,0,0
243978,246,246,0,0,0
243995,353,353,0,0,0
244004,102,102,0,0,0
244007,299,299,0,0,0
244009,94,94,0,0,0
244020,353,353,0,0,0
244024,158,158,0,0,0
244032,35,35,0,0,0
244036,17,17,0,0,0
244045,19,19,0,0,0
244055,144,144,0,0,0
244060,252,252,0,0,0
244062,69,69,0,0,0
244117,120,120,0,0,0
244129,137,137,0,0,0
244133,137,137,0,0,0
244138,163,163,0,0,0
244139,402,402,0,0,0
244149,402,402,0,0,0
244150,315,315,0,0,0
244151,345,345,0,0,0
244175,63,63,0,0,0
244181,9,9,0,0,0
244202,29,29,0,0,0
244224,20,20,0,0,0
244234,65,65,0,0,0
244240,315,315,0,0,0
244251,402,402,0,0,0
244270,103,103,0,0,0
244278,103,103,0,0,0
244283,76,76,0,0,0
244329,29,29,0,0,0
244331,76,76,0,0,0
244333,72,72,0,0,0
244340,313,313,0,0,0
244345,232,232,0,0,0
244349,137,137,0,0,0
244379,34,34,0,0,0
244397,16,16,0,0,0
244398,76,76,0,0,0
244411,74,74,0,0,0
244414,103,103,0,0,0
244417,252,252,0,0,0
244426,65,65,0,0,0
244436,306,306,0,0,0
244461,17,17,0,0,0
244462,158,158,0,0,0
244493,121,121,0,0,0
244506,299,299,0,0,0
244508,281,281,0,0,0
244525,345,345,0,0,0
244541,151,151,0,0,0
244549,313,313,0,0,0
244573,43,43,0,0,0
244592,167,167,0,0,0
244639,345,345,0,0,0
244641,299,299,0,0,0
244644,16,16,0,0,0
244651,10,10,0,0,0
244669,299,299,0,0,0
244679,251,251,0,0,0
244705,168,168,0,0,0
244710,232,232,0,0,0
244713,402,402,0,0,0
244724,103,103,0,0,0
244738,151,151,0,0,0
244749,313,313,0,0,0
244755,180,180,0,0,0
244761,251,251,0,0,0
244783,167,167,0,0,0
244796,163,163,0,0,0
244808,353,353,0,0,0
244814,43,43,0,0,0
244829,359,359,0,0,0
244837,97,97,0,0,0
244839,34,34,0,0,0
244861,70,70,0,0,0
244873,345,345,0,0,0
244893,402,402,0,0,0
244901,102,102,0,0,0
244917,163,163,0,0,0
244923,282,282,0,0,0
244927,20,20,0,0,0
244940,15,15,0,0,0
244946,2,2,0,0,0
244951,313,313,0,0,0
244956,315,315,0,0,0
244964,313,313,0,0,0
244965,282,282,0,0,0
244972,299,299,0,0,0
244982,128,128,0,0,0
245011,232,232,0,0,0
245013,70,70,0,0,0
245019,359,359,0,0,0
245021,168,168,0,0,0
245029,315,315,0,0,0
245035,25,25,0,0,0
245072,83,83,0,0,0
245078,102,102,0,0,0
245088,353,353,0,0,0
245100,83,83,0,0,0
245127,130,130,0,0,0
245134,1,1,0,0,0
245151,101,101,0,0,0
245164,76,76,0,0,0
245168,137,137,0,0,0
245177,12,12,0,0,0
245181,18,18,0,0,0
245183,168,168,0,0,0
245187,76,76,0,0,0
245189,158,158,0,0,0
245211,198,198,0,0,0
245212,167,167,0,0,0
245215,72,72,0,0,0
245224,313,313,0,0,0
245231,151,151,0,0,0
245255,299,299,0,0,0
245261,137,137,0,0,0
245304,28,28,0,0,0
245310,315,315,0,0,0
245321,193,193,0,0,0
245323,69,69,0,0,0
245330,22,22,0,0,0
245363,39,39,0,0,0
245367,353,353,0,0,0
245368,345,345,0,0,0
245377,94,94,0,0,0
245379,180,180,0,0,0
245383,15,15,0,0,0
245389,353,353,0,0,0
245419,255,255,0,0,0
245425,58,58,0,0,0
245431,65,65,0,0,0
245460,85,85,0,0,0
245463,50,50,0,0,0
245464,133,133,0,0,0
245480,198,198,0,0,0
245486,3,3,0,0,0
245498,130,130,0,0,0
245500,77,77,0,0,0
245510,180,180,0,0,0
245528,232,232,0,0,0
245543,39,39,0,0,0
245553,19,19,0,0,0
245567,132,132,0,0,0
245590,25,25,0,0,0
245595,130,130,0,0,0
245607,5,5,0,0,0
245609,97,97,0,0,0
245619,168,168,0,0,0
245633,34,34,0,0,0
245650,252,252,0,0,0
245657,151,151,0,0,0
245662,313,313,0,0,0
245663,201,201,0,0,0
245665,70,70,0,0,0
245668,130,130,0,0,0
245669,359,359,0,0,0
245688,77,77,0,0,0
245711,359,359,0,0,0
245719,259,259,0,0,0
245728,11,11,0,0,0
245729,137,137,0,0,0
245737,137,137,0,0,0
245755,184,184,0,0,0
245763,66,66,0,0,0
245765,402,402,0,0,0
245780,23,23,0,0,0
245782,306,306,0,0,0
245785,315,315,0,0,0
245786,255,255,0,0,0
245801,255,255,0,0,0
245805,16,16,0,0,0
245811,306,306,0,0,0
245818,21,21,0,0,0
245832,36,36,0,0,0
245837,306,306,0,0,0
245847,201,201,0,0,0
245854,121,121,0,0,0
245858,144,144,0,0,0
245871,281,281,0,0,0
245880,50,50,0,0,0
245885,65,65,0,0,0
245886,313,313,0,0,0
245891,152,152,0,0,0
245894,102,102,0,0,0
245896,94,94,0,0,0
245898,23,23,0,0,0
245899,282,282,0,0,0
245901,251,251,0,0,0
245903,27,27,0,0,0
245905,121,121,0,0,0
245908,114,114,0,0,0
245919,299,299,0,0,0
245924,193,193,0,0,0
245930,168,168,0,0,0
245953,77,77,0,0,0
245963,36,36,0,0,0
245965,299,299,0,0,0
245974,74,74,0,0,0
245986,402,402,0,0,0
245991,299,299,0,0,0
245992,158,158,0,0,0
246000,1,1,0,0,0
246001,252,252,0,0,0
246029,17,17,0,0,0
246030,246,246,0,0,0
246036,251,251,0,0,0
246041,75,75,0,0,0
246042,45,45,0,0,0
246047,158,158,0,0,0
246051,144,144,0,0,0
246052,281,281,0,0,0
246055,15,15,0,0,0
246086,198,198,0,0,0
246098,76,76,0,0,0
246138,353,353,0,0,0
246145,281,281,0,0,0
246166,232,232,0,0,0
246168,137,137,0,0,0
246172,143,143,0,0,0
246176,299,299,0,0,0
246183,130,130,0,0,0
246213,353,353,0,0,0
246219,315,315,0,0,0
246222,56,56,0,0,0
246232,171,171,0,0,0
246271,252,252,0,0,0
246285,130,130,0,0,0
246288,198,198,0,0,0
246297,198,198,0,0,0
246308,193,193,0,0,0
246309,27,27,0,0,0
246324,137,137,0,0,0
246343,158,158,0,0,0
246348,345,345,0,0,0
246351,246,246,0,0,0
246368,87,87,0,0,0
246376,402,402,0,0,0
246381,259,259,0,0,0
246395,76,76,0,0,0
246408,74,74,0,0,0
246413,74,74,0,0,0
246419,41,41,0,0,0
246428,55,55,0,0,0
246454,168,168,0,0,0
246465,34,34,0,0,0
246478,50,50,0,0,0
246528,252,252,0,0,0
246543,198,198,0,0,0
246554,281,281,0,0,0
246556,45,45,0,0,0
246573,71,71,0,0,0
246574,255,255,0,0,0
246580,8,8,0,0,0
246584,43,43,0,0,0
246588,65,65,0,0,0
246606,353,353,0,0,0
246612,94,94,0,0,0
246633,30,30,0,0,0
246634,20,20,0,0,0
246647,71,71,0,0,0
246653,43,43,0,0,0
246667,168,168,0,0,0
246676,353,353,0,0,0
246734,102,102,0,0,0
246735,44,44,0,0,0
246743,359,359,0,0,0
246744,255,255,0,0,0
246751,167,167,0,0,0
246760,137,137,0,0,0
246764,402,402,0,0,0
246780,163,163,0,0,0
246792,299,299,0,0,0
246814,359,359,0,0,0
246840,402,402,0,0,0
246846,85,85,0,0,0
246852,251,251,0,0,0
246861,313,313,0,0,0
246881,255,255,0,0,0
246892,137,137,0,0,0
246895,137,137,0,0,0
246904,2,2,0,0,0
246921,57,57,0,0,0
246950,144,144,0,0,0
246956,144,144,0,0,0
246970,167,167,0,0,0
246983,345,345,0,0,0
247004,345,345,0,0,0
247014,246,246,0,0,0
247026,232,232,0,0,0
247037,359,359,0,0,0
247038,255,255,0,0,0
247046,299,299,0,0,0
247051,18,18,0,0,0
247052,402,402,0,0,0
247078,232,232,0,0,0
247087,19,19,0,0,0
247093,198,198,0,0,0
247102,56,56,0,0,0
247124,158,158,0,0,0
247138,97,97,0,0,0
247150,114,114,0,0,0
247156,36,36,0,0,0
247168,5,5,0,0,0
247179,152,152,0,0,0
247217,232,232,0,0,0
247222,310,310,0,0,0
247245,252,252,0,0,0
247261,282,282,0,0,0
247268,198,198,0,0,0
247277,128,128,0,0,0
247282,168,168,0,0,0
247317,359,359,0,0,0
247321,359,359,0,0,0
247324,359,359,0,0,0
247345,72,72,0,0,0
247347,315,315,0,0,0
247363,133,133,0,0,0
247435,15,15,0,0,0
247437,67,67,0,0,0
247439,56,56,0,0,0
247449,315,315,0,0,0
247457,82,82,0,0,0
247459,97,97,0,0,0
247460,22,22,0,0,0
247482,24,24,0,0,0
247519,193,193,0,0,0
247534,72,72,0,0,0
247538,77,77,0,0,0
247552,255,255,0,0,0
247573,345,345,0,0,0
247605,282,282,0,0,0
247608,167,167,0,0,0
247615,201,201,0,0,0
247618,43,43,0,0,0
247619,12,12,0,0,0
247626,198,198,0,0,0
247629,35,35,0,0,0
247638,24,24,0,0,0
247685,63,63,0,0,0
247688,306,306,0,0,0
247700,94,94,0,0,0
247720,306,306,0,0,0
247728,50,50,0,0,0
247739,113,113,0,0,0
247742,310,310,0,0,0
247753,184,184,0,0,0
247755,281,281,0,0,0
247762,3,3,0,0,0
247778,11,11,0,0,0
247783,198,198,0,0,0
247789,353,353,0,0,0
247817,77,77,0,0,0
247825,102,102,0,0,0
247834,402,402,0,0,0
247841,168,168,0,0,0
247858,310,310,0,0,0
247863,12,12,0,0,0
247868,171,171,0,0,0
247879,50,50,0,0,0
247885,345,345,0,0,0
247891,76,76,0,0,0
247911,121,121,0,0,0
247923,246,246,0,0,0
247943,83,83,0,0,0
247945,7,7,0,0,0
247959,76,76,0,0,0
247981,34,34,0,0,0
247987,70,70,0,0,0
247990,101,101,0,0,0
248010,97,97,0,0,0
248012,299,299,0,0,0
248053,120,120,0,0,0
248060,12,12,0,0,0
248067,34,34,0,0,0
248072,102,102,0,0,0
248086,152,152,0,0,0
248090,128,128,0,0,0
248100,10,10,0,0,0
248160,35,35,0,0,0
248172,9,9,0,0,0
248196,133,133,0,0,0
248203,20,20,0,0,0
248233,14,14,0,0,0
248247,2,2,0,0,0
248256,281,281,0,0,0
248259,45,45,0,0,0
248283,313,313,0,0,0
248295,251,251,0,0,0
248302,180,180,0,0,0
248308,313,313,0,0,0
248310,17,17,0,0,0
248318,114,114,0,0,0
248322,167,167,0,0,0
248334,15,15,0,0,0
248335,259,259,0,0,0
248343,143,143,0,0,0
248364,310,310,0,0,0
248374,167,167,0,0,0
248390,75,75,0,0,0
248402,35,35,0,0,0
248417,252,252,0,0,0
248423,22,22,0,0,0
248447,198,198,0,0,0
248458,102,102,0,0,0
248461,184,184,0,0,0
248485,315,315,0,0,0
248495,281,281,0,0,0
248498,120,120,0,0,0
248500,97,97,0,0,0
248502,171,171,0,0,0
248512,402,402,0,0,0
248527,32,32,0,0,0
248534,359,359,0,0,0
248546,10,10,0,0,0
248549,353,353,0,0,0
248557,151,151,0,0,0
248561,251,251,0,0,0
248562,15,15,0,0,0
248576,76,76,0,0,0
248599,70,70,0,0,0
248600,114,114,0,0,0
248624,14,14,0,0,0
248626,353,353,0,0,0
248669,281,281,0,0,0
248690,10,10,0,0,0
248698,167,167,0,0,0
248701,402,402,0,0,0
248707,313,313,0,0,0
248715,114,114,0,0,0
248727,143,143,0,0,0
248758,143,143,0,0,0
248768,306,306,0,0,0
248769,69,69,0,0,0
248789,130,130,0,0,0
248812,121,121,0,0,0
248844,29,29,0,0,0
248859,19,19,0,0,0
248866,44,44,0,0,0
248870,167,167,0,0,0
248872,315,315,0,0,0
248881,121,121,0,0,0
248899,201,201,0,0,0
248905,143,143,0,0,0
248907,35,35,0,0,0
248915,27,27,0,0,0
248927,25,25,0,0,0
248947,201,201,0,0,0
248949,251,251,0,0,0
248951,167,167,0,0,0
248966,353,353,0,0,0
248993,12,12,0,0,0
249005,184,184,0,0,0
249029,102,102,0,0,0
249045,252,252,0,0,0
249056,137,137,0,0,0
249061,13,13,0,0,0
249062,345,345,0,0,0
249083,76,76,0,0,0
249085,87,87,0,0,0
249088,44,44,0,0,0
249100,101,101,0,0,0
249106,306,306,0,0,0
249113,76,76,0,0,0
249120,102,102,0,0,0
249121,131,131,0,0,0
249122,19,19,0,0,0
249127,180,180,0,0,0
249134,58,58,0,0,0
249151,359,359,0,0,0
249156,198,198,0,0,0
249175,198,198,0,0,0
249184,402,402,0,0,0
249194,128,128,0,0,0
249214,10,10,0,0,0
249233,313,313,0,0,0
249249,120,120,0,0,0
249253,313,313,0,0,0
249258,67,67,0,0,0
249282,313,313,0,0,0
249302,114,114,0,0,0
249304,255,255,0,0,0
249306,20,20,0,0,0
249322,50,50,0,0,0
249323,10,10,0,0,0
249338,310,310,0,0,0
249341,299,299,0,0,0
249343,29,29,0,0,0
249353,306,306,0,0,0
249391,34,34,0,0,0
249398,168,168,0,0,0
249399,402,402,0,0,0
249417,282,282,0,0,0
249438,359,359,0,0,0
249461,63,63,0,0,0
249480,345,345,0,0,0
249486,345,345,0,0,0
249489,246,246,0,0,0
249510,306,306,0,0,0
249513,345,345,0,0,0
249522,313,313,0,0,0
249526,102,102,0,0,0
249533,167,167,0,0,0
249540,24,24,0,0,0
249551,22,22,0,0,0
249559,353,353,0,0,0
249568,313,313,0,0,0
249590,313,313,0,0,0
249598,353,353,0,0,0
249601,299,299,0,0,0
249605,232,232,0,0,0
249620,310,310,0,0,0
249625,201,201,0,0,0
249629,282,282,0,0,0
249642,144,144,0,0,0
249644,50,50,0,0,0
249645,359,359,0,0,0
249654,310,310,0,0,0
249664,75,75,0,0,0
249670,306,306,0,0,0
249689,201,201,0,0,0
249693,306,306,0,0,0
249719,163,163,0,0,0
249723,184,184,0,0,0
249732,58,58,0,0,0
249740,310,310,0,0,0
249747,76,76,0,0,0
249751,306,306,0,0,0
249754,10,10,0,0,0
249755,128,128,0,0,0
249769,255,255,0,0,0
249801,29,29,0,0,0
249826,163,163,0,0,0
249830,16,16,0,0,0
249836,259,259,0,0,0
249839,259,259,0,0,0
249845,282,282,0,0,0
249878,232,232,0,0,0
249885,74,74,0,0,0
249887,167,167,0,0,0
249904,306,306,0,0,0
249931,131,131,0,0,0
249932,281,281,0,0,0
249948,9,9,0,0,0
249969,20,20,0,0,0
249971,113,113,0,0,0
249981,299,299,0,0,0
249991,315,315,0,0,0
250003,130,130,0,0,0
250008,29,29,0,0,0
250012,82,82,0,0,0
250028,163,163,0,0,0
250042,103,103,0,0,0
250045,201,201,0,0,0
250048,315,315,0,0,0
250060,359,359,0,0,0
250065,69,69,0,0,0
250071,299,299,0,0,0
250077,180,180,0,0,0
250078,70,70,0,0,0
250082,259,259,0,0,0
250091,120,120,0,0,0
250094,3,3,0,0,0
250103,259,259,0,0,0
250125,232,232,0,0,0
250126,76,76,0,0,0
250154,310,310,0,0,0
250180,19,19,0,0,0
250189,299,299,0,0,0
250194,402,402,0,0,0
250195,14,14,0,0,0
250238,36,36,0,0,0
250249,74,74,0,0,0
250276,130,130,0,0,0
250287,184,184,0,0,0
250301,167,167,0,0,0
250309,310,310,0,0,0
250311,70,70,0,0,0
250319,246,246,0,0,0
250336,359,359,0,0,0
250337,151,151,0,0,0
250349,201,201,0,0,0
250389,353,353,0,0,0
250404,345,345,0,0,0
250415,75,75,0,0,0
250417,345,345,0,0,0
250447,315,315,0,0,0
250453,36,36,0,0,0
250455,144,144,0,0,0
250460,184,184,0,0,0
250471,143,143,0,0,0
250473,128,128,0,0,0
250474,315,315,0,0,0
250476,402,402,0,0,0
250484,144,144,0,0,0
250488,97,97,0,0,0
250499,158,158,0,0,0
250501,35,35,0,0,0
250516,11,11,0,0,0
250531,114,114,0,0,0
250540,137,137,0,0,0
250544,282,282,0,0,0
250564,158,158,0,0,0
250565,246,246,0,0,0
250576,198,198,0,0,0
250585,131,131,0,0,0
250588,56,56,0,0,0
250596,94,94,0,0,0
250602,11,11,0,0,0
250631,43,43,0,0,0
250632,137,137,0,0,0
250635,70,70,0,0,0
250648,143,143,0,0,0
250689,72,72,0,0,0
250694,102,102,0,0,0
250696,11,11,0,0,0
250699,144,144,0,0,0
250711,137,137,0,0,0
250712,353,353,0,0,0
250716,9,9,0,0,0
250731,18,18,0,0,0
250748,102,102,0,0,0
250756,313,313,0,0,0
250758,75,75,0,0,0
250764,58,58,0,0,0
250783,50,50,0,0,0
250787,281,281,0,0,0
250791,353,353,0,0,0
250793,167,167,0,0,0
250804,282,282,0,0,0
250808,50,50,0,0,0
250819,282,282,0,0,0
250821,168,168,0,0,0
250823,20,20,0,0,0
250835,184,184,0,0,0
250865,193,193,0,0,0
250876,402,402,0,0,0
250878,34,34,0,0,0
250908,246,246,0,0,0
250919,18,18,0,0,0
250927,184,184,0,0,0
250930,143,143,0,0,0
250935,15,15,0,0,0
250945,246,246,0,0,0
250967,313,313,0,0,0
250980,131,131,0,0,0
250999,310,310,0,0,0
251006,133,133,0,0,0
251014,82,82,0,0,0
251024,144,144,0,0,0
251042,232,232,0,0,0
251048,9,9,0,0,0
251055,128,128,0,0,0
251069,137,137,0,0,0
251077,168,168,0,0,0
251097,74,74,0,0,0
251101,137,137,0,0,0
251107,94,94,0,0,0
251125,25,25,0,0,0
251166,353,353,0,0,0
251173,353,353,0,0,0
251174,313,313,0,0,0
251183,299,299,0,0,0
251185,76,76,0,0,0
251191,29,29,0,0,0
251205,306,306,0,0,0
251220,310,310,0,0,0
251229,163,163,0,0,0
251235,76,76,0,0,0
251238,1,1,0,0,0
251241,180,180,0,0,0
251253,246,246,0,0,0
251261,306,306,0,0,0
251263,132,132,0,0,0
251268,34,34,0,0,0
251273,313,313,0,0,0
251283,255,255,0,0,0
251287,232,232,0,0,0
251288,299,299,0,0,0
251293,259,259,0,0,0
251298,184,184,0,0,0
251301,184,184,0,0,0
251333,25,25,0,0,0
251337,76,76,0,0,0
251350,19,19,0,0,0
251369,180,180,0,0,0
251376,131,131,0,0,0
251384,45,45,0,0,0
251386,55,55,0,0,0
251391,27,27,0,0,0
251408,193,193,0,0,0
251433,246,246,0,0,0
251448,359,359,0,0,0
251471,15,15,0,0,0
251472,70,70,0,0,0
251494,3,3,0,0,0
251520,201,201,0,0,0
251525,163,163,0,0,0
251528,306,306,0,0,0
251558,306,306,0,0,0
251564,7,7,0,0,0
251566,232,232,0,0,0
251573,259,259,0,0,0
251575,121,121,0,0,0
251600,299,299,0,0,0
251604,101,101,0,0,0
251619,144,144,0,0,0
251667,193,193,0,0,0
251678,137,137,0,0,0
251686,83,83,0,0,0
251692,315,315,0,0,0
251730,151,151,0,0,0
251744,345,345,0,0,0
251747,299,299,0,0,0
251748,359,359,0,0,0
251750,151,151,0,0,0
251752,171,171,0,0,0
251761,306,306,0,0,0
251763,193,193,0,0,0
251790,101,101,0,0,0
251811,402,402,0,0,0
251822,137,137,0,0,0
251840,402,402,0,0,0
251849,282,282,0,0,0
251872,66,66,0,0,0
251889,152,152,0,0,0
251898,345,345,0,0,0
251915,76,76,0,0,0
251937,34,34,0,0,0
251948,131,131,0,0,0
251965,45,45,0,0,0
252008,82,82,0,0,0
252013,29,29,0,0,0
252015,259,259,0,0,0
252026,313,313,0,0,0
252031,6,6,0,0,0
252033,345,345,0,0,0
252058,6,6,0,0,0
252070,152,152,0,0,0
252074,193,193,0,0,0
252078,201,201,0,0,0
252079,1,1,0,0,0
252081,35,35,0,0,0
252117,97,97,0,0,0
252129,137,137,0,0,0
252136,102,102,0,0,0
252137,43,43,0,0,0
252156,133,133,0,0,0
252166,82,82,0,0,0
252173,55,55,0,0,0
252182,143,143,0,0,0
252188,193,193,0,0,0
252234,180,180,0,0,0
252236,75,75,0,0,0
252244,282,282,0,0,0
252246,171,171,0,0,0
252249,184,184,0,0,0
252255,30,30,0,0,0
252267,102,102,0,0,0
252270,54,54,0,0,0
252276,201,201,0,0,0
252280,232,232,0,0,0
252284,87,87,0,0,0
252301,193,193,0,0,0
252313,171,171,0,0,0
252325,29,29,0,0,0
252328,114,114,0,0,0
252353,299,299,0,0,0
252354,102,102,0,0,0
252355,102,102,0,0,0
252360,167,167,0,0,0
252361,402,402,0,0,0
252372,128,128,0,0,0
252377,168,168,0,0,0
252378,313,313,0,0,0
252379,113,113,0,0,0
252398,7,7,0,0,0
252407,310,310,0,0,0
252413,67,67,0,0,0
252414,71,71,0,0,0
252428,56,56,0,0,0
252454,128,128,0,0,0
252466,40,40,0,0,0
252476,1,1,0,0,0
252478,152,152,0,0,0
252480,132,132,0,0,0
252486,353,353,0,0,0
252490,252,252,0,0,0
252500,402,402,0,0,0
252503,193,193,0,0,0
252506,281,281,0,0,0
252508,402,402,0,0,0
252514,7,7,0,0,0
252521,16,16,0,0,0
252565,259,259,0,0,0
252569,152,152,0,0,0
252574,246,246,0,0,0
252577,359,359,0,0,0
252579,13,13,0,0,0
252605,345,345,0,0,0
252611,402,402,0,0,0
252628,168,168,0,0,0
252634,171,171,0,0,0
252657,313,313,0,0,0
252674,255,255,0,0,0
252675,163,163,0,0,0
252678,143,143,0,0,0
252679,151,151,0,0,0
252681,198,198,0,0,0
252687,131,131,0,0,0
252705,20,20,0,0,0
252708,36,36,0,0,0
252710,120,120,0,0,0
252730,171,171,0,0,0
252734,130,130,0,0,0
252735,17,17,0,0,0
252776,315,315,0,0,0
252799,315,315,0,0,0
252810,246,246,0,0,0
252821,252,252,0,0,0
252857,3,3,0,0,0
252867,75,75,0,0,0
252874,313,313,0,0,0
252886,184,184,0,0,0
252902,97,97,0,0,0
252905,22,22,0,0,0
252917,87,87,0,0,0
252933,77,77,0,0,0
252937,167,167,0,0,0
252947,282,282,0,0,0
252948,282,282,0,0,0
252955,310,310,0,0,0
252959,50,50,0,0,0
252960,83,83,0,0,0
252988,101,101,0,0,0
252996,3,3,0,0,0
253000,259,259,0,0,0
253002,65,65,0,0,0
253009,171,171,0,0,0
253013,246,246,0,0,0
253024,152,152,0,0,0
253047,77,77,0,0,0
253054,201,201,0,0,0
253062,168,168,0,0,0
253065,76,76,0,0,0
253066,77,77,0,0,0
253087,3,3,0,0,0
253125,82,82,0,0,0
253127,11,11,0,0,0
253154,168,168,0,0,0
253162,310,310,0,0,0
253163,137,137,0,0,0
253175,168,168,0,0,0
253183,306,306,0,0,0
253195,41,41,0,0,0
253201,251,251,0,0,0
253205,18,18,0,0,0
253209,22,22,0,0,0
253210,77,77,0,0,0
253222,353,353,0,0,0
253232,402,402,0,0,0
253237,345,345,0,0,0
253241,232,232,0,0,0
253242,34,34,0,0,0
253245,252,252,0,0,0
253250,44,44,0,0,0
253293,24,24,0,0,0
253324,281,281,0,0,0
253331,137,137,0,0,0
253341,16,16,0,0,0
253370,76,76,0,0,0
253408,353,353,0,0,0
253439,144,144,0,0,0
253444,5,5,0,0,0
253458,345,345,0,0,0
253477,252,252,0,0,0
253479,133,133,0,0,0
253487,158,158,0,0,0
253497,128,128,0,0,0
253520,201,201,0,0,0
253529,359,359,0,0,0
253533,18,18,0,0,0
253540,13,13,0,0,0
253547,133,133,0,0,0
253568,310,310,0,0,0
253598,32,32,0,0,0
253611,137,137,0,0,0
253624,70,70,0,0,0
253662,180,180,0,0,0
253668,15,15,0,0,0
253687,21,21,0,0,0
253688,201,201,0,0,0
253702,167,167,0,0,0
253706,282,282,0,0,0
253711,63,63,0,0,0
253726,56,56,0,0,0
253728,75,75,0,0,0
253730,69,69,0,0,0
253741,17,17,0,0,0
253750,246,246,0,0,0
253768,34,34,0,0,0
253770,137,137,0,0,0
253781,313,313,0,0,0
253784,67,67,0,0,0
253799,163,163,0,0,0
253805,72,72,0,0,0
253830,299,299,0,0,0
253846,35,35,0,0,0
253852,259,259,0,0,0
253857,10,10,0,0,0
253881,5,5,0,0,0
253883,255,255,0,0,0
253884,402,402,0,0,0
253900,23,23,0,0,0
253905,121,121,0,0,0
253917,15,15,0,0,0
253921,184,184,0,0,0
253934,83,83,0,0,0
253938,34,34,0,0,0
253953,12,12,0,0,0
253973,259,259,0,0,0
253982,281,281,0,0,0
253995,130,130,0,0,0
254001,94,94,0,0,0
254005,281,281,0,0,0
254023,299,299,0,0,0
254032,353,353,0,0,0
254058,74,74,0,0,0
254064,359,359,0,0,0
254082,22,22,0,0,0
254099,251,251,0,0,0
254117,70,70,0,0,0
254118,14,14,0,0,0
254121,180,180,0,0,0
254132,66,66,0,0,0
254139,19,19,0,0,0
254147,255,255,0,0,0
254181,50,50,0,0,0
254188,198,198,0,0,0
254196,65,65,0,0,0
254202,18,18,0,0,0
254211,113,113,0,0,0
254227,299,299,0,0,0
254230,121,121,0,0,0
254240,120,120,0,0,0
254243,306,306,0,0,0
254245,299,299,0,0,0
254271,15,15,0,0,0
254275,144,144,0,0,0
254287,168,168,0,0,0
254290,184,184,0,0,0
254321,3,3,0,0,0
254329,34,34,0,0,0
254332,44,44,0,0,0
254337,74,74,0,0,0
254346,402,402,0,0,0
254354,94,94,0,0,0
254399,345,345,0,0,0
254409,402,402,0,0,0
254413,282,282,0,0,0
254424,184,184,0,0,0
254434,281,281,0,0,0
254454,402,402,0,0,0
254473,1,1,0,0,0
254479,121,121,0,0,0
254483,313,313,0,0,0
254493,198,198,0,0,0
254511,353,353,0,0,0
254533,143,143,0,0,0
254541,313,313,0,0,0
254547,252,252,0,0,0
254560,281,281,0,0,0
254575,55,55,0,0,0
254582,17,17,0,0,0
254589,402,402,0,0,0
254597,36,36,0,0,0
254601,345,345,0,0,0
254610,282,282,0,0,0
254641,18,18,0,0,0
254642,259,259,0,0,0
254651,22,22,0,0,0
254656,315,315,0,0,0
254662,299,299,0,0,0
254680,184,184,0,0,0
254699,158,158,0,0,0
254705,152,152,0,0,0
254712,67,67,0,0,0
254719,306,306,0,0,0
254721,144,144,0,0,0
254735,85,85,0,0,0
254738,103,103,0,0,0
254739,22,22,0,0,0
254741,251,251,0,0,0
254744,315,315,0,0,0
254764,232,232,0,0,0
254777,102,102,0,0,0
254779,50,50,0,0,0
254798,282,282,0,0,0
254799,359,359,0,0,0
254800,20,20,0,0,0
254802,102,102,0,0,0
254812,97,97,0,0,0
254813,82,82,0,0,0
254845,310,310,0,0,0
254847,1,1,0,0,0
254850,35,35,0,0,0
254851,72,72,0,0,0
254861,168,168,0,0,0
254868,144,144,0,0,0
254876,246,246,0,0,0
254908,232,232,0,0,0
254910,255,255,0,0,0
254921,345,345,0,0,0
254932,8,8,0,0,0
254955,168,168,0,0,0
254959,76,76,0,0,0
254964,193,193,0,0,0
254967,193,193,0,0,0
255005,114,114,0,0,0
255011,76,76,0,0,0
255019,25,25,0,0,0
255026,252,252,0,0,0
255027,10,10,0,0,0
255029,43,43,0,0,0
255030,281,281,0,0,0
255050,137,137,0,0,0
255055,71,71,0,0,0
255083,359,359,0,0,0
255092,102,102,0,0,0
255105,299,299,0,0,0
255130,313,313,0,0,0
255134,251,251,0,0,0
255138,402,402,0,0,0
255158,87,87,0,0,0
255168,281,281,0,0,0
255177,252,252,0,0,0
255188,102,102,0,0,0
255191,184,184,0,0,0
255206,3,3,0,0,0
255216,313,313,0,0,0
255230,12,12,0,0,0
255245,71,71,0,0,0
255312,70,70,0,0,0
255314,82,82,0,0,0
255322,74,74,0,0,0
255334,120,120,0,0,0
255345,184,184,0,0,0
255357,66,66,0,0,0
255364,133,133,0,0,0
255365,315,315,0,0,0
255379,56,56,0,0,0
255382,306,306,0,0,0
255386,50,50,0,0,0
255393,6,6,0,0,0
255403,65,65,0,0,0
255409,41,41,0,0,0
255416,402,402,0,0,0
255427,1,1,0,0,0
255429,94,94,0,0,0
255457,58,58,0,0,0
255469,65,65,0,0,0
255517,121,121,0,0,0
255536,65,65,0,0,0
255539,353,353,0,0,0
255574,232,232,0,0,0
255585,69,69,0,0,0
255586,72,72,0,0,0
255587,151,151,0,0,0
255589,359,359,0,0,0
255594,11,11,0,0,0
255601,7,7,0,0,0
255649,24,24,0,0,0
255652,102,102,0,0,0
255660,167,167,0,0,0
255667,299,299,0,0,0
255692,114,114,0,0,0
255721,114,114,0,0,0
255725,315,315,0,0,0
255749,97,97,0,0,0
255756,137,137,0,0,0
255771,70,70,0,0,0
255786,102,102,0,0,0
255834,353,353,0,0,0
255848,101,101,0,0,0
255857,180,180,0,0,0
255859,18,18,0,0,0
255862,345,345,0,0,0
255864,152,152,0,0,0
255891,306,306,0,0,0
255909,121,121,0,0,0
255916,198,198,0,0,0
255920,121,121,0,0,0
255922,57,57,0,0,0
255927,121,121,0,0,0
255937,306,306,0,0,0
255938,255,255,0,0,0
255951,345,345,0,0,0
255958,255,255,0,0,0
255963,281,281,0,0,0
255981,255,255,0,0,0
255987,114,114,0,0,0
255990,120,120,0,0,0
256041,152,152,0,0,0
256048,72,72,0,0,0
256062,15,15,0,0,0
256064,22,22,0,0,0
256082,198,198,0,0,0
256090,94,94,0,0,0
256091,22,22,0,0,0
256098,255,255,0,0,0
256126,9,9,0,0,0
256130,121,121,0,0,0
256131,168,168,0,0,0
256134,70,70,0,0,0
256153,282,282,0,0,0
256177,402,402,0,0,0
256192,232,232,0,0,0
256203,97,97,0,0,0
256208,151,151,0,0,0
256212,74,74,0,0,0
256229,306,306,0,0,0
256272,17,17,0,0,0
256292,70,70,0,0,0
256294,306,306,0,0,0
256306,36,36,0,0,0
256309,345,345,0,0,0
256317,151,151,0,0,0
256327,259,259,0,0,0
256342,76,76,0,0,0
256345,56,56,0,0,0
256359,255,255,0,0,0
256360,45,45,0,0,0
256371,71,71,0,0,0
256383,113,113,0,0,0
256384,281,281,0,0,0
256389,402,402,0,0,0
256390,246,246,0,0,0
256399,251,251,0,0,0
256400,359,359,0,0,0
256402,6,6,0,0,0
256410,114,114,0,0,0
256425,198,198,0,0,0
256432,130,130,0,0,0
256458,402,402,0,0,0
256488,131,131,0,0,0
256511,12,12,0,0,0
256527,259,259,0,0,0
256530,87,87,0,0,0
256533,21,21,0,0,0
256537,180,180,0,0,0
256551,251,251,0,0,0
256559,20,20,0,0,0
256571,54,54,0,0,0
256582,167,167,0,0,0
256588,171,171,0,0,0
256589,353,353,0,0,0
256591,180,180,0,0,0
256593,180,180,0,0,0
256596,255,255,0,0,0
256607,152,152,0,0,0
256626,315,315,0,0,0
256628,171,171,0,0,0
256629,65,65,0,0,0
256646,198,198,0,0,0
256658,144,144,0,0,0
256712,255,255,0,0,0
256718,359,359,0,0,0
256726,11,11,0,0,0
256735,232,232,0,0,0
256749,87,87,0,0,0
256752,114,114,0,0,0
256759,152,152,0,0,0
256785,251,251,0,0,0
256786,252,252,0,0,0
256788,94,94,0,0,0
256802,3,3,0,0,0
256813,158,158,0,0,0
256822,27,27,0,0,0
256830,24,24,0,0,0
256847,85,85,0,0,0
256849,70,70,0,0,0
256853,131,131,0,0,0
256854,252,252,0,0,0
256858,113,113,0,0,0
256874,133,133,0,0,0
256881,24,24,0,0,0
256883,5,5,0,0,0
256884,77,77,0,0,0
256906,299,299,0,0,0
256907,246,246,0,0,0
256910,20,20,0,0,0
256920,97,97,0,0,0
256939,193,193,0,0,0
256947,252,252,0,0,0
256958,315,315,0,0,0
256998,152,152,0,0,0
257004,402,402,0,0,0
257008,133,133,0,0,0
257011,8,8,0,0,0
257028,7,7,0,0,0
257040,299,299,0,0,0
257047,313,313,0,0,0
257063,143,143,0,0,0
257067,281,281,0,0,0
257085,158,158,0,0,0
257086,85,85,0,0,0
257104,193,193,0,0,0
257126,56,56,0,0,0
257145,21,21,0,0,0
257147,255,255,0,0,0
257154,131,131,0,0,0
257161,353,353,0,0,0
257173,359,359,0,0,0
257174,22,22,0,0,0
257177,353,353,0,0,0
257204,144,144,0,0,0
257210,310,310,0,0,0
257217,402,402,0,0,0
257225,8,8,0,0,0
257232,45,45,0,0,0
257241,232,232,0,0,0
257255,114,114,0,0,0
257260,76,76,0,0,0
257287,353,353,0,0,0
257293,353,353,0,0,0
257323,56,56,0,0,0
257337,121,121,0,0,0
257342,281,281,0,0,0
257354,102,102,0,0,0
257365,281,281,0,0,0
257367,313,313,0,0,0
257379,128,128,0,0,0
257393,69,69,0,0,0
257411,41,41,0,0,0
257417,7,7,0,0,0
257419,72,72,0,0,0
257423,36,36,0,0,0
257459,1,1,0,0,0
257460,353,353,0,0,0
257463,232,232,0,0,0
257468,103,103,0,0,0
257478,3,3,0,0,0
257482,152,152,0,0,0
257483,113,113,0,0,0
257504,11,11,0,0,0
257511,359,359,0,0,0
257513,20,20,0,0,0
257516,345,345,0,0,0
257538,30,30,0,0,0
257543,353,353,0,0,0
257551,163,163,0,0,0
257586,201,201,0,0,0
257590,5,5,0,0,0
257591,171,171,0,0,0
257592,121,121,0,0,0
257602,353,353,0,0,0
257617,359,359,0,0,0
257620,193,193,0,0,0
257636,313,313,0,0,0
257637,313,313,0,0,0
257639,158,158,0,0,0
257645,34,34,0,0,0
257650,184,184,0,0,0
257651,102,102,0,0,0
257679,252,252,0,0,0
257681,402,402,0,0,0
257713,345,345,0,0,0
257721,40,40,0,0,0
257722,65,65,0,0,0
257726,128,128,0,0,0
257745,259,259,0,0,0
257753,34,34,0,0,0
257760,71,71,0,0,0
257775,259,259,0,0,0
257782,310,310,0,0,0
257786,306,306,0,0,0
257795,299,299,0,0,0
257799,76,76,0,0,0
257804,151,151,0,0,0
257818,3,3,0,0,0
257831,66,66,0,0,0
257868,168,168,0,0,0
257880,184,184,0,0,0
257885,198,198,0,0,0
257899,102,102,0,0,0
257904,114,114,0,0,0
257909,299,299,0,0,0
257923,151,151,0,0,0
257930,131,131,0,0,0
257932,299,299,0,0,0
257942,97,97,0,0,0
257950,310,310,0,0,0
257962,402,402,0,0,0
257964,252,252,0,0,0
257976,8,8,0,0,0
257977,6,6,0,0,0
257989,306,306,0,0,0
258007,23,23,0,0,0
258015,137,137,0,0,0
258027,315,315,0,0,0
258033,281,281,0,0,0
258044,7,7,0,0,0
258050,55,55,0,0,0
258057,121,121,0,0,0
258093,54,54,0,0,0
258102,259,259,0,0,0
258134,193,193,0,0,0
258222,144,144,0,0,0
258241,299,299,0,0,0
258257,63,63,0,0,0
258261,281,281,0,0,0
258273,345,345,0,0,0
258279,281,281,0,0,0
258292,39,39,0,0,0
258296,120,120,0,0,0
258330,20,20,0,0,0
258333,130,130,0,0,0
258384,402,402,0,0,0
258388,168,168,0,0,0
258411,74,74,0,0,0
258413,8,8,0,0,0
258423,310,310,0,0,0
258442,41,41,0,0,0
258466,255,255,0,0,0
258488,193,193,0,0,0
258489,193,193,0,0,0
258497,259,259,0,0,0
258499,313,313,0,0,0
258503,353,353,0,0,0
258504,27,27,0,0,0
258524,306,306,0,0,0
258538,133,133,0,0,0
258558,19,19,0,0,0
258561,12,12,0,0,0
258583,15,15,0,0,0
258599,281,281,0,0,0
258617,35,35,0,0,0
258619,9,9,0,0,0
258624,299,299,0,0,0
258642,94,94,0,0,0
258651,259,259,0,0,0
258655,201,201,0,0,0
258674,143,143,0,0,0
258702,137,137,0,0,0
258703,201,201,0,0,0
258704,3,3,0,0,0
258710,198,198,0,0,0
258719,282,282,0,0,0
258727,137,137,0,0,0
258749,198,198,0,0,0
258759,345,345,0,0,0
258764,171,171,0,0,0
258777,310,310,0,0,0
258792,310,310,0,0,0
258820,20,20,0,0,0
258822,74,74,0,0,0
258849,251,251,0,0,0
258851,2,2,0,0,0
258852,29,29,0,0,0
258861,76,76,0,0,0
258866,282,282,0,0,0
258871,299,299,0,0,0
258873,345,345,0,0,0
258884,103,103,0,0,0
258913,152,152,0,0,0
258914,137,137,0,0,0
258931,144,144,0,0,0
258932,259,259,0,0,0
258938,11,11,0,0,0
258939,35,35,0,0,0
258941,19,19,0,0,0
258953,132,132,0,0,0
258956,255,255,0,0,0
258965,120,120,0,0,0
258970,198,198,0,0,0
259007,77,77,0,0,0
259038,32,32,0,0,0
259042,281,281,0,0,0
259043,251,251,0,0,0
259047,101,101,0,0,0
259050,5,5,0,0,0
259061,137,137,0,0,0
259063,151,151,0,0,0
259074,5,5,0,0,0
259106,74,74,0,0,0
259107,6,6,0,0,0
259158,137,137,0,0,0
259171,198,198,0,0,0
259172,281,281,0,0,0
259173,143,143,0,0,0
259174,43,43,0,0,0
259175,35,35,0,0,0
259182,137,137,0,0,0
259184,25,25,0,0,0
259185,121,121,0,0,0
259190,246,246,0,0,0
259191,143,143,0,0,0
259197,151,151,0,0,0
259208,255,255,0,0,0
259214,402,402,0,0,0
259219,3,3,0,0,0
259231,74,74,0,0,0
259236,310,310,0,0,0
259240,76,76,0,0,0
259254,7,7,0,0,0
259255,251,251,0,0,0
259265,306,306,0,0,0
259286,246,246,0,0,0
259304,315,315,0,0,0
259305,299,299,0,0,0
259310,113,113,0,0,0
259316,10,10,0,0,0
259321,121,121,0,0,0
259323,87,87,0,0,0
259334,55,55,0,0,0
259353,402,402,0,0,0
259365,101,101,0,0,0
259371,168,168,0,0,0
259373,353,353,0,0,0
259401,74,74,0,0,0
259419,232,232,0,0,0
259430,198,198,0,0,0
259435,87,87,0,0,0
259436,232,232,0,0,0
259443,201,201,0,0,0
259455,193,193,0,0,0
259457,281,281,0,0,0
259460,163,163,0,0,0
259468,36,36,0,0,0
259477,345,345,0,0,0
259484,402,402,0,0,0
259526,306,306,0,0,0
259528,18,18,0,0,0
259531,13,13,0,0,0
259536,299,299,0,0,0
259537,35,35,0,0,0
259547,171,171,0,0,0
259560,184,184,0,0,0
259561,299,299,0,0,0
259580,55,55,0,0,0
259584,113,113,0,0,0
259598,259,259,0,0,0
259603,232,232,0,0,0
259614,114,114,0,0,0
259628,251,251,0,0,0
259635,201,201,0,0,0
259646,131,131,0,0,0
259667,40,40,0,0,0
259671,75,75,0,0,0
259674,198,198,0,0,0
259676,310,310,0,0,0
259681,10,10,0,0,0
259705,345,345,0,0,0
259710,69,69,0,0,0
259718,34,34,0,0,0
259721,144,144,0,0,0
259723,144,144,0,0,0
259738,252,252,0,0,0
259772,72,72,0,0,0
259781,50,50,0,0,0
259789,102,102,0,0,0
259799,198,198,0,0,0
259847,67,67,0,0,0
259879,171,171,0,0,0
259882,158,158,0,0,0
259891,77,77,0,0,0
259901,19,19,0,0,0
259902,345,345,0,0,0
259904,39,39,0,0,0
259926,25,25,0,0,0
259937,102,102,0,0,0
259945,255,255,0,0,0
259955,402,402,0,0,0
259959,75,75,0,0,0
259960,345,345,0,0,0
259965,259,259,0,0,0
259966,82,82,0,0,0
259978,281,281,0,0,0
259984,9,9,0,0,0
259991,18,18,0,0,0
259996,69,69,0,0,0
260016,151,151,0,0,0
260025,18,18,0,0,0
260044,251,251,0,0,0
260047,10,10,0,0,0
260055,36,36,0,0,0
260060,131,131,0,0,0
260069,152,152,0,0,0
260153,359,359,0,0,0
260161,74,74,0,0,0
260185,198,198,0,0,0
260188,8,8,0,0,0
260193,39,39,0,0,0
260212,315,315,0,0,0
260216,402,402,0,0,0
260248,1,1,0,0,0
260266,24,24,0,0,0
260283,402,402,0,0,0
260313,259,259,0,0,0
260314,281,281,0,0,0
260316,97,97,0,0,0
260329,259,259,0,0,0
260366,251,251,0,0,0
260389,313,313,0,0,0
260404,85,85,0,0,0
260420,70,70,0,0,0
260421,76,76,0,0,0
260423,259,259,0,0,0
260424,54,54,0,0,0
260445,103,103,0,0,0
260467,43,43,0,0,0
260477,151,151,0,0,0
260482,8,8,0,0,0
260489,70,70,0,0,0
260491,70,70,0,0,0
260533,35,35,0,0,0
260538,353,353,0,0,0
260546,345,345,0,0,0
260547,180,180,0,0,0
260548,97,97,0,0,0
260552,402,402,0,0,0
260554,152,152,0,0,0
260564,14,14,0,0,0
260578,77,77,0,0,0
260580,85,85,0,0,0
260581,313,313,0,0,0
260582,306,306,0,0,0
260598,281,281,0,0,0
260634,58,58,0,0,0
260648,74,74,0,0,0
260655,69,69,0,0,0
260663,359,359,0,0,0
260670,132,132,0,0,0
260683,310,310,0,0,0
260689,25,25,0,0,0
260700,315,315,0,0,0
260705,114,114,0,0,0
260711,50,50,0,0,0
260714,18,18,0,0,0
260723,252,252,0,0,0
260746,232,232,0,0,0
260754,5,5,0,0,0
260759,315,315,0,0,0
260760,255,255,0,0,0
260761,133,133,0,0,0
260766,151,151,0,0,0
260773,71,71,0,0,0
260810,144,144,0,0,0
260820,193,193,0,0,0
260824,184,184,0,0,0
260844,56,56,0,0,0
260865,143,143,0,0,0
260880,44,44,0,0,0
260889,345,345,0,0,0
260893,180,180,0,0,0
260906,36,36,0,0,0
260913,76,76,0,0,0
260919,168,168,0,0,0
260931,168,168,0,0,0
260934,193,193,0,0,0
260939,3,3,0,0,0
260944,282,282,0,0,0
260957,74,74,0,0,0
260968,171,171,0,0,0
260978,193,193,0,0,0
260996,402,402,0,0,0
261003,128,128,0,0,0
261006,6,6,0,0,0
261029,180,180,0,0,0
261053,281,281,0,0,0
261069,72,72,0,0,0
261070,4,4,0,0,0
261076,133,133,0,0,0
261083,72,72,0,0,0
261091,101,101,0,0,0
261106,167,167,0,0,0
261116,75,75,0,0,0
261122,36,36,0,0,0
261126,171,171,0,0,0
261129,184,184,0,0,0
261131,158,158,0,0,0
261133,74,74,0,0,0
261135,282,282,0,0,0
261146,19,19,0,0,0
261162,310,310,0,0,0
261166,167,167,0,0,0
261184,353,353,0,0,0
261205,85,85,0,0,0
261206,299,299,0,0,0
261208,345,345,0,0,0
261215,35,35,0,0,0
261216,14,14,0,0,0
261218,102,102,0,0,0
261221,310,310,0,0,0
261234,7,7,0,0,0
261249,299,299,0,0,0
261256,246,246,0,0,0
261258,82,82,0,0,0
261261,56,56,0,0,0
261268,306,306,0,0,0
261269,193,193,0,0,0
261295,41,41,0,0,0
261307,306,306,0,0,0
261315,313,313,0,0,0
261333,167,167,0,0,0
261335,306,306,0,0,0
261346,70,70,0,0,0
261351,56,56,0,0,0
261352,70,70,0,0,0
261363,158,158,0,0,0
261369,168,168,0,0,0
261377,167,167,0,0,0
261400,180,180,0,0,0
261424,87,87,0,0,0
261434,313,313,0,0,0
261440,9,9,0,0,0
261464,9,9,0,0,0
261468,193,193,0,0,0
261485,120,120,0,0,0
261489,27,27,0,0,0
261504,315,315,0,0,0
261512,315,315,0,0,0
261514,76,76,0,0,0
261536,83,83,0,0,0
261538,359,359,0,0,0
261540,180,180,0,0,0
261559,353,353,0,0,0
261569,158,158,0,0,0
261572,313,313,0,0,0
261587,29,29,0,0,0
261599,232,232,0,0,0
261609,87,87,0,0,0
261616,255,255,0,0,0
261623,306,306,0,0,0
261627,14,14,0,0,0
261639,56,56,0,0,0
261656,16,16,0,0,0
261688,201,201,0,0,0
261708,36,36,0,0,0
261719,19,19,0,0,0
261743,15,15,0,0,0
261748,30,30,0,0,0
261749,137,137,0,0,0
261753,121,121,0,0,0
261761,103,103,0,0,0
261769,65,65,0,0,0
261799,252,252,0,0,0
261829,281,281,0,0,0
261835,102,102,0,0,0
261840,251,251,0,0,0
261842,67,67,0,0,0
261848,313,313,0,0,0
261858,151,151,0,0,0
261887,282,282,0,0,0
261896,143,143,0,0,0
261898,43,43,0,0,0
261908,34,34,0,0,0
261910,180,180,0,0,0
261922,345,345,0,0,0
261924,41,41,0,0,0
261941,152,152,0,0,0
261947,353,353,0,0,0
261951,246,246,0,0,0
261972,70,70,0,0,0
261982,9,9,0,0,0
261989,281,281,0,0,0
261992,20,20,0,0,0
261999,43,43,0,0,0
262001,137,137,0,0,0
262013,251,251,0,0,0
262029,75,75,0,0,0
262035,151,151,0,0,0
262038,121,121,0,0,0
262039,54,54,0,0,0
262047,310,310,0,0,0
262052,310,310,0,0,0
262065,282,282,0,0,0
262067,281,281,0,0,0
262075,7,7,0,0,0
262076,353,353,0,0,0
262098,315,315,0,0,0
262110,353,353,0,0,0
262133,36,36,0,0,0
262141,69,69,0,0,0
262152,131,131,0,0,0
262153,313,313,0,0,0
262156,34,34,0,0,0
262160,144,144,0,0,0
262165,158,158,0,0,0
262167,102,102,0,0,0
262170,66,66,0,0,0
262185,306,306,0,0,0
262198,252,252,0,0,0
262204,144,144,0,0,0
262210,402,402,0,0,0
262248,345,345,0,0,0
262249,246,246,0,0,0
262265,259,259,0,0,0
262266,143,143,0,0,0
262290,128,128,0,0,0
262294,101,101,0,0,0
262321,184,184,0,0,0
262347,402,402,0,0,0
262383,282,282,0,0,0
262389,255,255,0,0,0
262407,180,180,0,0,0
262410,232,232,0,0,0
262413,313,313,0,0,0
262461,50,50,0,0,0
262478,402,402,0,0,0
262482,82,82,0,0,0
262495,313,313,0,0,0
262503,14,14,0,0,0
262517,77,77,0,0,0
262523,131,131,0,0,0
262524,402,402,0,0,0
262527,7,7,0,0,0
262532,97,97,0,0,0
262539,13,13,0,0,0
262548,180,180,0,0,0
262549,137,137,0,0,0
262557,255,255,0,0,0
262580,15,15,0,0,0
262581,259,259,0,0,0
262607,12,12,0,0,0
262610,121,121,0,0,0
262634,313,313,0,0,0
262635,29,29,0,0,0
262649,22,22,0,0,0
262676,315,315,0,0,0
262699,299,299,0,0,0
262709,97,97,0,0,0
262717,55,55,0,0,0
262732,315,315,0,0,0
262743,310,310,0,0,0
262751,143,143,0,0,0
262764,9,9,0,0,0
262767,137,137,0,0,0
262774,72,72,0,0,0
262788,402,402,0,0,0
262792,1,1,0,0,0
262807,103,103,0,0,0
262808,345,345,0,0,0
262822,87,87,0,0,0
262838,128,128,0,0,0
262847,345,345,0,0,0
262857,168,168,0,0,0
262859,193,193,0,0,0
262887,353,353,0,0,0
262889,102,102,0,0,0
262901,76,76,0,0,0
262918,282,282,0,0,0
262922,255,255,0,0,0
262925,252,252,0,0,0
262927,306,306,0,0,0
262937,20,20,0,0,0
262949,131,131,0,0,0
262959,72,72,0,0,0
262972,35,35,0,0,0
262979,315,315,0,0,0
262982,167,167,0,0,0
262993,315,315,0,0,0
263002,35,35,0,0,0
263012,121,121,0,0,0
263022,251,251,0,0,0
263036,50,50,0,0,0
263052,306,306,0,0,0
263068,102,102,0,0,0
263081,168,168,0,0,0
263100,4,4,0,0,0
263107,171,171,0,0,0
263114,299,299,0,0,0
263116,103,103,0,0,0
263121,201,201,0,0,0
263124,54,54,0,0,0
263138,151,151,0,0,0
263156,232,232,0,0,0
263159,313,313,0,0,0
263182,69,69,0,0,0
263186,75,75,0,0,0
263195,12,12,0,0,0
263207,36,36,0,0,0
263209,144,144,0,0,0
263221,359,359,0,0,0
263228,130,130,0,0,0
263233,4,4,0,0,0
263237,299,299,0,0,0
263245,121,121,0,0,0
263249,58,58,0,0,0
263273,402,402,0,0,0
263274,201,201,0,0,0
263292,74,74,0,0,0
263300,167,167,0,0,0
263304,5,5,0,0,0
263393,259,259,0,0,0
263425,299,299,0,0,0
263439,313,313,0,0,0
263455,252,252,0,0,0
263461,74,74,0,0,0
263462,131,131,0,0,0
263466,310,310,0,0,0
263473,193,193,0,0,0
263477,133,133,0,0,0
263490,252,252,0,0,0
263500,128,128,0,0,0
263511,54,54,0,0,0
263514,132,132,0,0,0
263516,74,74,0,0,0
263543,113,113,0,0,0
263555,74,74,0,0,0
263574,1,1,0,0,0
263578,180,180,0,0,0
263585,82,82,0,0,0
263589,128,128,0,0,0
263596,151,151,0,0,0
263602,201,201,0,0,0
263605,120,120,0,0,0
263617,184,184,0,0,0
263634,167,167,0,0,0
263642,252,252,0,0,0
263655,345,345,0,0,0
263667,313,313,0,0,0
263674,27,27,0,0,0
263680,306,306,0,0,0
263682,167,167,0,0,0
263697,251,251,0,0,0
263698,158,158,0,0,0
263735,259,259,0,0,0
263751,345,345,0,0,0
263762,310,310,0,0,0
263768,232,232,0,0,0
263775,306,306,0,0,0
263779,17,17,0,0,0
263793,43,43,0,0,0
263874,18,18,0,0,0
263880,131,131,0,0,0
263892,402,402,0,0,0
263913,120,120,0,0,0
263920,359,359,0,0,0
263924,345,345,0,0,0
263926,56,56,0,0,0
263938,85,85,0,0,0
263939,306,306,0,0,0
263947,251,251,0,0,0
263963,299,299,0,0,0
263967,82,82,0,0,0
263969,4,4,0,0,0
263972,306,306,0,0,0
264001,353,353,0,0,0
264003,143,143,0,0,0
264006,143,143,0,0,0
264045,29,29,0,0,0
264049,94,94,0,0,0
264052,313,313,0,0,0
264053,44,44,0,0,0
264056,359,359,0,0,0
264057,152,152,0,0,0
264093,114,114,0,0,0
264108,345,345,0,0,0
264114,101,101,0,0,0
264116,180,180,0,0,0
264157,345,345,0,0,0
264168,299,299,0,0,0
264184,9,9,0,0,0
264185,2,2,0,0,0
264196,1,1,0,0,0
264201,251,251,0,0,0
264216,198,198,0,0,0
264222,5,5,0,0,0
264234,299,299,0,0,0
264235,128,128,0,0,0
264240,299,299,0,0,0
264244,310,310,0,0,0
264245,137,137,0,0,0
264246,97,97,0,0,0
264274,299,299,0,0,0
264294,114,114,0,0,0
264303,201,201,0,0,0
264313,345,345,0,0,0
264378,232,232,0,0,0
264383,144,144,0,0,0
264384,54,54,0,0,0
264388,313,313,0,0,0
264390,137,137,0,0,0
264391,66,66,0,0,0
264399,144,144,0,0,0
264403,71,71,0,0,0
264412,3,3,0,0,0
264417,315,315,0,0,0
264419,306,306,0,0,0
264437,35,35,0,0,0
264488,18,18,0,0,0
264504,143,143,0,0,0
264515,7,7,0,0,0
264540,50,50,0,0,0
264541,282,282,0,0,0
264550,10,10,0,0,0
264551,252,252,0,0,0
264561,75,75,0,0,0
264565,22,22,0,0,0
264566,163,163,0,0,0
264567,163,163,0,0,0
264569,18,18,0,0,0
264574,101,101,0,0,0
264594,143,143,0,0,0
264616,151,151,0,0,0
264622,167,167,0,0,0
264629,310,310,0,0,0
264636,56,56,0,0,0
264638,29,29,0,0,0
264652,306,306,0,0,0
264664,184,184,0,0,0
264667,13,13,0,0,0
264692,97,97,0,0,0
264707,171,171,0,0,0
264722,24,24,0,0,0
264732,56,56,0,0,0
264744,252,252,0,0,0
264746,121,121,0,0,0
264748,259,259,0,0,0
264749,251,251,0,0,0
264787,313,313,0,0,0
264788,259,259,0,0,0
264794,168,168,0,0,0
264801,168,168,0,0,0
264808,167,167,0,0,0
264816,76,76,0,0,0
264822,137,137,0,0,0
264824,113,113,0,0,0
264828,114,114,0,0,0
264838,9,9,0,0,0
264841,17,17,0,0,0
264859,15,15,0,0,0
264876,167,167,0,0,0
264886,246,246,0,0,0
264896,63,63,0,0,0
264902,36,36,0,0,0
264907,259,259,0,0,0
264912,121,121,0,0,0
264916,82,82,0,0,0
264925,232,232,0,0,0
264927,359,359,0,0,0
264936,259,259,0,0,0
264947,3,3,0,0,0
264948,345,345,0,0,0
264951,120,120,0,0,0
264957,252,252,0,0,0
264965,359,359,0,0,0
264978,102,102,0,0,0
264988,259,259,0,0,0
264992,131,131,0,0,0
265018,168,168,0,0,0
265032,58,58,0,0,0
265042,201,201,0,0,0
265049,251,251,0,0,0
265097,255,255,0,0,0
265119,353,353,0,0,0
265123,201,201,0,0,0
265136,11,11,0,0,0
265147,39,39,0,0,0
265154,128,128,0,0,0
265186,152,152,0,0,0
265204,246,246,0,0,0
265212,20,20,0,0,0
265223,353,353,0,0,0
265226,299,299,0,0,0
265239,103,103,0,0,0
265240,282,282,0,0,0
265241,72,72,0,0,0
265243,11,11,0,0,0
265255,76,76,0,0,0
265258,102,102,0,0,0
265259,43,43,0,0,0
265265,306,306,0,0,0
265292,144,144,0,0,0
265294,54,54,0,0,0
265297,184,184,0,0,0
265301,402,402,0,0,0
265313,232,232,0,0,0
265324,251,251,0,0,0
265332,13,13,0,0,0
265334,144,144,0,0,0
265339,359,359,0,0,0
265362,102,102,0,0,0
265363,94,94,0,0,0
265364,201,201,0,0,0
265387,43,43,0,0,0
265390,18,18,0,0,0
265404,83,83,0,0,0
265424,152,152,0,0,0
265428,299,299,0,0,0
265435,24,24,0,0,0
265438,359,359,0,0,0
265442,27,27,0,0,0
265444,97,97,0,0,0
265447,167,167,0,0,0
265450,120,120,0,0,0
265457,29,29,0,0,0
265461,71,71,0,0,0
265462,143,143,0,0,0
265466,168,168,0,0,0
265492,143,143,0,0,0
265534,114,114,0,0,0
265538,171,171,0,0,0
265540,40,40,0,0,0
265542,4,4,0,0,0
265550,137,137,0,0,0
265558,353,353,0,0,0
265565,313,313,0,0,0
265573,74,74,0,0,0
265579,132,132,0,0,0
265581,168,168,0,0,0
265603,201,201,0,0,0
265612,306,306,0,0,0
265617,313,313,0,0,0
265639,44,44,0,0,0
265653,56,56,0,0,0
265675,353,353,0,0,0
265691,25,25,0,0,0
265698,345,345,0,0,0
265703,310,310,0,0,0
265737,259,259,0,0,0
265741,152,152,0,0,0
265756,133,133,0,0,0
265771,168,168,0,0,0
265778,402,402,0,0,0
265784,137,137,0,0,0
265793,299,299,0,0,0
265803,359,359,0,0,0
265806,65,65,0,0,0
265820,56,56,0,0,0
265824,54,54,0,0,0
265837,315,315,0,0,0
265870,232,232,0,0,0
265879,313,313,0,0,0
265881,16,16,0,0,0
265902,10,10,0,0,0
265915,50,50,0,0,0
265919,44,44,0,0,0
265920,63,63,0,0,0
265926,74,74,0,0,0
265932,359,359,0,0,0
265934,128,128,0,0,0
265951,69,69,0,0,0
265952,315,315,0,0,0
265976,306,306,0,0,0
265982,201,201,0,0,0
265997,167,167,0,0,0
266011,313,313,0,0,0
266040,193,193,0,0,0
266046,27,27,0,0,0
266048,201,201,0,0,0
266051,6,6,0,0,0
266055,5,5,0,0,0
266056,359,359,0,0,0
266064,57,57,0,0,0
266072,359,359,0,0,0
266081,306,306,0,0,0
266105,63,63,0,0,0
266114,281,281,0,0,0
266120,45,45,0,0,0
266121,281,281,0,0,0
266130,281,281,0,0,0
266141,310,310,0,0,0
266142,193,193,0,0,0
266145,171,171,0,0,0
266153,3,3,0,0,0
266158,72,72,0,0,0
266167,120,120,0,0,0
266168,151,151,0,0,0
266175,121,121,0,0,0
266186,310,310,0,0,0
266215,102,102,0,0,0
266231,3,3,0,0,0
266239,132,132,0,0,0
266251,359,359,0,0,0
266252,18,18,0,0,0
266253,246,246,0,0,0
266259,4,4,0,0,0
266264,2,2,0,0,0
266285,11,11,0,0,0
266301,306,306,0,0,0
266313,25,25,0,0,0
266319,359,359,0,0,0
266324,345,345,0,0,0
266330,32,32,0,0,0
266331,232,232,0,0,0
266334,255,255,0,0,0
266339,345,345,0,0,0
266343,359,359,0,0,0
266378,255,255,0,0,0
266402,102,102,0,0,0
266406,76,76,0,0,0
266416,35,35,0,0,0
266421,19,19,0,0,0
266446,359,359,0,0,0
266451,114,114,0,0,0
266476,2,2,0,0,0
266477,9,9,0,0,0
266480,282,282,0,0,0
266488,16,16,0,0,0
266491,103,103,0,0,0
266511,359,359,0,0,0
266518,184,184,0,0,0
266535,74,74,0,0,0
266555,299,299,0,0,0
266567,353,353,0,0,0
266596,5,5,0,0,0
266619,152,152,0,0,0
266631,101,101,0,0,0
266646,121,121,0,0,0
266651,184,184,0,0,0
266674,97,97,0,0,0
266679,76,76,0,0,0
266683,11,11,0,0,0
266685,315,315,0,0,0
266706,56,56,0,0,0
266710,402,402,0,0,0
266719,255,255,0,0,0
266727,402,402,0,0,0
266755,306,306,0,0,0
266767,22,22,0,0,0
266769,66,66,0,0,0
266779,128,128,0,0,0
266780,201,201,0,0,0
266791,345,345,0,0,0
266799,143,143,0,0,0
266801,144,144,0,0,0
266807,131,131,0,0,0
266810,54,54,0,0,0
266831,8,8,0,0,0
266848,22,22,0,0,0
266851,50,50,0,0,0
266859,168,168,0,0,0
266875,168,168,0,0,0
266893,306,306,0,0,0
266923,281,281,0,0,0
266925,121,121,0,0,0
266959,168,168,0,0,0
266962,152,152,0,0,0
266965,114,114,0,0,0
266969,180,180,0,0,0
266982,7,7,0,0,0
267005,151,151,0,0,0
267014,180,180,0,0,0
267015,299,299,0,0,0
267021,34,34,0,0,0
267026,299,299,0,0,0
267047,402,402,0,0,0
267072,54,54,0,0,0
267073,402,402,0,0,0
267080,168,168,0,0,0
267083,252,252,0,0,0
267085,24,24,0,0,0
267101,57,57,0,0,0
267106,27,27,0,0,0
267109,313,313,0,0,0
267118,232,232,0,0,0
267132,14,14,0,0,0
267139,75,75,0,0,0
267159,137,137,0,0,0
267161,27,27,0,0,0
267173,17,17,0,0,0
267180,251,251,0,0,0
267183,313,313,0,0,0
267188,15,15,0,0,0
267222,15,15,0,0,0
267244,101,101,0,0,0
267247,353,353,0,0,0
267254,103,103,0,0,0
267259,353,353,0,0,0
267290,69,69,0,0,0
267306,152,152,0,0,0
267311,152,152,0,0,0
267319,74,74,0,0,0
267325,144,144,0,0,0
267335,171,171,0,0,0
267346,255,255,0,0,0
267349,359,359,0,0,0
267353,353,353,0,0,0
267363,315,315,0,0,0
267364,299,299,0,0,0
267365,252,252,0,0,0
267372,184,184,0,0,0
267398,252,252,0,0,0
267401,131,131,0,0,0
267402,167,167,0,0,0
267404,359,359,0,0,0
267416,137,137,0,0,0
267429,143,143,0,0,0
267430,131,131,0,0,0
267452,102,102,0,0,0
267461,36,36,0,0,0
267462,132,132,0,0,0
267476,180,180,0,0,0
267509,131,131,0,0,0
267519,232,232,0,0,0
267529,87,87,0,0,0
267530,2,2,0,0,0
267539,12,12,0,0,0
267545,151,151,0,0,0
267547,180,180,0,0,0
267551,7,7,0,0,0
267569,76,76,0,0,0
267578,21,21,0,0,0
267581,1,1,0,0,0
267587,102,102,0,0,0
267593,10,10,0,0,0
267594,130,130,0,0,0
267607,345,345,0,0,0
267610,252,252,0,0,0
267612,2,2,0,0,0
267620,353,353,0,0,0
267625,310,310,0,0,0
267630,58,58,0,0,0
267631,167,167,0,0,0
267645,131,131,0,0,0
267649,402,402,0,0,0
267655,353,353,0,0,0
267660,201,201,0,0,0
267665,259,259,0,0,0
267671,102,102,0,0,0
267683,19,19,0,0,0
267690,67,67,0,0,0
267697,306,306,0,0,0
267706,20,20,0,0,0
267709,137,137,0,0,0
267715,17,17,0,0,0
267723,353,353,0,0,0
267730,359,359,0,0,0
267732,74,74,0,0,0
267738,313,313,0,0,0
267740,23,23,0,0,0
267765,67,67,0,0,0
267771,402,402,0,0,0
267776,58,58,0,0,0
267778,345,345,0,0,0
267792,65,65,0,0,0
267809,20,20,0,0,0
267811,74,74,0,0,0
267836,144,144,0,0,0
267839,102,102,0,0,0
267851,144,144,0,0,0
267860,44,44,0,0,0
267873,246,246,0,0,0
267889,56,56,0,0,0
267900,7,7,0,0,0
267917,144,144,0,0,0
267918,5,5,0,0,0
267929,21,21,0,0,0
267946,17,17,0,0,0
267955,8,8,0,0,0
267957,310,310,0,0,0
267966,251,251,0,0,0
267977,10,10,0,0,0
267981,29,29,0,0,0
267995,44,44,0,0,0
268003,345,345,0,0,0
268029,282,282,0,0,0
268031,315,315,0,0,0
268033,281,281,0,0,0
268058,299,299,0,0,0
268097,152,152,0,0,0
268106,315,315,0,0,0
268119,306,306,0,0,0
268121,353,353,0,0,0
268126,121,121,0,0,0
268130,198,198,0,0,0
268132,54,54,0,0,0
268134,345,345,0,0,0
268158,9,9,0,0,0
268166,306,306,0,0,0
268173,152,152,0,0,0
268175,259,259,0,0,0
268176,102,102,0,0,0
268179,39,39,0,0,0
268189,76,76,0,0,0
268190,6,6,0,0,0
268195,7,7,0,0,0
268225,252,252,0,0,0
268229,75,75,0,0,0
268230,168,168,0,0,0
268257,70,70,0,0,0
268274,3,3,0,0,0
268280,251,251,0,0,0
268289,163,163,0,0,0
268299,137,137,0,0,0
268301,97,97,0,0,0
268312,7,7,0,0,0
268313,12,12,0,0,0
268316,144,144,0,0,0
268328,152,152,0,0,0
268342,69,69,0,0,0
268374,359,359,0,0,0
268385,171,171,0,0,0
268396,281,281,0,0,0
268405,299,299,0,0,0
268426,29,29,0,0,0
268427,114,114,0,0,0
268432,5,5,0,0,0
268447,22,22,0,0,0
268451,103,103,0,0,0
268466,82,82,0,0,0
268535,180,180,0,0,0
268553,102,102,0,0,0
268558,180,180,0,0,0
268581,74,74,0,0,0
268587,158,158,0,0,0
268591,359,359,0,0,0
268610,232,232,0,0,0
268612,82,82,0,0,0
268617,102,102,0,0,0
268619,97,97,0,0,0
268628,74,74,0,0,0
268636,130,130,0,0,0
268644,16,16,0,0,0
268649,310,310,0,0,0
268673,252,252,0,0,0
268675,102,102,0,0,0
268684,299,299,0,0,0
268688,83,83,0,0,0
268730,76,76,0,0,0
268782,131,131,0,0,0
268799,3,3,0,0,0
268814,168,168,0,0,0
268820,121,121,0,0,0
268831,15,15,0,0,0
268854,158,158,0,0,0
268875,36,36,0,0,0
268900,315,315,0,0,0
268902,251,251,0,0,0
268909,359,359,0,0,0
268933,29,29,0,0,0
268940,113,113,0,0,0
268952,402,402,0,0,0
268960,87,87,0,0,0
268962,252,252,0,0,0
268963,313,313,0,0,0
268973,353,353,0,0,0
268988,36,36,0,0,0
268994,35,35,0,0,0
269016,152,152,0,0,0
269022,55,55,0,0,0
269037,131,131,0,0,0
269058,359,359,0,0,0
269059,20,20,0,0,0
269088,65,65,0,0,0
269117,18,18,0,0,0
269128,282,282,0,0,0
269135,252,252,0,0,0
269136,137,137,0,0,0
269141,70,70,0,0,0
269148,345,345,0,0,0
269151,180,180,0,0,0
269161,310,310,0,0,0
269163,56,56,0,0,0
269170,359,359,0,0,0
269194,102,102,0,0,0
269196,167,167,0,0,0
269207,77,77,0,0,0
269221,102,102,0,0,0
269227,359,359,0,0,0
269230,402,402,0,0,0
269241,313,313,0,0,0
269242,63,63,0,0,0
269272,232,232,0,0,0
269276,5,5,0,0,0
269281,201,201,0,0,0
269287,315,315,0,0,0
269291,198,198,0,0,0
269306,310,310,0,0,0
269310,315,315,0,0,0
269315,8,8,0,0,0
269317,345,345,0,0,0
269322,171,171,0,0,0
269324,251,251,0,0,0
269339,128,128,0,0,0
269358,70,70,0,0,0
269362,299,299,0,0,0
269385,201,201,0,0,0
269387,6,6,0,0,0
269396,299,299,0,0,0
269413,75,75,0,0,0
269431,168,168,0,0,0
269443,1,1,0,0,0
269499,121,121,0,0,0
269505,180,180,0,0,0
269508,94,94,0,0,0
269513,359,359,0,0,0
269517,151,151,0,0,0
269519,8,8,0,0,0
269524,359,359,0,0,0
269528,128,128,0,0,0
269530,152,152,0,0,0
269546,85,85,0,0,0
269548,7,7,0,0,0
269564,184,184,0,0,0
269572,2,2,0,0,0
269588,83,83,0,0,0
269589,20,20,0,0,0
269612,310,310,0,0,0
269617,152,152,0,0,0
269623,7,7,0,0,0
269628,353,353,0,0,0
269638,359,359,0,0,0
269640,255,255,0,0,0
269641,359,359,0,0,0
269644,137,137,0,0,0
269666,130,130,0,0,0
269669,251,251,0,0,0
269701,74,74,0,0,0
269717,282,282,0,0,0
269718,36,36,0,0,0
269739,63,63,0,0,0
269741,151,151,0,0,0
269755,121,121,0,0,0
269762,121,121,0,0,0
269769,3,3,0,0,0
269770,180,180,0,0,0
269787,315,315,0,0,0
269794,83,83,0,0,0
269810,306,306,0,0,0
269822,30,30,0,0,0
269844,54,54,0,0,0
269848,180,180,0,0,0
269852,5,5,0,0,0
269864,232,232,0,0,0
269882,251,251,0,0,0
269893,246,246,0,0,0
269898,75,75,0,0,0
269906,180,180,0,0,0
269915,158,158,0,0,0
269934,259,259,0,0,0
269939,102,102,0,0,0
269946,120,120,0,0,0
269969,70,70,0,0,0
269971,315,315,0,0,0
269978,163,163,0,0,0
269982,15,15,0,0,0
270007,128,128,0,0,0
270019,171,171,0,0,0
270027,36,36,0,0,0
270039,103,103,0,0,0
270060,137,137,0,0,0
270062,255,255,0,0,0
270074,43,43,0,0,0
270080,345,345,0,0,0
270098,259,259,0,0,0
270100,131,131,0,0,0
270102,11,11,0,0,0
270152,315,315,0,0,0
270166,114,114,0,0,0
270184,201,201,0,0,0
270193,87,87,0,0,0
270197,15,15,0,0,0
270209,299,299,0,0,0
270211,70,70,0,0,0
270229,402,402,0,0,0
270233,281,281,0,0,0
270259,168,168,0,0,0
270266,180,180,0,0,0
270271,82,82,0,0,0
270284,152,152,0,0,0
270297,299,299,0,0,0
270301,299,299,0,0,0
270305,36,36,0,0,0
270313,313,313,0,0,0
270321,102,102,0,0,0
270322,232,232,0,0,0
270339,193,193,0,0,0
270348,232,232,0,0,0
270352,152,152,0,0,0
270366,402,402,0,0,0
270381,77,77,0,0,0
270423,201,201,0,0,0
270437,76,76,0,0,0
270441,71,71,0,0,0
270449,251,251,0,0,0
270452,70,70,0,0,0
270458,359,359,0,0,0
270467,121,121,0,0,0
270473,402,402,0,0,0
270474,259,259,0,0,0
270476,299,299,0,0,0
270498,201,201,0,0,0
270509,259,259,0,0,0
270522,101,101,0,0,0
270546,163,163,0,0,0
270575,143,143,0,0,0
270579,402,402,0,0,0
270580,251,251,0,0,0
270594,315,315,0,0,0
270603,171,171,0,0,0
270614,102,102,0,0,0
270616,144,144,0,0,0
270628,359,359,0,0,0
270632,232,232,0,0,0
270641,121,121,0,0,0
270651,158,158,0,0,0
270652,57,57,0,0,0
270655,128,128,0,0,0
270659,345,345,0,0,0
270683,201,201,0,0,0
270692,168,168,0,0,0
270749,85,85,0,0,0
270761,345,345,0,0,0
270763,163,163,0,0,0
270775,128,128,0,0,0
270783,20,20,0,0,0
270816,193,193,0,0,0
270822,310,310,0,0,0
270832,402,402,0,0,0
270846,77,77,0,0,0
270849,193,193,0,0,0
270876,402,402,0,0,0
270880,259,259,0,0,0
270890,76,76,0,0,0
270893,310,310,0,0,0
270904,102,102,0,0,0
270915,313,313,0,0,0
270917,29,29,0,0,0
270918,402,402,0,0,0
270924,94,94,0,0,0
270980,12,12,0,0,0
270982,102,102,0,0,0
270991,251,251,0,0,0
270995,306,306,0,0,0
271018,18,18,0,0,0
271036,152,152,0,0,0
271048,1,1,0,0,0
271054,353,353,0,0,0
271071,345,345,0,0,0
271079,281,281,0,0,0
271087,70,70,0,0,0
271093,137,137,0,0,0
271095,299,299,0,0,0
271096,402,402,0,0,0
271098,77,77,0,0,0
271101,83,83,0,0,0
271115,281,281,0,0,0
271117,246,246,0,0,0
271134,246,246,0,0,0
271135,25,25,0,0,0
271190,27,27,0,0,0
271202,246,246,0,0,0
271203,310,310,0,0,0
271204,76,76,0,0,0
271215,20,20,0,0,0
271219,313,313,0,0,0
271236,163,163,0,0,0
271243,144,144,0,0,0
271244,402,402,0,0,0
271251,54,54,0,0,0
271256,113,113,0,0,0
271277,74,74,0,0,0
271287,282,282,0,0,0
271291,315,315,0,0,0
271300,232,232,0,0,0
271302,198,198,0,0,0
271314,310,310,0,0,0
271315,101,101,0,0,0
271322,102,102,0,0,0
271329,168,168,0,0,0
271331,114,114,0,0,0
271341,282,282,0,0,0
271376,310,310,0,0,0
271379,252,252,0,0,0
271402,198,198,0,0,0
271413,131,131,0,0,0
271420,67,67,0,0,0
271429,87,87,0,0,0
271465,50,50,0,0,0
271472,353,353,0,0,0
271478,310,310,0,0,0
271484,281,281,0,0,0
271496,121,121,0,0,0
271512,132,132,0,0,0
271515,121,121,0,0,0
271535,252,252,0,0,0
271540,12,12,0,0,0
271543,252,252,0,0,0
271555,252,252,0,0,0
271563,299,299,0,0,0
271575,7,7,0,0,0
271581,18,18,0,0,0
271588,168,168,0,0,0
271594,50,50,0,0,0
271623,152,152,0,0,0
271639,121,121,0,0,0
271642,359,359,0,0,0
271645,102,102,0,0,0
271650,143,143,0,0,0
271655,3,3,0,0,0
271666,345,345,0,0,0
271668,167,167,0,0,0
271674,282,282,0,0,0
271684,113,113,0,0,0
271696,345,345,0,0,0
271702,97,97,0,0,0
271726,259,259,0,0,0
271730,184,184,0,0,0
271746,102,102,0,0,0
271748,193,193,0,0,0
271753,359,359,0,0,0
271756,310,310,0,0,0
271760,359,359,0,0,0
271765,76,76,0,0,0
271790,282,282,0,0,0
271792,315,315,0,0,0
271797,246,246,0,0,0
271798,85,85,0,0,0
271810,259,259,0,0,0
271812,251,251,0,0,0
271827,232,232,0,0,0
271828,137,137,0,0,0
271834,152,152,0,0,0
271851,193,193,0,0,0
271865,50,50,0,0,0
271897,193,193,0,0,0
271902,259,259,0,0,0
271908,315,315,0,0,0
271910,76,76,0,0,0
271911,158,158,0,0,0
271937,76,76,0,0,0
271943,252,252,0,0,0
271957,315,315,0,0,0
271974,315,315,0,0,0
271980,3,3,0,0,0
271988,102,102,0,0,0
271990,255,255,0,0,0
272012,353,353,0,0,0
272025,137,137,0,0,0
272035,198,198,0,0,0
272039,5,5,0,0,0
272042,76,76,0,0,0
272050,281,281,0,0,0
272061,74,74,0,0,0
272069,41,41,0,0,0
272084,63,63,0,0,0
272089,313,313,0,0,0
272095,102,102,0,0,0
272121,114,114,0,0,0
272124,143,143,0,0,0
272154,313,313,0,0,0
272156,315,315,0,0,0
272168,259,259,0,0,0
272204,168,168,0,0,0
272208,184,184,0,0,0
272209,353,353,0,0,0
272221,97,97,0,0,0
272248,41,41,0,0,0
272254,315,315,0,0,0
272290,402,402,0,0,0
272301,151,151,0,0,0
272315,143,143,0,0,0
272320,131,131,0,0,0
272334,56,56,0,0,0
272360,171,171,0,0,0
272439,306,306,0,0,0
272473,313,313,0,0,0
272474,313,313,0,0,0
272487,299,299,0,0,0
272490,232,232,0,0,0
272520,299,299,0,0,0
272523,69,69,0,0,0
272537,152,152,0,0,0
272557,54,54,0,0,0
272559,201,201,0,0,0
272654,299,299,0,0,0
272656,3,3,0,0,0
272670,402,402,0,0,0
272671,83,83,0,0,0
272673,255,255,0,0,0
272678,23,23,0,0,0
272681,151,151,0,0,0
272691,345,345,0,0,0
272701,310,310,0,0,0
272705,3,3,0,0,0
272717,158,158,0,0,0
272739,30,30,0,0,0
272749,184,184,0,0,0
272761,34,34,0,0,0
272769,299,299,0,0,0
272814,299,299,0,0,0
272856,102,102,0,0,0
272860,345,345,0,0,0
272866,353,353,0,0,0
272870,313,313,0,0,0
272885,313,313,0,0,0
272887,198,198,0,0,0
272893,1,1,0,0,0
272902,345,345,0,0,0
272914,3,3,0,0,0
272920,10,10,0,0,0
272923,313,313,0,0,0
272937,252,252,0,0,0
272941,345,345,0,0,0
272946,128,128,0,0,0
272960,168,168,0,0,0
272967,315,315,0,0,0
272976,184,184,0,0,0
272982,171,171,0,0,0
272996,130,130,0,0,0
273002,251,251,0,0,0
273009,281,281,0,0,0
273011,18,18,0,0,0
273025,97,97,0,0,0
273043,353,353,0,0,0
273049,198,198,0,0,0
273067,310,310,0,0,0
273069,255,255,0,0,0
273070,114,114,0,0,0
273079,50,50,0,0,0
273090,259,259,0,0,0
273093,25,25,0,0,0
273098,130,130,0,0,0
273101,39,39,0,0,0
273104,402,402,0,0,0
273117,128,128,0,0,0
273120,152,152,0,0,0
273130,345,345,0,0,0
273137,402,402,0,0,0
273143,12,12,0,0,0
273144,255,255,0,0,0
273147,12,12,0,0,0
273153,171,171,0,0,0
273158,306,306,0,0,0
273162,137,137,0,0,0
273166,13,13,0,0,0
273177,353,353,0,0,0
273188,313,313,0,0,0
273190,255,255,0,0,0
273216,152,152,0,0,0
273224,137,137,0,0,0
273235,315,315,0,0,0
273250,66,66,0,0,0
273261,103,103,0,0,0
273268,69,69,0,0,0
273272,103,103,0,0,0
273273,251,251,0,0,0
273274,128,128,0,0,0
273280,232,232,0,0,0
273293,94,94,0,0,0
273294,353,353,0,0,0
273295,201,201,0,0,0
273303,345,345,0,0,0
273311,167,167,0,0,0
273324,8,8,0,0,0
273351,402,402,0,0,0
273352,128,128,0,0,0
273356,313,313,0,0,0
273357,246,246,0,0,0
273360,6,6,0,0,0
273371,71,71,0,0,0
273373,232,232,0,0,0
273383,259,259,0,0,0
273385,121,121,0,0,0
273412,313,313,0,0,0
273417,315,315,0,0,0
273441,299,299,0,0,0
273459,315,315,0,0,0
273465,137,137,0,0,0
273471,310,310,0,0,0
273474,171,171,0,0,0
273476,345,345,0,0,0
273481,255,255,0,0,0
273482,120,120,0,0,0
273491,11,11,0,0,0
273500,246,246,0,0,0
273510,168,168,0,0,0
273519,313,313,0,0,0
273530,171,171,0,0,0
273536,5,5,0,0,0
273553,353,353,0,0,0
273567,27,27,0,0,0
273573,143,143,0,0,0
273579,281,281,0,0,0
273581,113,113,0,0,0
273597,144,144,0,0,0
273598,21,21,0,0,0
273600,74,74,0,0,0
273613,313,313,0,0,0
273631,281,281,0,0,0
273638,259,259,0,0,0
273639,16,16,0,0,0
273642,201,201,0,0,0
273657,306,306,0,0,0
273690,198,198,0,0,0
273700,144,144,0,0,0
273730,246,246,0,0,0
273733,306,306,0,0,0
273754,255,255,0,0,0
273757,76,76,0,0,0
273760,4,4,0,0,0
273765,299,299,0,0,0
273781,168,168,0,0,0
273785,87,87,0,0,0
273788,22,22,0,0,0
273792,144,144,0,0,0
273801,17,17,0,0,0
273804,255,255,0,0,0
273832,232,232,0,0,0
273837,310,310,0,0,0
273841,282,282,0,0,0
273859,163,163,0,0,0
273862,282,282,0,0,0
273877,171,171,0,0,0
273878,121,121,0,0,0
273887,306,306,0,0,0
273893,252,252,0,0,0
273915,30,30,0,0,0
273923,306,306,0,0,0
273924,12,12,0,0,0
273939,103,103,0,0,0
273948,252,252,0,0,0
273968,353,353,0,0,0
273988,1,1,0,0,0
273991,144,144,0,0,0
274012,259,259,0,0,0
274017,74,74,0,0,0
274033,70,70,0,0,0
274050,306,306,0,0,0
274052,18,18,0,0,0
274053,299,299,0,0,0
274059,20,20,0,0,0
274075,7,7,0,0,0
274141,57,57,0,0,0
274169,36,36,0,0,0
274180,114,114,0,0,0
274187,359,359,0,0,0
274192,246,246,0,0,0
274231,402,402,0,0,0
274235,72,72,0,0,0
274247,201,201,0,0,0
274252,246,246,0,0,0
274258,193,193,0,0,0
274260,246,246,0,0,0
274270,359,359,0,0,0
274274,4,4,0,0,0
274279,255,255,0,0,0
274286,103,103,0,0,0
274290,168,168,0,0,0
274305,163,163,0,0,0
274306,201,201,0,0,0
274311,69,69,0,0,0
274314,310,310,0,0,0
274315,27,27,0,0,0
274318,171,171,0,0,0
274320,76,76,0,0,0
274328,246,246,0,0,0
274338,76,76,0,0,0
274339,5,5,0,0,0
274346,54,54,0,0,0
274349,20,20,0,0,0
274362,1,1,0,0,0
274363,20,20,0,0,0
274366,402,402,0,0,0
274385,359,359,0,0,0
274387,20,20,0,0,0
274430,171,171,0,0,0
274451,121,121,0,0,0
274459,97,97,0,0,0
274460,193,193,0,0,0
274464,20,20,0,0,0
274465,402,402,0,0,0
274474,113,113,0,0,0
274499,299,299,0,0,0
274509,315,315,0,0,0
274510,21,21,0,0,0
274512,315,315,0,0,0
274529,345,345,0,0,0
274543,15,15,0,0,0
274557,255,255,0,0,0
274561,255,255,0,0,0
274562,252,252,0,0,0
274565,128,128,0,0,0
274567,281,281,0,0,0
274575,353,353,0,0,0
274608,21,21,0,0,0
274612,151,151,0,0,0
274614,281,281,0,0,0
274625,12,12,0,0,0
274636,402,402,0,0,0
274647,251,251,0,0,0
274649,299,299,0,0,0
274653,255,255,0,0,0
274665,402,402,0,0,0
274671,137,137,0,0,0
274677,255,255,0,0,0
274696,121,121,0,0,0
274699,12,12,0,0,0
274710,281,281,0,0,0
274749,3,3,0,0,0
274762,131,131,0,0,0
274769,39,39,0,0,0
274818,180,180,0,0,0
274832,121,121,0,0,0
274833,12,12,0,0,0
274837,131,131,0,0,0
274840,10,10,0,0,0
274861,310,310,0,0,0
274866,313,313,0,0,0
274877,7,7,0,0,0
274879,282,282,0,0,0
274888,9,9,0,0,0
274896,281,281,0,0,0
274902,282,282,0,0,0
274904,152,152,0,0,0
274911,3,3,0,0,0
274914,251,251,0,0,0
274924,120,120,0,0,0
274926,137,137,0,0,0
274930,23,23,0,0,0
274947,83,83,0,0,0
274998,5,5,0,0,0
275026,310,310,0,0,0
275076,299,299,0,0,0
275079,255,255,0,0,0
275080,353,353,0,0,0
275109,143,143,0,0,0
275121,313,313,0,0,0
275146,14,14,0,0,0
275149,151,151,0,0,0
275158,137,137,0,0,0
275168,201,201,0,0,0
275175,306,306,0,0,0
275177,34,34,0,0,0
275195,310,310,0,0,0
275204,345,345,0,0,0
275210,171,171,0,0,0
275227,282,282,0,0,0
275232,251,251,0,0,0
275235,167,167,0,0,0
275238,76,76,0,0,0
275239,152,152,0,0,0
275243,353,353,0,0,0
275261,120,120,0,0,0
275269,39,39,0,0,0
275275,21,21,0,0,0
275298,282,282,0,0,0
275299,251,251,0,0,0
275305,137,137,0,0,0
275322,56,56,0,0,0
275324,137,137,0,0,0
275329,246,246,0,0,0
275332,232,232,0,0,0
275352,313,313,0,0,0
275365,132,132,0,0,0
275368,63,63,0,0,0
275381,402,402,0,0,0
275386,102,102,0,0,0
275402,43,43,0,0,0
275417,251,251,0,0,0
275421,94,94,0,0,0
275453,246,246,0,0,0
275454,36,36,0,0,0
275459,87,87,0,0,0
275465,34,34,0,0,0
275473,402,402,0,0,0
275486,306,306,0,0,0
275491,120,120,0,0,0
275497,103,103,0,0,0
275507,315,315,0,0,0
275518,198,198,0,0,0
275523,359,359,0,0,0
275539,232,232,0,0,0
275540,23,23,0,0,0
275550,163,163,0,0,0
275565,259,259,0,0,0
275576,359,359,0,0,0
275581,16,16,0,0,0
275595,70,70,0,0,0
275598,82,82,0,0,0
275622,101,101,0,0,0
275628,315,315,0,0,0
275631,198,198,0,0,0
275657,152,152,0,0,0
275681,16,16,0,0,0
275691,310,310,0,0,0
275699,306,306,0,0,0
275701,102,102,0,0,0
275705,137,137,0,0,0
275707,102,102,0,0,0
275714,25,25,0,0,0
275717,255,255,0,0,0
275718,85,85,0,0,0
275726,310,310,0,0,0
275741,113,113,0,0,0
275757,246,246,0,0,0
275764,55,55,0,0,0
275779,255,255,0,0,0
275790,246,246,0,0,0
275803,137,137,0,0,0
275808,359,359,0,0,0
275810,198,198,0,0,0
275811,74,74,0,0,0
275818,70,70,0,0,0
275822,130,130,0,0,0
275828,402,402,0,0,0
275840,21,21,0,0,0
275849,359,359,0,0,0
275866,131,131,0,0,0
275869,102,102,0,0,0
275898,193,193,0,0,0
275901,255,255,0,0,0
275927,402,402,0,0,0
275931,180,180,0,0,0
275939,23,23,0,0,0
275961,35,35,0,0,0
275974,180,180,0,0,0
275986,345,345,0,0,0
275991,144,144,0,0,0
275994,306,306,0,0,0
276006,50,50,0,0,0
276016,306,306,0,0,0
276024,82,82,0,0,0
276033,259,259,0,0,0
276038,163,163,0,0,0
276039,130,130,0,0,0
276059,128,128,0,0,0
276061,69,69,0,0,0
276081,282,282,0,0,0
276094,259,259,0,0,0
276107,246,246,0,0,0
276112,299,299,0,0,0
276125,45,45,0,0,0
276127,101,101,0,0,0
276128,345,345,0,0,0
276138,29,29,0,0,0
276146,132,132,0,0,0
276164,29,29,0,0,0
276169,1,1,0,0,0
276182,143,143,0,0,0
276192,54,54,0,0,0
276193,34,34,0,0,0
276194,251,251,0,0,0
276215,281,281,0,0,0
276217,87,87,0,0,0
276225,345,345,0,0,0
276240,281,281,0,0,0
276245,184,184,0,0,0
276246,133,133,0,0,0
276249,94,94,0,0,0
276262,97,97,0,0,0
276277,345,345,0,0,0
276278,17,17,0,0,0
276297,102,102,0,0,0
276316,77,77,0,0,0
276326,13,13,0,0,0
276329,299,299,0,0,0
276330,102,102,0,0,0
276348,39,39,0,0,0
276351,94,94,0,0,0
276361,74,74,0,0,0
276376,255,255,0,0,0
276378,114,114,0,0,0
276384,34,34,0,0,0
276392,74,74,0,0,0
276428,36,36,0,0,0
276444,252,252,0,0,0
276447,252,252,0,0,0
276450,17,17,0,0,0
276451,7,7,0,0,0
276480,163,163,0,0,0
276497,353,353,0,0,0
276499,72,72,0,0,0
276528,35,35,0,0,0
276534,282,282,0,0,0
276540,353,353,0,0,0
276550,83,83,0,0,0
276571,15,15,0,0,0
276592,28,28,0,0,0
276612,353,353,0,0,0
276617,76,76,0,0,0
276640,251,251,0,0,0
276642,15,15,0,0,0
276643,152,152,0,0,0
276657,39,39,0,0,0
276669,34,34,0,0,0
276678,402,402,0,0,0
276682,15,15,0,0,0
276688,306,306,0,0,0
276701,282,282,0,0,0
276704,310,310,0,0,0
276706,259,259,0,0,0
276712,168,168,0,0,0
276714,198,198,0,0,0
276727,198,198,0,0,0
276729,11,11,0,0,0
276730,36,36,0,0,0
276744,101,101,0,0,0
276747,76,76,0,0,0
276756,310,310,0,0,0
276765,251,251,0,0,0
276804,232,232,0,0,0
276813,120,120,0,0,0
276816,402,402,0,0,0
276824,251,251,0,0,0
276838,201,201,0,0,0
276840,281,281,0,0,0
276845,1,1,0,0,0
276887,12,12,0,0,0
276917,201,201,0,0,0
276926,18,18,0,0,0
276931,359,359,0,0,0
276957,232,232,0,0,0
276960,232,232,0,0,0
276969,11,11,0,0,0
276974,56,56,0,0,0
276976,151,151,0,0,0
276984,313,313,0,0,0
276987,255,255,0,0,0
276991,83,83,0,0,0
277010,310,310,0,0,0
277013,306,306,0,0,0
277019,43,43,0,0,0
277041,281,281,0,0,0
277060,76,76,0,0,0
277070,193,193,0,0,0
277078,75,75,0,0,0
277093,29,29,0,0,0
277113,180,180,0,0,0
277116,402,402,0,0,0
277120,74,74,0,0,0
277137,310,310,0,0,0
277150,114,114,0,0,0
277156,345,345,0,0,0
277167,36,36,0,0,0
277171,57,57,0,0,0
277173,151,151,0,0,0
277174,281,281,0,0,0
277182,65,65,0,0,0
277195,25,25,0,0,0
277207,232,232,0,0,0
277211,87,87,0,0,0
277219,39,39,0,0,0
277240,66,66,0,0,0
277254,3,3,0,0,0
277257,137,137,0,0,0
277262,102,102,0,0,0
277275,180,180,0,0,0
277277,232,232,0,0,0
277279,163,163,0,0,0
277299,359,359,0,0,0
277327,151,151,0,0,0
277332,306,306,0,0,0
277342,281,281,0,0,0
277351,120,120,0,0,0
277363,252,252,0,0,0
277388,137,137,0,0,0
277415,94,94,0,0,0
277422,306,306,0,0,0
277426,121,121,0,0,0
277427,13,13,0,0,0
277435,102,102,0,0,0
277450,14,14,0,0,0
277451,252,252,0,0,0
277459,252,252,0,0,0
277466,103,103,0,0,0
277479,121,121,0,0,0
277482,180,180,0,0,0
277486,259,259,0,0,0
277503,198,198,0,0,0
277516,11,11,0,0,0
277536,66,66,0,0,0
277541,402,402,0,0,0
277545,255,255,0,0,0
277551,255,255,0,0,0
277587,101,101,0,0,0
277588,70,70,0,0,0
277591,6,6,0,0,0
277600,232,232,0,0,0
277602,25,25,0,0,0
277626,163,163,0,0,0
277651,282,282,0,0,0
277657,151,151,0,0,0
277660,198,198,0,0,0
277666,25,25,0,0,0
277667,137,137,0,0,0
277671,251,251,0,0,0
277676,137,137,0,0,0
277677,281,281,0,0,0
277689,36,36,0,0,0
277691,3,3,0,0,0
277710,180,180,0,0,0
277711,315,315,0,0,0
277739,8,8,0,0,0
277744,251,251,0,0,0
277748,13,13,0,0,0
277760,70,70,0,0,0
277793,87,87,0,0,0
277809,255,255,0,0,0
277825,82,82,0,0,0
277845,128,128,0,0,0
277849,29,29,0,0,0
277851,315,315,0,0,0
277886,315,315,0,0,0
277892,180,180,0,0,0
277904,16,16,0,0,0
277957,97,97,0,0,0
277961,45,45,0,0,0
277964,345,345,0,0,0
277965,8,8,0,0,0
277979,70,70,0,0,0
277985,131,131,0,0,0
277988,201,201,0,0,0
278010,39,39,0,0,0
278022,22,22,0,0,0
278046,193,193,0,0,0
278048,113,113,0,0,0
278062,310,310,0,0,0
278075,87,87,0,0,0
278101,76,76,0,0,0
278105,65,65,0,0,0
278115,259,259,0,0,0
278118,315,315,0,0,0
278121,299,299,0,0,0
278124,306,306,0,0,0
278127,56,56,0,0,0
278158,299,299,0,0,0
278174,70,70,0,0,0
278179,201,201,0,0,0
278186,251,251,0,0,0
278205,114,114,0,0,0
278212,251,251,0,0,0
278229,120,120,0,0,0
278232,151,151,0,0,0
278243,57,57,0,0,0
278259,246,246,0,0,0
278265,44,44,0,0,0
278280,39,39,0,0,0
278281,143,143,0,0,0
278282,158,158,0,0,0
278295,102,102,0,0,0
278300,167,167,0,0,0
278311,310,310,0,0,0
278313,97,97,0,0,0
278336,76,76,0,0,0
278346,10,10,0,0,0
278357,70,70,0,0,0
278358,252,252,0,0,0
278388,70,70,0,0,0
278400,353,353,0,0,0
278405,281,281,0,0,0
278421,76,76,0,0,0
278435,359,359,0,0,0
278443,70,70,0,0,0
278452,114,114,0,0,0
278465,353,353,0,0,0
278467,12,12,0,0,0
278491,359,359,0,0,0
278498,9,9,0,0,0
278502,18,18,0,0,0
278504,76,76,0,0,0
278516,152,152,0,0,0
278522,72,72,0,0,0
278523,25,25,0,0,0
278524,121,121,0,0,0
278530,13,13,0,0,0
278565,12,12,0,0,0
278567,29,29,0,0,0
278568,113,113,0,0,0
278590,102,102,0,0,0
278595,313,313,0,0,0
278607,402,402,0,0,0
278620,193,193,0,0,0
278649,252,252,0,0,0
278656,143,143,0,0,0
278667,252,252,0,0,0
278670,114,114,0,0,0
278672,128,128,0,0,0
278681,74,74,0,0,0
278686,103,103,0,0,0
278698,151,151,0,0,0
278711,70,70,0,0,0
278717,306,306,0,0,0
278723,102,102,0,0,0
278727,137,137,0,0,0
278731,17,17,0,0,0
278741,252,252,0,0,0
278751,310,310,0,0,0
278799,34,34,0,0,0
278806,25,25,0,0,0
278829,128,128,0,0,0
278846,77,77,0,0,0
278860,67,67,0,0,0
278862,359,359,0,0,0
278863,306,306,0,0,0
278867,130,130,0,0,0
278868,306,306,0,0,0
278874,71,71,0,0,0
278893,69,69,0,0,0
278898,97,97,0,0,0
278924,82,82,0,0,0
278927,180,180,0,0,0
278928,306,306,0,0,0
278932,313,313,0,0,0
278938,121,121,0,0,0
278949,114,114,0,0,0
278950,313,313,0,0,0
278955,252,252,0,0,0
278957,36,36,0,0,0
278974,259,259,0,0,0
278979,143,143,0,0,0
278986,259,259,0,0,0
278987,353,353,0,0,0
278988,306,306,0,0,0
278995,44,44,0,0,0
278996,4,4,0,0,0
279001,114,114,0,0,0
279010,34,34,0,0,0
279029,114,114,0,0,0
279031,82,82,0,0,0
279033,70,70,0,0,0
279034,128,128,0,0,0
279040,56,56,0,0,0
279051,246,246,0,0,0
279053,143,143,0,0,0
279067,232,232,0,0,0
279079,310,310,0,0,0
279094,3,3,0,0,0
279118,9,9,0,0,0
279126,15,15,0,0,0
279134,71,71,0,0,0
279137,232,232,0,0,0
279158,75,75,0,0,0
279160,131,131,0,0,0
279171,36,36,0,0,0
279183,82,82,0,0,0
279194,144,144,0,0,0
279197,15,15,0,0,0
279205,313,313,0,0,0
279224,29,29,0,0,0
279238,56,56,0,0,0
279252,310,310,0,0,0
279259,18,18,0,0,0
279261,128,128,0,0,0
279277,252,252,0,0,0
279279,255,255,0,0,0
279294,163,163,0,0,0
279296,45,45,0,0,0
279299,246,246,0,0,0
279301,15,15,0,0,0
279313,402,402,0,0,0
279327,306,306,0,0,0
279340,353,353,0,0,0
279348,56,56,0,0,0
279360,180,180,0,0,0
279369,353,353,0,0,0
279384,74,74,0,0,0
279397,121,121,0,0,0
279418,137,137,0,0,0
279429,76,76,0,0,0
279435,184,184,0,0,0
279440,74,74,0,0,0
279452,198,198,0,0,0
279465,67,67,0,0,0
279469,306,306,0,0,0
279497,198,198,0,0,0
279501,345,345,0,0,0
279508,251,251,0,0,0
279519,144,144,0,0,0
279535,71,71,0,0,0
279540,198,198,0,0,0
279583,255,255,0,0,0
279595,28,28,0,0,0
279610,54,54,0,0,0
279618,44,44,0,0,0
279647,7,7,0,0,0
279657,15,15,0,0,0
279679,402,402,0,0,0
279684,82,82,0,0,0
279687,25,25,0,0,0
279688,184,184,0,0,0
279689,232,232,0,0,0
279701,306,306,0,0,0
279705,19,19,0,0,0
279711,315,315,0,0,0
279714,128,128,0,0,0
279719,282,282,0,0,0
279739,9,9,0,0,0
279772,180,180,0,0,0
279776,180,180,0,0,0
279795,353,353,0,0,0
279803,315,315,0,0,0
279818,121,121,0,0,0
279831,102,102,0,0,0
279833,143,143,0,0,0
279834,36,36,0,0,0
279839,246,246,0,0,0
279850,144,144,0,0,0
279857,201,201,0,0,0
279860,299,299,0,0,0
279862,36,36,0,0,0
279880,6,6,0,0,0
279891,152,152,0,0,0
279923,67,67,0,0,0
279940,87,87,0,0,0
279942,402,402,0,0,0
279945,13,13,0,0,0
279961,184,184,0,0,0
279964,299,299,0,0,0
279971,313,313,0,0,0
279976,281,281,0,0,0
279994,282,282,0,0,0
280005,180,180,0,0,0
280013,120,120,0,0,0
280020,133,133,0,0,0
280021,76,76,0,0,0
280024,171,171,0,0,0
280036,402,402,0,0,0
280046,14,14,0,0,0
280064,259,259,0,0,0
280071,114,114,0,0,0
280073,251,251,0,0,0
280091,44,44,0,0,0
280101,74,74,0,0,0
280115,281,281,0,0,0
280127,57,57,0,0,0
280146,50,50,0,0,0
280151,121,121,0,0,0
280154,114,114,0,0,0
280172,180,180,0,0,0
280176,315,315,0,0,0
280180,113,113,0,0,0
280184,17,17,0,0,0
280203,282,282,0,0,0
280211,345,345,0,0,0
280220,66,66,0,0,0
280224,137,137,0,0,0
280229,180,180,0,0,0
280250,8,8,0,0,0
280263,315,315,0,0,0
280267,16,16,0,0,0
280268,252,252,0,0,0
280275,306,306,0,0,0
280279,310,310,0,0,0
280285,315,315,0,0,0
280293,251,251,0,0,0
280295,281,281,0,0,0
280304,359,359,0,0,0
280313,252,252,0,0,0
280314,87,87,0,0,0
280318,180,180,0,0,0
280347,144,144,0,0,0
280359,30,30,0,0,0
280364,315,315,0,0,0
280382,32,32,0,0,0
280386,151,151,0,0,0
280391,34,34,0,0,0
280399,113,113,0,0,0
280409,255,255,0,0,0
280410,168,168,0,0,0
280429,171,171,0,0,0
280445,102,102,0,0,0
280457,87,87,0,0,0
280463,29,29,0,0,0
280465,41,41,0,0,0
280468,74,74,0,0,0
280488,310,310,0,0,0
280526,402,402,0,0,0
280532,180,180,0,0,0
280539,232,232,0,0,0
280551,120,120,0,0,0
280608,251,251,0,0,0
280612,313,313,0,0,0
280614,121,121,0,0,0
280646,198,198,0,0,0
280653,281,281,0,0,0
280679,310,310,0,0,0
280683,198,198,0,0,0
280691,246,246,0,0,0
280695,103,103,0,0,0
280714,299,299,0,0,0
280715,313,313,0,0,0
280757,133,133,0,0,0
280759,10,10,0,0,0
280763,76,76,0,0,0
280782,163,163,0,0,0
280783,180,180,0,0,0
280784,72,72,0,0,0
280789,251,251,0,0,0
280827,137,137,0,0,0
280828,402,402,0,0,0
280830,11,11,0,0,0
280841,282,282,0,0,0
280845,281,281,0,0,0
280847,114,114,0,0,0
280854,137,137,0,0,0
280873,39,39,0,0,0
280874,306,306,0,0,0
280883,66,66,0,0,0
280901,143,143,0,0,0
280906,345,345,0,0,0
280907,65,65,0,0,0
280908,402,402,0,0,0
280909,128,128,0,0,0
280915,252,252,0,0,0
280927,69,69,0,0,0
280933,167,167,0,0,0
280944,114,114,0,0,0
280965,113,113,0,0,0
280982,163,163,0,0,0
280996,313,313,0,0,0
281006,259,259,0,0,0
281007,23,23,0,0,0
281008,252,252,0,0,0
281013,128,128,0,0,0
281035,72,72,0,0,0
281046,44,44,0,0,0
281061,12,12,0,0,0
281070,313,313,0,0,0
281080,299,299,0,0,0
281081,282,282,0,0,0
281082,151,151,0,0,0
281087,18,18,0,0,0
281098,18,18,0,0,0
281102,65,65,0,0,0
281114,30,30,0,0,0
281115,63,63,0,0,0
281116,57,57,0,0,0
281132,345,345,0,0,0
281159,44,44,0,0,0
281161,39,39,0,0,0
281183,120,120,0,0,0
281208,180,180,0,0,0
281214,353,353,0,0,0
281218,359,359,0,0,0
281227,359,359,0,0,0
281274,9,9,0,0,0
281286,128,128,0,0,0
281291,282,282,0,0,0
281293,128,128,0,0,0
281295,310,310,0,0,0
281307,313,313,0,0,0
281313,18,18,0,0,0
281314,25,25,0,0,0
281316,102,102,0,0,0
281323,137,137,0,0,0
281359,56,56,0,0,0
281369,137,137,0,0,0
281399,120,120,0,0,0
281406,34,34,0,0,0
281409,158,158,0,0,0
281411,66,66,0,0,0
281426,282,282,0,0,0
281430,259,259,0,0,0
281441,2,2,0,0,0
281469,24,24,0,0,0
281486,16,16,0,0,0
281487,152,152,0,0,0
281489,75,75,0,0,0
281496,8,8,0,0,0
281498,282,282,0,0,0
281499,137,137,0,0,0
281512,144,144,0,0,0
281515,137,137,0,0,0
281537,180,180,0,0,0
281541,114,114,0,0,0
281566,152,152,0,0,0
281570,11,11,0,0,0
281633,114,114,0,0,0
281637,232,232,0,0,0
281645,121,121,0,0,0
281648,94,94,0,0,0
281658,353,353,0,0,0
281672,17,17,0,0,0
281684,39,39,0,0,0
281694,251,251,0,0,0
281701,87,87,0,0,0
281708,232,232,0,0,0
281712,144,144,0,0,0
281763,299,299,0,0,0
281768,168,168,0,0,0
281781,345,345,0,0,0
281788,193,193,0,0,0
281815,152,152,0,0,0
281817,184,184,0,0,0
281820,193,193,0,0,0
281828,402,402,0,0,0
281830,167,167,0,0,0
281835,74,74,0,0,0
281851,18,18,0,0,0
281868,281,281,0,0,0
281869,35,35,0,0,0
281871,7,7,0,0,0
281880,17,17,0,0,0
281881,345,345,0,0,0
281887,315,315,0,0,0
281889,50,50,0,0,0
281911,315,315,0,0,0
281925,251,251,0,0,0
281940,167,167,0,0,0
281951,3,3,0,0,0
281963,94,94,0,0,0
281967,82,82,0,0,0
281979,255,255,0,0,0
281997,299,299,0,0,0
282002,70,70,0,0,0
282006,171,171,0,0,0
282012,25,25,0,0,0
282015,313,313,0,0,0
282025,143,143,0,0,0
282080,6,6,0,0,0
282104,102,102,0,0,0
282107,82,82,0,0,0
282109,44,44,0,0,0
282110,83,83,0,0,0
282111,171,171,0,0,0
282115,121,121,0,0,0
282136,246,246,0,0,0
282139,114,114,0,0,0
282140,232,232,0,0,0
282144,137,137,0,0,0
282153,259,259,0,0,0
282155,345,345,0,0,0
282159,102,102,0,0,0
282191,251,251,0,0,0
282193,82,82,0,0,0
282196,44,44,0,0,0
282199,193,193,0,0,0
282212,345,345,0,0,0
282223,246,246,0,0,0
282227,102,102,0,0,0
282237,114,114,0,0,0
282240,17,17,0,0,0
282252,259,259,0,0,0
282258,143,143,0,0,0
282259,27,27,0,0,0
282263,24,24,0,0,0
282267,255,255,0,0,0
282295,345,345,0,0,0
282299,40,40,0,0,0
282329,402,402,0,0,0
282339,313,313,0,0,0
282348,171,171,0,0,0
282356,180,180,0,0,0
282369,25,25,0,0,0
282370,313,313,0,0,0
282373,45,45,0,0,0
282386,15,15,0,0,0
282406,345,345,0,0,0
282410,143,143,0,0,0
282433,252,252,0,0,0
282439,34,34,0,0,0
282462,43,43,0,0,0
282464,70,70,0,0,0
282470,168,168,0,0,0
282476,299,299,0,0,0
282487,9,9,0,0,0
282493,151,151,0,0,0
282518,12,12,0,0,0
282523,315,315,0,0,0
282530,402,402,0,0,0
282538,97,97,0,0,0
282549,67,67,0,0,0
282589,168,168,0,0,0
282599,69,69,0,0,0
282609,22,22,0,0,0
282627,35,35,0,0,0
282629,29,29,0,0,0
282638,259,259,0,0,0
282658,299,299,0,0,0
282661,313,313,0,0,0
282680,315,315,0,0,0
282687,35,35,0,0,0
282688,167,167,0,0,0
282689,102,102,0,0,0
282700,121,121,0,0,0
282703,70,70,0,0,0
282705,345,345,0,0,0
282706,128,128,0,0,0
282729,252,252,0,0,0
282737,114,114,0,0,0
282741,246,246,0,0,0
282742,198,198,0,0,0
282750,306,306,0,0,0
282759,74,74,0,0,0
282761,102,102,0,0,0
282788,252,252,0,0,0
282790,359,359,0,0,0
282811,17,17,0,0,0
282835,15,15,0,0,0
282870,255,255,0,0,0
282872,66,66,0,0,0
282881,171,171,0,0,0
282887,77,77,0,0,0
282891,131,131,0,0,0
282895,180,180,0,0,0
282902,34,34,0,0,0
282916,252,252,0,0,0
282920,130,130,0,0,0
282928,54,54,0,0,0
282963,144,144,0,0,0
282964,402,402,0,0,0
282990,299,299,0,0,0
282991,201,201,0,0,0
282994,306,306,0,0,0
283004,133,133,0,0,0
283017,152,152,0,0,0
283041,402,402,0,0,0
283042,102,102,0,0,0
283056,137,137,0,0,0
283058,315,315,0,0,0
283067,114,114,0,0,0
283080,87,87,0,0,0
283090,345,345,0,0,0
283095,232,232,0,0,0
283117,144,144,0,0,0
283124,144,144,0,0,0
283144,74,74,0,0,0
283148,76,76,0,0,0
283158,24,24,0,0,0
283166,184,184,0,0,0
283179,30,30,0,0,0
283192,310,310,0,0,0
283211,310,310,0,0,0
283214,359,359,0,0,0
283231,259,259,0,0,0
283243,353,353,0,0,0
283259,144,144,0,0,0
283269,8,8,0,0,0
283273,85,85,0,0,0
283304,57,57,0,0,0
283306,232,232,0,0,0
283307,158,158,0,0,0
283314,130,130,0,0,0
283322,313,313,0,0,0
283327,28,28,0,0,0
283341,259,259,0,0,0
283356,121,121,0,0,0
283359,232,232,0,0,0
283366,94,94,0,0,0
283391,72,72,0,0,0
283405,158,158,0,0,0
283412,180,180,0,0,0
283421,57,57,0,0,0
283444,168,168,0,0,0
283466,152,152,0,0,0
283467,63,63,0,0,0
283473,259,259,0,0,0
283478,11,11,0,0,0
283497,87,87,0,0,0
283498,315,315,0,0,0
283503,299,299,0,0,0
283506,76,76,0,0,0
283528,22,22,0,0,0
283541,13,13,0,0,0
283543,259,259,0,0,0
283550,69,69,0,0,0
283552,353,353,0,0,0
283553,402,402,0,0,0
283577,120,120,0,0,0
283578,359,359,0,0,0
283584,251,251,0,0,0
283587,74,74,0,0,0
283615,345,345,0,0,0
283622,315,315,0,0,0
283625,45,45,0,0,0
283639,24,24,0,0,0
283644,359,359,0,0,0
283645,246,246,0,0,0
283652,246,246,0,0,0
283671,83,83,0,0,0
283677,20,20,0,0,0
283685,144,144,0,0,0
283691,143,143,0,0,0
283738,102,102,0,0,0
283740,282,282,0,0,0
283753,282,282,0,0,0
283774,41,41,0,0,0
283784,359,359,0,0,0
283798,13,13,0,0,0
283811,158,158,0,0,0
283814,345,345,0,0,0
283830,198,198,0,0,0
283840,35,35,0,0,0
283842,13,13,0,0,0
283843,353,353,0,0,0
283845,232,232,0,0,0
283859,345,345,0,0,0
283882,30,30,0,0,0
283883,66,66,0,0,0
283901,232,232,0,0,0
283910,315,315,0,0,0
283916,87,87,0,0,0
283926,310,310,0,0,0
283935,152,152,0,0,0
283937,130,130,0,0,0
283957,246,246,0,0,0
283985,17,17,0,0,0
284064,29,29,0,0,0
284069,299,299,0,0,0
284092,94,94,0,0,0
284097,32,32,0,0,0
284104,87,87,0,0,0
284107,345,345,0,0,0
284123,259,259,0,0,0
284140,402,402,0,0,0
284143,29,29,0,0,0
284147,120,120,0,0,0
284151,345,345,0,0,0
284152,76,76,0,0,0
284159,72,72,0,0,0
284163,121,121,0,0,0
284168,15,15,0,0,0
284179,306,306,0,0,0
284187,143,143,0,0,0
284191,255,255,0,0,0
284195,131,131,0,0,0
284205,65,65,0,0,0
284211,67,67,0,0,0
284221,171,171,0,0,0
284228,282,282,0,0,0
284234,193,193,0,0,0
284237,281,281,0,0,0
284279,252,252,0,0,0
284286,353,353,0,0,0
284291,120,120,0,0,0
284299,66,66,0,0,0
284337,345,345,0,0,0
284339,97,97,0,0,0
284353,255,255,0,0,0
284357,345,345,0,0,0
284364,299,299,0,0,0
284382,94,94,0,0,0
284383,313,313,0,0,0
284394,151,151,0,0,0
284397,259,259,0,0,0
284407,40,40,0,0,0
284416,299,299,0,0,0
284440,75,75,0,0,0
284456,201,201,0,0,0
284462,27,27,0,0,0
284493,345,345,0,0,0
284508,82,82,0,0,0
284530,10,10,0,0,0
284545,12,12,0,0,0
284572,76,76,0,0,0
284587,22,22,0,0,0
284590,102,102,0,0,0
284615,255,255,0,0,0
284616,255,255,0,0,0
284618,121,121,0,0,0
284632,402,402,0,0,0
284644,6,6,0,0,0
284649,299,299,0,0,0
284666,3,3,0,0,0
284681,315,315,0,0,0
284692,313,313,0,0,0
284715,137,137,0,0,0
284719,57,57,0,0,0
284759,3,3,0,0,0
284787,82,82,0,0,0
284798,57,57,0,0,0
284803,103,103,0,0,0
284810,76,76,0,0,0
284812,259,259,0,0,0
284825,71,71,0,0,0
284846,103,103,0,0,0
284858,17,17,0,0,0
284860,102,102,0,0,0
284871,133,133,0,0,0
284883,12,12,0,0,0
284897,39,39,0,0,0
284901,163,163,0,0,0
284916,30,30,0,0,0
284921,402,402,0,0,0
284922,255,255,0,0,0
284930,232,232,0,0,0
284934,70,70,0,0,0
284938,255,255,0,0,0
284962,50,50,0,0,0
284966,120,120,0,0,0
284980,76,76,0,0,0
284982,97,97,0,0,0
284986,102,102,0,0,0
285025,180,180,0,0,0
285032,315,315,0,0,0
285039,22,22,0,0,0
285042,359,359,0,0,0
285054,121,121,0,0,0
285057,232,232,0,0,0
285059,158,158,0,0,0
285073,345,345,0,0,0
285074,163,163,0,0,0
285079,359,359,0,0,0
285107,5,5,0,0,0
285115,306,306,0,0,0
285122,4,4,0,0,0
285123,43,43,0,0,0
285139,34,34,0,0,0
285154,168,168,0,0,0
285162,310,310,0,0,0
285181,359,359,0,0,0
285185,17,17,0,0,0
285202,282,282,0,0,0
285206,23,23,0,0,0
285207,353,353,0,0,0
285218,5,5,0,0,0
285226,13,13,0,0,0
285236,282,282,0,0,0
285237,35,35,0,0,0
285256,402,402,0,0,0
285271,313,313,0,0,0
285272,71,71,0,0,0
285286,131,131,0,0,0
285299,315,315,0,0,0
285303,35,35,0,0,0
285323,281,281,0,0,0
285325,313,313,0,0,0
285327,402,402,0,0,0
285364,121,121,0,0,0
285368,163,163,0,0,0
285371,306,306,0,0,0
285373,137,137,0,0,0
285376,22,22,0,0,0
285378,74,74,0,0,0
285383,282,282,0,0,0
285385,168,168,0,0,0
285415,353,353,0,0,0
285417,94,94,0,0,0
285430,55,55,0,0,0
285440,315,315,0,0,0
285441,158,158,0,0,0
285442,15,15,0,0,0
285443,198,198,0,0,0
285444,163,163,0,0,0
285446,75,75,0,0,0
285475,27,27,0,0,0
285531,128,128,0,0,0
285532,310,310,0,0,0
285540,252,252,0,0,0
285544,163,163,0,0,0
285549,315,315,0,0,0
285554,180,180,0,0,0
285557,120,120,0,0,0
285559,29,29,0,0,0
285579,19,19,0,0,0
285587,94,94,0,0,0
285590,310,310,0,0,0
285596,232,232,0,0,0
285597,56,56,0,0,0
285628,313,313,0,0,0
285630,133,133,0,0,0
285646,18,18,0,0,0
285660,39,39,0,0,0
285674,57,57,0,0,0
285686,180,180,0,0,0
285695,167,167,0,0,0
285706,5,5,0,0,0
285711,94,94,0,0,0
285726,63,63,0,0,0
285750,198,198,0,0,0
285754,132,132,0,0,0
285760,282,282,0,0,0
285778,313,313,0,0,0
285779,71,71,0,0,0
285783,232,232,0,0,0
285785,128,128,0,0,0
285789,133,133,0,0,0
285790,131,131,0,0,0
285814,167,167,0,0,0
285815,313,313,0,0,0
285821,180,180,0,0,0
285827,32,32,0,0,0
285830,402,402,0,0,0
285840,50,50,0,0,0
285842,310,310,0,0,0
285846,66,66,0,0,0
285885,87,87,0,0,0
285886,255,255,0,0,0
285893,184,184,0,0,0
285897,310,310,0,0,0
285900,121,121,0,0,0
285905,121,121,0,0,0
285907,163,163,0,0,0
285910,353,353,0,0,0
286001,36,36,0,0,0
286013,75,75,0,0,0
286055,70,70,0,0,0
286061,315,315,0,0,0
286075,130,130,0,0,0
286076,19,19,0,0,0
286077,32,32,0,0,0
286078,184,184,0,0,0
286090,281,281,0,0,0
286092,83,83,0,0,0
286116,299,299,0,0,0
286121,299,299,0,0,0
286122,102,102,0,0,0
286135,24,24,0,0,0
286137,306,306,0,0,0
286143,193,193,0,0,0
286154,310,310,0,0,0
286189,14,14,0,0,0
286198,30,30,0,0,0
286211,132,132,0,0,0
286225,121,121,0,0,0
286230,15,15,0,0,0
286247,43,43,0,0,0
286260,12,12,0,0,0
286290,313,313,0,0,0
286306,402,402,0,0,0
286310,29,29,0,0,0
286311,17,17,0,0,0
286322,74,74,0,0,0
286326,359,359,0,0,0
286345,35,35,0,0,0
286351,252,252,0,0,0
286364,251,251,0,0,0
286375,56,56,0,0,0
286381,163,163,0,0,0
286400,180,180,0,0,0
286422,171,171,0,0,0
286428,167,167,0,0,0
286448,310,310,0,0,0
286450,87,87,0,0,0
286456,299,299,0,0,0
286458,58,58,0,0,0
286471,25,25,0,0,0
286473,121,121,0,0,0
286493,180,180,0,0,0
286508,43,43,0,0,0
286520,144,144,0,0,0
286523,94,94,0,0,0
286542,56,56,0,0,0
286544,252,252,0,0,0
286555,94,94,0,0,0
286564,27,27,0,0,0
286570,193,193,0,0,0
286590,76,76,0,0,0
286619,75,75,0,0,0
286623,313,313,0,0,0
286627,310,310,0,0,0
286643,402,402,0,0,0
286667,345,345,0,0,0
286680,281,281,0,0,0
286685,281,281,0,0,0
286724,255,255,0,0,0
286731,102,102,0,0,0
286737,82,82,0,0,0
286743,66,66,0,0,0
286744,40,40,0,0,0
286756,87,87,0,0,0
286758,36,36,0,0,0
286764,310,310,0,0,0
286770,232,232,0,0,0
286774,17,17,0,0,0
286778,143,143,0,0,0
286786,167,167,0,0,0
286797,56,56,0,0,0
286798,168,168,0,0,0
286800,251,251,0,0,0
286801,18,18,0,0,0
286804,251,251,0,0,0
286809,313,313,0,0,0
286839,168,168,0,0,0
286847,158,158,0,0,0
286849,359,359,0,0,0
286861,306,306,0,0,0
286906,72,72,0,0,0
286907,313,313,0,0,0
286909,252,252,0,0,0
286921,315,315,0,0,0
286951,57,57,0,0,0
286963,113,113,0,0,0
286981,82,82,0,0,0
287001,353,353,0,0,0
287002,128,128,0,0,0
287019,402,402,0,0,0
287027,10,10,0,0,0
287036,12,12,0,0,0
287045,313,313,0,0,0
287049,75,75,0,0,0
287050,259,259,0,0,0
287054,120,120,0,0,0
287070,353,353,0,0,0
287111,132,132,0,0,0
287121,232,232,0,0,0
287131,114,114,0,0,0
287132,137,137,0,0,0
287140,35,35,0,0,0
287147,8,8,0,0,0
287165,137,137,0,0,0
287168,259,259,0,0,0
287185,94,94,0,0,0
287187,24,24,0,0,0
287205,50,50,0,0,0
287213,120,120,0,0,0
287219,251,251,0,0,0
287220,306,306,0,0,0
287221,184,184,0,0,0
287252,65,65,0,0,0
287256,180,180,0,0,0
287265,20,20,0,0,0
287280,359,359,0,0,0
287281,353,353,0,0,0
287290,44,44,0,0,0
287292,131,131,0,0,0
287300,345,345,0,0,0
287313,77,77,0,0,0
287316,24,24,0,0,0
287326,402,402,0,0,0
287331,171,171,0,0,0
287335,402,402,0,0,0
287344,281,281,0,0,0
287349,315,315,0,0,0
287365,83,83,0,0,0
287397,3,3,0,0,0
287402,313,313,0,0,0
287446,252,252,0,0,0
287455,143,143,0,0,0
287469,345,345,0,0,0
287484,246,246,0,0,0
287485,77,77,0,0,0
287487,180,180,0,0,0
287493,15,15,0,0,0
287495,121,121,0,0,0
287496,184,184,0,0,0
287501,12,12,0,0,0
287514,15,15,0,0,0
287530,97,97,0,0,0
287563,306,306,0,0,0
287571,345,345,0,0,0
287574,252,252,0,0,0
287598,402,402,0,0,0
287609,315,315,0,0,0
287611,2,2,0,0,0
287625,94,94,0,0,0
287631,77,77,0,0,0
287638,131,131,0,0,0
287664,180,180,0,0,0
287665,29,29,0,0,0
287695,193,193,0,0,0
287711,158,158,0,0,0
287714,128,128,0,0,0
287718,281,281,0,0,0
287756,168,168,0,0,0
287765,137,137,0,0,0
287770,259,259,0,0,0
287773,15,15,0,0,0
287776,402,402,0,0,0
287805,198,198,0,0,0
287813,34,34,0,0,0
287814,281,281,0,0,0
287817,12,12,0,0,0
287829,171,171,0,0,0
287846,113,113,0,0,0
287906,102,102,0,0,0
287912,402,402,0,0,0
287914,22,22,0,0,0
287923,7,7,0,0,0
287943,345,345,0,0,0
287945,281,281,0,0,0
287951,43,43,0,0,0
287957,143,143,0,0,0
287963,232,232,0,0,0
287965,20,20,0,0,0
287996,232,232,0,0,0
288024,39,39,0,0,0
288039,282,282,0,0,0
288040,252,252,0,0,0
288051,76,76,0,0,0
288059,259,259,0,0,0
288094,102,102,0,0,0
288098,299,299,0,0,0
288102,313,313,0,0,0
288108,8,8,0,0,0
288112,193,193,0,0,0
288122,133,133,0,0,0
288127,94,94,0,0,0
288163,255,255,0,0,0
288186,102,102,0,0,0
288193,158,158,0,0,0
288194,282,282,0,0,0
288195,255,255,0,0,0
288204,252,252,0,0,0
288216,11,11,0,0,0
288221,299,299,0,0,0
288240,70,70,0,0,0
288266,315,315,0,0,0
288280,50,50,0,0,0
288288,131,131,0,0,0
288299,5,5,0,0,0
288301,143,143,0,0,0
288308,359,359,0,0,0
288313,246,246,0,0,0
288319,255,255,0,0,0
288321,102,102,0,0,0
288324,130,130,0,0,0
288336,246,246,0,0,0
288358,152,152,0,0,0
288359,152,152,0,0,0
288363,306,306,0,0,0
288367,133,133,0,0,0
288387,353,353,0,0,0
288406,306,306,0,0,0
288415,55,55,0,0,0
288429,151,151,0,0,0
288448,201,201,0,0,0
288479,72,72,0,0,0
288487,163,163,0,0,0
288501,151,151,0,0,0
288513,131,131,0,0,0
288539,184,184,0,0,0
288548,151,151,0,0,0
288558,232,232,0,0,0
288559,25,25,0,0,0
288565,83,83,0,0,0
288578,121,121,0,0,0
288579,306,306,0,0,0
288586,114,114,0,0,0
288590,299,299,0,0,0
288594,167,167,0,0,0
288611,232,232,0,0,0
288666,299,299,0,0,0
288667,259,259,0,0,0
288673,180,180,0,0,0
288703,102,102,0,0,0
288714,24,24,0,0,0
288717,201,201,0,0,0
288738,56,56,0,0,0
288742,20,20,0,0,0
288747,281,281,0,0,0
288751,281,281,0,0,0
288753,252,252,0,0,0
288769,282,282,0,0,0
288792,97,97,0,0,0
288808,131,131,0,0,0
288816,15,15,0,0,0
288818,102,102,0,0,0
288831,39,39,0,0,0
288832,18,18,0,0,0
288840,143,143,0,0,0
288843,359,359,0,0,0
288881,8,8,0,0,0
288891,313,313,0,0,0
288900,144,144,0,0,0
288905,121,121,0,0,0
288906,252,252,0,0,0
288908,402,402,0,0,0
288914,55,55,0,0,0
288918,313,313,0,0,0
288938,313,313,0,0,0
288962,281,281,0,0,0
288975,7,7,0,0,0
288981,232,232,0,0,0
288984,16,16,0,0,0
288989,19,19,0,0,0
288998,353,353,0,0,0
289017,101,101,0,0,0
289022,44,44,0,0,0
289053,32,32,0,0,0
289074,120,120,0,0,0
289076,130,130,0,0,0
289082,310,310,0,0,0
289098,282,282,0,0,0
289099,180,180,0,0,0
289105,163,163,0,0,0
289113,128,128,0,0,0
289123,102,102,0,0,0
289132,259,259,0,0,0
289145,30,30,0,0,0
289171,282,282,0,0,0
289195,306,306,0,0,0
289209,7,7,0,0,0
289241,17,17,0,0,0
289254,63,63,0,0,0
289281,75,75,0,0,0
289291,168,168,0,0,0
289295,402,402,0,0,0
289296,20,20,0,0,0
289303,40,40,0,0,0
289317,29,29,0,0,0
289324,133,133,0,0,0
289347,402,402,0,0,0
289348,16,16,0,0,0
289353,252,252,0,0,0
289368,85,85,0,0,0
289372,137,137,0,0,0
289377,2,2,0,0,0
289391,74,74,0,0,0
289436,130,130,0,0,0
289437,299,299,0,0,0
289460,71,71,0,0,0
289463,67,67,0,0,0
289470,167,167,0,0,0
289472,3,3,0,0,0
289480,114,114,0,0,0
289497,103,103,0,0,0
289511,315,315,0,0,0
289514,299,299,0,0,0
289553,306,306,0,0,0
289561,114,114,0,0,0
289579,345,345,0,0,0
289582,75,75,0,0,0
289588,151,151,0,0,0
289592,101,101,0,0,0
289623,27,27,0,0,0
289632,85,85,0,0,0
289633,12,12,0,0,0
289645,50,50,0,0,0
289670,34,34,0,0,0
289695,180,180,0,0,0
289734,282,282,0,0,0
289745,310,310,0,0,0
289751,313,313,0,0,0
289752,55,55,0,0,0
289759,345,345,0,0,0
289760,50,50,0,0,0
289767,345,345,0,0,0
289769,66,66,0,0,0
289773,1,1,0,0,0
289778,144,144,0,0,0
289779,8,8,0,0,0
289784,94,94,0,0,0
289786,282,282,0,0,0
289789,9,9,0,0,0
289794,232,232,0,0,0
289802,7,7,0,0,0
289811,7,7,0,0,0
289823,299,299,0,0,0
289826,163,163,0,0,0
289833,24,24,0,0,0
289837,103,103,0,0,0
289844,171,171,0,0,0
289866,180,180,0,0,0
289867,151,151,0,0,0
289868,282,282,0,0,0
289889,180,180,0,0,0
289921,130,130,0,0,0
289984,251,251,0,0,0
289986,232,232,0,0,0
290001,353,353,0,0,0
290030,282,282,0,0,0
290045,67,67,0,0,0
290047,63,63,0,0,0
290057,359,359,0,0,0
290077,70,70,0,0,0
290081,41,41,0,0,0
290091,299,299,0,0,0
290096,345,345,0,0,0
290121,77,77,0,0,0
290145,299,299,0,0,0
290146,34,34,0,0,0
290148,28,28,0,0,0
290152,121,121,0,0,0
290155,76,76,0,0,0
290159,232,232,0,0,0
290163,67,67,0,0,0
290168,5,5,0,0,0
290196,12,12,0,0,0
290202,82,82,0,0,0
290213,282,282,0,0,0
290222,85,85,0,0,0
290263,56,56,0,0,0
290268,55,55,0,0,0
290277,353,353,0,0,0
290279,19,19,0,0,0
290287,143,143,0,0,0
290291,70,70,0,0,0
290292,313,313,0,0,0
290299,101,101,0,0,0
290301,70,70,0,0,0
290307,402,402,0,0,0
290314,71,71,0,0,0
290342,402,402,0,0,0
290364,151,151,0,0,0
290369,246,246,0,0,0
290392,128,128,0,0,0
290407,10,10,0,0,0
290409,102,102,0,0,0
290411,313,313,0,0,0
290441,101,101,0,0,0
290445,184,184,0,0,0
290453,66,66,0,0,0
290473,143,143,0,0,0
290482,28,28,0,0,0
290488,13,13,0,0,0
290506,168,168,0,0,0
290514,167,167,0,0,0
290516,171,171,0,0,0
290536,76,76,0,0,0
290549,137,137,0,0,0
290562,74,74,0,0,0
290569,85,85,0,0,0
290574,6,6,0,0,0
290584,45,45,0,0,0
290594,152,152,0,0,0
290601,20,20,0,0,0
290615,353,353,0,0,0
290617,255,255,0,0,0
290619,22,22,0,0,0
290624,29,29,0,0,0
290639,9,9,0,0,0
290643,30,30,0,0,0
290649,21,21,0,0,0
290656,359,359,0,0,0
290657,83,83,0,0,0
290661,11,11,0,0,0
290662,345,345,0,0,0
290664,201,201,0,0,0
290672,22,22,0,0,0
290682,353,353,0,0,0
290685,184,184,0,0,0
290687,171,171,0,0,0
290698,168,168,0,0,0
290731,402,402,0,0,0
290751,103,103,0,0,0
290761,359,359,0,0,0
290765,255,255,0,0,0
290774,76,76,0,0,0
290776,101,101,0,0,0
290777,121,121,0,0,0
290786,143,143,0,0,0
290788,282,282,0,0,0
290792,151,151,0,0,0
290810,7,7,0,0,0
290848,56,56,0,0,0
290851,74,74,0,0,0
290860,102,102,0,0,0
290866,94,94,0,0,0
290871,281,281,0,0,0
290880,76,76,0,0,0
290883,131,131,0,0,0
290893,198,198,0,0,0
290898,63,63,0,0,0
290912,158,158,0,0,0
290918,402,402,0,0,0
290919,310,310,0,0,0
290967,82,82,0,0,0
291005,128,128,0,0,0
291019,101,101,0,0,0
291020,83,83,0,0,0
291023,313,313,0,0,0
291035,82,82,0,0,0
291083,114,114,0,0,0
291098,281,281,0,0,0
291112,281,281,0,0,0
291151,310,310,0,0,0
291163,74,74,0,0,0
291178,306,306,0,0,0
291190,28,28,0,0,0
291191,71,71,0,0,0
291209,402,402,0,0,0
291210,14,14,0,0,0
291216,232,232,0,0,0
291230,35,35,0,0,0
291232,299,299,0,0,0
291244,281,281,0,0,0
291270,70,70,0,0,0
291271,69,69,0,0,0
291272,121,121,0,0,0
291274,353,353,0,0,0
291299,158,158,0,0,0
291335,232,232,0,0,0
291342,76,76,0,0,0
291347,345,345,0,0,0
291386,193,193,0,0,0
291387,299,299,0,0,0
291423,345,345,0,0,0
291435,184,184,0,0,0
291444,36,36,0,0,0
291449,143,143,0,0,0
291457,128,128,0,0,0
291459,201,201,0,0,0
291473,103,103,0,0,0
291475,402,402,0,0,0
291490,168,168,0,0,0
291492,137,137,0,0,0
291494,97,97,0,0,0
291497,232,232,0,0,0
291505,353,353,0,0,0
291618,128,128,0,0,0
291619,345,345,0,0,0
291634,39,39,0,0,0
291637,69,69,0,0,0
291672,232,232,0,0,0
291676,246,246,0,0,0
291682,193,193,0,0,0
291696,63,63,0,0,0
291697,58,58,0,0,0
291705,24,24,0,0,0
291707,6,6,0,0,0
291714,87,87,0,0,0
291715,103,103,0,0,0
291721,281,281,0,0,0
291737,2,2,0,0,0
291745,69,69,0,0,0
291775,6,6,0,0,0
291784,128,128,0,0,0
291786,232,232,0,0,0
291796,19,19,0,0,0
291811,171,171,0,0,0
291828,22,22,0,0,0
291829,251,251,0,0,0
291841,15,15,0,0,0
291848,345,345,0,0,0
291870,55,55,0,0,0
291884,130,130,0,0,0
291886,74,74,0,0,0
291907,133,133,0,0,0
291918,281,281,0,0,0
291923,252,252,0,0,0
291942,55,55,0,0,0
291947,255,255,0,0,0
291950,17,17,0,0,0
291960,74,74,0,0,0
291968,131,131,0,0,0
291981,184,184,0,0,0
291983,3,3,0,0,0
292005,306,306,0,0,0
292009,310,310,0,0,0
292014,345,345,0,0,0
292039,29,29,0,0,0
292089,6,6,0,0,0
292096,128,128,0,0,0
292097,144,144,0,0,0
292105,151,151,0,0,0
292108,34,34,0,0,0
292114,102,102,0,0,0
292116,259,259,0,0,0
292125,50,50,0,0,0
292126,299,299,0,0,0
292128,402,402,0,0,0
292146,171,171,0,0,0
292148,35,35,0,0,0
292149,65,65,0,0,0
292151,402,402,0,0,0
292161,313,313,0,0,0
292165,151,151,0,0,0
292199,58,58,0,0,0
292205,255,255,0,0,0
292206,353,353,0,0,0
292219,310,310,0,0,0
292233,313,313,0,0,0
292242,94,94,0,0,0
292259,22,22,0,0,0
292267,8,8,0,0,0
292287,246,246,0,0,0
292293,34,34,0,0,0
292294,281,281,0,0,0
292318,22,22,0,0,0
292332,66,66,0,0,0
292339,5,5,0,0,0
292341,402,402,0,0,0
292354,44,44,0,0,0
292357,184,184,0,0,0
292358,102,102,0,0,0
292384,345,345,0,0,0
292385,101,101,0,0,0
292386,359,359,0,0,0
292420,402,402,0,0,0
292425,102,102,0,0,0
292427,315,315,0,0,0
292449,14,14,0,0,0
292451,131,131,0,0,0
292456,251,251,0,0,0
292494,28,28,0,0,0
292503,201,201,0,0,0
292520,39,39,0,0,0
292528,299,299,0,0,0
292534,39,39,0,0,0
292538,282,282,0,0,0
292541,32,32,0,0,0
292542,306,306,0,0,0
292558,76,76,0,0,0
292564,128,128,0,0,0
292574,345,345,0,0,0
292586,128,128,0,0,0
292599,259,259,0,0,0
292610,184,184,0,0,0
292621,158,158,0,0,0
292640,32,32,0,0,0
292641,74,74,0,0,0
292642,168,168,0,0,0
292649,143,143,0,0,0
292653,132,132,0,0,0
292665,82,82,0,0,0
292667,158,158,0,0,0
292687,251,251,0,0,0
292696,359,359,0,0,0
292717,102,102,0,0,0
292725,184,184,0,0,0
292782,77,77,0,0,0
292791,137,137,0,0,0
292807,143,143,0,0,0
292811,72,72,0,0,0
292819,12,12,0,0,0
292856,71,71,0,0,0
292889,180,180,0,0,0
292904,306,306,0,0,0
292910,40,40,0,0,0
292929,29,29,0,0,0
292952,151,151,0,0,0
292976,259,259,0,0,0
292986,8,8,0,0,0
292996,193,193,0,0,0
293006,137,137,0,0,0
293022,36,36,0,0,0
293026,251,251,0,0,0
293030,11,11,0,0,0
293051,171,171,0,0,0
293072,232,232,0,0,0
293076,359,359,0,0,0
293078,40,40,0,0,0
293080,246,246,0,0,0
293085,27,27,0,0,0
293095,171,171,0,0,0
293096,87,87,0,0,0
293099,313,313,0,0,0
293108,11,11,0,0,0
293113,281,281,0,0,0
293155,246,246,0,0,0
293181,71,71,0,0,0
293182,72,72,0,0,0
293191,97,97,0,0,0
293194,120,120,0,0,0
293204,44,44,0,0,0
293226,7,7,0,0,0
293236,345,345,0,0,0
293264,345,345,0,0,0
293266,7,7,0,0,0
293283,9,9,0,0,0
293284,180,180,0,0,0
293291,259,259,0,0,0
293292,167,167,0,0,0
293296,29,29,0,0,0
293298,22,22,0,0,0
293300,3,3,0,0,0
293304,24,24,0,0,0
293315,94,94,0,0,0
293325,151,151,0,0,0
293327,132,132,0,0,0
293346,193,193,0,0,0
293356,143,143,0,0,0
293358,282,282,0,0,0
293390,232,232,0,0,0
293399,39,39,0,0,0
293406,67,67,0,0,0
293414,7,7,0,0,0
293424,45,45,0,0,0
293429,7,7,0,0,0
293439,143,143,0,0,0
293449,193,193,0,0,0
293450,299,299,0,0,0
293485,12,12,0,0,0
293488,30,30,0,0,0
293506,74,74,0,0,0
293512,151,151,0,0,0
293514,306,306,0,0,0
293518,128,128,0,0,0
293524,83,83,0,0,0
293541,103,103,0,0,0
293557,313,313,0,0,0
293567,94,94,0,0,0
293568,345,345,0,0,0
293577,101,101,0,0,0
293578,255,255,0,0,0
293580,8,8,0,0,0
293583,71,71,0,0,0
293586,14,14,0,0,0
293589,359,359,0,0,0
293591,259,259,0,0,0
293599,353,353,0,0,0
293618,180,180,0,0,0
293628,120,120,0,0,0
293635,66,66,0,0,0
293643,171,171,0,0,0
293645,34,34,0,0,0
293654,114,114,0,0,0
293663,56,56,0,0,0
293677,359,359,0,0,0
293698,8,8,0,0,0
293742,193,193,0,0,0
293753,55,55,0,0,0
293764,114,114,0,0,0
293766,32,32,0,0,0
293774,306,306,0,0,0
293782,313,313,0,0,0
293795,359,359,0,0,0
293821,198,198,0,0,0
293827,163,163,0,0,0
293852,50,50,0,0,0
293854,102,102,0,0,0
293879,97,97,0,0,0
293887,359,359,0,0,0
293894,151,151,0,0,0
293898,163,163,0,0,0
293904,251,251,0,0,0
293922,22,22,0,0,0
293931,198,198,0,0,0
293935,102,102,0,0,0
293958,168,168,0,0,0
293977,198,198,0,0,0
293986,2,2,0,0,0
293993,402,402,0,0,0
293995,87,87,0,0,0
293999,184,184,0,0,0
294006,315,315,0,0,0
294010,402,402,0,0,0
294026,85,85,0,0,0
294059,151,151,0,0,0
294064,315,315,0,0,0
294073,17,17,0,0,0
294087,246,246,0,0,0
294101,21,21,0,0,0
294109,306,306,0,0,0
294112,34,34,0,0,0
294116,2,2,0,0,0
294120,44,44,0,0,0
294148,402,402,0,0,0
294151,35,35,0,0,0
294173,359,359,0,0,0
294176,131,131,0,0,0
294237,137,137,0,0,0
294243,151,151,0,0,0
294253,16,16,0,0,0
294254,35,35,0,0,0
294275,113,113,0,0,0
294314,65,65,0,0,0
294315,50,50,0,0,0
294319,345,345,0,0,0
294322,82,82,0,0,0
294332,198,198,0,0,0
294335,7,7,0,0,0
294346,57,57,0,0,0
294351,246,246,0,0,0
294354,72,72,0,0,0
294373,255,255,0,0,0
294376,5,5,0,0,0
294388,246,246,0,0,0
294390,184,184,0,0,0
294406,131,131,0,0,0
294409,71,71,0,0,0
294417,128,128,0,0,0
294421,353,353,0,0,0
294423,313,313,0,0,0
294451,8,8,0,0,0
294453,71,71,0,0,0
294454,103,103,0,0,0
294461,74,74,0,0,0
294465,12,12,0,0,0
294472,282,282,0,0,0
294473,184,184,0,0,0
294478,114,114,0,0,0
294501,50,50,0,0,0
294509,29,29,0,0,0
294531,114,114,0,0,0
294535,94,94,0,0,0
294553,167,167,0,0,0
294560,82,82,0,0,0
294567,246,246,0,0,0
294568,315,315,0,0,0
294571,193,193,0,0,0
294574,1,1,0,0,0
294582,137,137,0,0,0
294587,50,50,0,0,0
294592,5,5,0,0,0
294602,168,168,0,0,0
294638,345,345,0,0,0
294646,259,259,0,0,0
294654,252,252,0,0,0
294659,77,77,0,0,0
294661,402,402,0,0,0
294668,282,282,0,0,0
294669,151,151,0,0,0
294685,44,44,0,0,0
294702,74,74,0,0,0
294729,232,232,0,0,0
294741,2,2,0,0,0
294745,82,82,0,0,0
294759,17,17,0,0,0
294763,255,255,0,0,0
294782,281,281,0,0,0
294784,306,306,0,0,0
294808,76,76,0,0,0
294816,282,282,0,0,0
294820,251,251,0,0,0
294830,310,310,0,0,0
294847,345,345,0,0,0
294852,77,77,0,0,0
294900,198,198,0,0,0
294930,20,20,0,0,0
294936,402,402,0,0,0
294937,306,306,0,0,0
294955,299,299,0,0,0
294971,184,184,0,0,0
294981,70,70,0,0,0
294995,158,158,0,0,0
295010,58,58,0,0,0
295012,246,246,0,0,0
295016,137,137,0,0,0
295053,198,198,0,0,0
295083,313,313,0,0,0
295095,128,128,0,0,0
295096,120,120,0,0,0
295104,282,282,0,0,0
295115,2,2,0,0,0
295155,402,402,0,0,0
295156,114,114,0,0,0
295181,121,121,0,0,0
295191,12,12,0,0,0
295201,113,113,0,0,0
295224,19,19,0,0,0
295227,57,57,0,0,0
295230,66,66,0,0,0
295244,58,58,0,0,0
295247,65,65,0,0,0
295248,255,255,0,0,0
295286,39,39,0,0,0
295292,121,121,0,0,0
295310,18,18,0,0,0
295342,345,345,0,0,0
295365,24,24,0,0,0
295388,345,345,0,0,0
295391,29,29,0,0,0
295392,102,102,0,0,0
295399,36,36,0,0,0
295414,402,402,0,0,0
295415,246,246,0,0,0
295423,180,180,0,0,0
295438,55,55,0,0,0
295455,137,137,0,0,0
295481,252,252,0,0,0
295485,69,69,0,0,0
295488,259,259,0,0,0
295491,101,101,0,0,0
295497,306,306,0,0,0
295542,5,5,0,0,0
295555,315,315,0,0,0
295561,252,252,0,0,0
295577,259,259,0,0,0
295579,102,102,0,0,0
295582,359,359,0,0,0
295586,43,43,0,0,0
295651,131,131,0,0,0
295657,310,310,0,0,0
295680,56,56,0,0,0
295704,171,171,0,0,0
295707,259,259,0,0,0
295721,152,152,0,0,0
295747,152,152,0,0,0
295750,315,315,0,0,0
295766,402,402,0,0,0
295804,7,7,0,0,0
295809,77,77,0,0,0
295824,232,232,0,0,0
295825,75,75,0,0,0
295828,114,114,0,0,0
295830,345,345,0,0,0
295839,137,137,0,0,0
295840,167,167,0,0,0
295863,299,299,0,0,0
295866,137,137,0,0,0
295868,30,30,0,0,0
295890,70,70,0,0,0
295901,23,23,0,0,0
295902,315,315,0,0,0
295904,55,55,0,0,0
295915,168,168,0,0,0
295917,281,281,0,0,0
295932,259,259,0,0,0
295940,27,27,0,0,0
295941,34,34,0,0,0
295955,163,163,0,0,0
295969,252,252,0,0,0
295970,299,299,0,0,0
295972,315,315,0,0,0
295974,255,255,0,0,0
295983,25,25,0,0,0
295988,246,246,0,0,0
295990,281,281,0,0,0
295991,76,76,0,0,0
296004,12,12,0,0,0
296006,97,97,0,0,0
296014,120,120,0,0,0
296017,184,184,0,0,0
296029,310,310,0,0,0
296045,255,255,0,0,0
296065,282,282,0,0,0
296067,310,310,0,0,0
296068,67,67,0,0,0
296074,251,251,0,0,0
296085,281,281,0,0,0
296086,345,345,0,0,0
296113,35,35,0,0,0
296168,306,306,0,0,0
296169,255,255,0,0,0
296183,72,72,0,0,0
296198,402,402,0,0,0
296209,74,74,0,0,0
296213,259,259,0,0,0
296216,18,18,0,0,0
296218,232,232,0,0,0
296226,359,359,0,0,0
296237,72,72,0,0,0
296247,65,65,0,0,0
296282,83,83,0,0,0
296285,44,44,0,0,0
296321,315,315,0,0,0
296323,198,198,0,0,0
296329,201,201,0,0,0
296342,359,359,0,0,0
296347,143,143,0,0,0
296367,201,201,0,0,0
296385,77,77,0,0,0
296387,402,402,0,0,0
296392,35,35,0,0,0
296418,137,137,0,0,0
296457,310,310,0,0,0
296461,402,402,0,0,0
296464,353,353,0,0,0
296487,158,158,0,0,0
296500,131,131,0,0,0
296515,315,315,0,0,0
296517,65,65,0,0,0
296534,255,255,0,0,0
296535,184,184,0,0,0
296538,15,15,0,0,0
296551,246,246,0,0,0
296554,198,198,0,0,0
296565,13,13,0,0,0
296571,131,131,0,0,0
296573,29,29,0,0,0
296576,35,35,0,0,0
296578,359,359,0,0,0
296581,281,281,0,0,0
296584,54,54,0,0,0
296590,71,71,0,0,0
296594,246,246,0,0,0
296616,131,131,0,0,0
296618,144,144,0,0,0
296633,306,306,0,0,0
296649,359,359,0,0,0
296650,9,9,0,0,0
296657,76,76,0,0,0
296659,130,130,0,0,0
296688,57,57,0,0,0
296696,76,76,0,0,0
296699,83,83,0,0,0
296708,39,39,0,0,0
296719,402,402,0,0,0
296720,345,345,0,0,0
296721,259,259,0,0,0
296747,255,255,0,0,0
296772,76,76,0,0,0
296773,77,77,0,0,0
296777,402,402,0,0,0
296778,27,27,0,0,0
296784,315,315,0,0,0
296788,30,30,0,0,0
296793,306,306,0,0,0
296804,74,74,0,0,0
296816,184,184,0,0,0
296826,131,131,0,0,0
296834,144,144,0,0,0
296845,193,193,0,0,0
296867,58,58,0,0,0
296889,114,114,0,0,0
296905,56,56,0,0,0
296928,65,65,0,0,0
296933,85,85,0,0,0
296942,75,75,0,0,0
296943,54,54,0,0,0
296956,152,152,0,0,0
296963,121,121,0,0,0
296979,353,353,0,0,0
297029,83,83,0,0,0
297043,198,198,0,0,0
297054,359,359,0,0,0
297070,282,282,0,0,0
297081,76,76,0,0,0
297102,151,151,0,0,0
297104,131,131,0,0,0
297123,345,345,0,0,0
297127,97,97,0,0,0
297149,114,114,0,0,0
297156,103,103,0,0,0
297178,76,76,0,0,0
297179,39,39,0,0,0
297185,40,40,0,0,0
297203,137,137,0,0,0
297223,345,345,0,0,0
297246,281,281,0,0,0
297252,198,198,0,0,0
297261,246,246,0,0,0
297270,121,121,0,0,0
297273,103,103,0,0,0
297274,180,180,0,0,0
297279,198,198,0,0,0
297288,359,359,0,0,0
297296,101,101,0,0,0
297300,20,20,0,0,0
297302,70,70,0,0,0
297308,345,345,0,0,0
297309,402,402,0,0,0
297319,121,121,0,0,0
297322,345,345,0,0,0
297332,201,201,0,0,0
297344,246,246,0,0,0
297351,353,353,0,0,0
297357,10,10,0,0,0
297373,232,232,0,0,0
297381,310,310,0,0,0
297406,299,299,0,0,0
297407,6,6,0,0,0
297413,15,15,0,0,0
297431,184,184,0,0,0
297441,259,259,0,0,0
297447,101,101,0,0,0
297458,167,167,0,0,0
297478,168,168,0,0,0
297495,45,45,0,0,0
297496,72,72,0,0,0
297508,5,5,0,0,0
297513,259,259,0,0,0
297543,22,22,0,0,0
297566,34,34,0,0,0
297569,315,315,0,0,0
297572,6,6,0,0,0
297590,44,44,0,0,0
297594,114,114,0,0,0
297595,24,24,0,0,0
297599,306,306,0,0,0
297605,74,74,0,0,0
297607,15,15,0,0,0
297610,41,41,0,0,0
297626,83,83,0,0,0
297642,76,76,0,0,0
297645,299,299,0,0,0
297657,87,87,0,0,0
297674,10,10,0,0,0
297737,402,402,0,0,0
297751,10,10,0,0,0
297763,67,67,0,0,0
297791,143,143,0,0,0
297817,163,163,0,0,0
297833,313,313,0,0,0
297842,18,18,0,0,0
297849,310,310,0,0,0
297853,353,353,0,0,0
297860,180,180,0,0,0
297880,83,83,0,0,0
297882,353,353,0,0,0
297903,143,143,0,0,0
297917,252,252,0,0,0
297923,353,353,0,0,0
297927,151,151,0,0,0
297946,121,121,0,0,0
297950,345,345,0,0,0
297974,121,121,0,0,0
297989,232,232,0,0,0
297993,255,255,0,0,0
298014,17,17,0,0,0
298018,315,315,0,0,0
298042,167,167,0,0,0
298051,167,167,0,0,0
298055,306,306,0,0,0
298057,163,163,0,0,0
298084,40,40,0,0,0
298092,102,102,0,0,0
298094,198,198,0,0,0
298098,299,299,0,0,0
298102,315,315,0,0,0
298108,102,102,0,0,0
298120,121,121,0,0,0
298124,255,255,0,0,0
298146,45,45,0,0,0
298153,402,402,0,0,0
298158,353,353,0,0,0
298176,137,137,0,0,0
298198,163,163,0,0,0
298205,114,114,0,0,0
298213,252,252,0,0,0
298225,85,85,0,0,0
298230,306,306,0,0,0
298254,345,345,0,0,0
298256,184,184,0,0,0
298257,310,310,0,0,0
298268,131,131,0,0,0
298299,55,55,0,0,0
298302,232,232,0,0,0
298307,359,359,0,0,0
298314,50,50,0,0,0
298321,77,77,0,0,0
298338,232,232,0,0,0
298341,128,128,0,0,0
298343,152,152,0,0,0
298352,35,35,0,0,0
298353,71,71,0,0,0
298356,137,137,0,0,0
298366,3,3,0,0,0
298377,50,50,0,0,0
298383,82,82,0,0,0
298392,310,310,0,0,0
298395,151,151,0,0,0
298396,310,310,0,0,0
298410,57,57,0,0,0
298413,22,22,0,0,0
298414,251,251,0,0,0
298420,114,114,0,0,0
298444,158,158,0,0,0
298456,24,24,0,0,0
298458,193,193,0,0,0
298459,97,97,0,0,0
298460,198,198,0,0,0
298464,43,43,0,0,0
298471,13,13,0,0,0
298495,193,193,0,0,0
298513,40,40,0,0,0
298532,232,232,0,0,0
298541,137,137,0,0,0
298545,137,137,0,0,0
298554,82,82,0,0,0
298555,168,168,0,0,0
298558,232,232,0,0,0
298578,41,41,0,0,0
298586,6,6,0,0,0
298594,67,67,0,0,0
298632,70,70,0,0,0
298661,6,6,0,0,0
298681,152,152,0,0,0
298682,102,102,0,0,0
298683,34,34,0,0,0
298690,77,77,0,0,0
298693,24,24,0,0,0
298700,82,82,0,0,0
298702,315,315,0,0,0
298729,71,71,0,0,0
298736,193,193,0,0,0
298753,144,144,0,0,0
298774,402,402,0,0,0
298777,310,310,0,0,0
298778,50,50,0,0,0
298791,353,353,0,0,0
298796,35,35,0,0,0
298815,168,168,0,0,0
298816,102,102,0,0,0
298821,137,137,0,0,0
298828,128,128,0,0,0
298838,402,402,0,0,0
298850,2,2,0,0,0
298885,353,353,0,0,0
298896,36,36,0,0,0
298903,313,313,0,0,0
298919,137,137,0,0,0
298923,232,232,0,0,0
298924,137,137,0,0,0
298935,184,184,0,0,0
298960,193,193,0,0,0
298967,282,282,0,0,0
298971,50,50,0,0,0
298972,6,6,0,0,0
298982,5,5,0,0,0
298987,252,252,0,0,0
298988,137,137,0,0,0
298990,137,137,0,0,0
299017,137,137,0,0,0
299018,353,353,0,0,0
299019,180,180,0,0,0
299036,137,137,0,0,0
299038,102,102,0,0,0
299055,180,180,0,0,0
299056,315,315,0,0,0
299072,36,36,0,0,0
299078,16,16,0,0,0
299080,167,167,0,0,0
299081,315,315,0,0,0
299114,402,402,0,0,0
299116,15,15,0,0,0
299120,402,402,0,0,0
299124,76,76,0,0,0
299125,299,299,0,0,0
299133,232,232,0,0,0
299135,255,255,0,0,0
299147,353,353,0,0,0
299148,63,63,0,0,0
299153,114,114,0,0,0
299156,25,25,0,0,0
299168,94,94,0,0,0
299178,315,315,0,0,0
299184,282,282,0,0,0
299220,259,259,0,0,0
299240,137,137,0,0,0
299253,114,114,0,0,0
299259,66,66,0,0,0
299263,299,299,0,0,0
299272,313,313,0,0,0
299274,193,193,0,0,0
299276,50,50,0,0,0
299282,313,313,0,0,0
299294,259,259,0,0,0
299308,353,353,0,0,0
299323,120,120,0,0,0
299332,252,252,0,0,0
299333,359,359,0,0,0
299345,143,143,0,0,0
299356,180,180,0,0,0
299357,103,103,0,0,0
299374,251,251,0,0,0
299388,144,144,0,0,0
299400,97,97,0,0,0
299404,359,359,0,0,0
299405,75,75,0,0,0
299410,353,353,0,0,0
299411,19,19,0,0,0
299414,114,114,0,0,0
299415,313,313,0,0,0
299429,16,16,0,0,0
299432,35,35,0,0,0
299438,10,10,0,0,0
299442,315,315,0,0,0
299472,184,184,0,0,0
299478,25,25,0,0,0
299484,171,171,0,0,0
299507,102,102,0,0,0
299517,57,57,0,0,0
299529,69,69,0,0,0
299538,152,152,0,0,0
299562,66,66,0,0,0
299574,15,15,0,0,0
299585,252,252,0,0,0
299598,103,103,0,0,0
299600,310,310,0,0,0
299611,35,35,0,0,0
299620,402,402,0,0,0
299629,128,128,0,0,0
299639,29,29,0,0,0
299671,3,3,0,0,0
299680,27,27,0,0,0
299684,121,121,0,0,0
299692,113,113,0,0,0
299698,313,313,0,0,0
299701,24,24,0,0,0
299705,402,402,0,0,0
299707,310,310,0,0,0
299727,75,75,0,0,0
299729,306,306,0,0,0
299737,29,29,0,0,0
299741,74,74,0,0,0
299748,56,56,0,0,0
299770,82,82,0,0,0
299777,353,353,0,0,0
299807,402,402,0,0,0
299811,255,255,0,0,0
299815,50,50,0,0,0
299826,22,22,0,0,0
299835,15,15,0,0,0
299838,251,251,0,0,0
299846,87,87,0,0,0
299851,259,259,0,0,0
299863,133,133,0,0,0
299866,310,310,0,0,0
299888,7,7,0,0,0
299895,259,259,0,0,0
299897,3,3,0,0,0
299898,252,252,0,0,0
299908,310,310,0,0,0
299937,151,151,0,0,0
299938,402,402,0,0,0
299946,3,3,0,0,0
299947,353,353,0,0,0
299950,310,310,0,0,0
299951,180,180,0,0,0
299955,259,259,0,0,0
299995,255,255,0,0,0
300000,70,70,0,0,0
300019,2,2,0,0,0
300032,1,1,0,0,0
300047,306,306,0,0,0
300055,144,144,0,0,0
300067,29,29,0,0,0
300072,158,158,0,0,0
300074,402,402,0,0,0
300076,168,168,0,0,0
300093,281,281,0,0,0
300096,87,87,0,0,0
300104,76,76,0,0,0
300116,246,246,0,0,0
300163,168,168,0,0,0
300164,315,315,0,0,0
300199,74,74,0,0,0
300218,63,63,0,0,0
300227,315,315,0,0,0
300230,1,1,0,0,0
300254,82,82,0,0,0
300267,402,402,0,0,0
300275,102,102,0,0,0
300291,76,76,0,0,0
300346,29,29,0,0,0
300352,132,132,0,0,0
300355,44,44,0,0,0
300357,306,306,0,0,0
300397,102,102,0,0,0
300409,359,359,0,0,0
300416,184,184,0,0,0
300429,103,103,0,0,0
300435,310,310,0,0,0
300437,20,20,0,0,0
300442,50,50,0,0,0
300450,121,121,0,0,0
300460,201,201,0,0,0
300461,310,310,0,0,0
300463,76,76,0,0,0
300488,151,151,0,0,0
300494,18,18,0,0,0
300497,70,70,0,0,0
300503,282,282,0,0,0
300533,310,310,0,0,0
300545,12,12,0,0,0
300547,3,3,0,0,0
300562,255,255,0,0,0
300563,8,8,0,0,0
300575,402,402,0,0,0
300585,114,114,0,0,0
300594,251,251,0,0,0
300601,102,102,0,0,0
300627,315,315,0,0,0
300633,130,130,0,0,0
300641,315,315,0,0,0
300658,184,184,0,0,0
300660,101,101,0,0,0
300673,8,8,0,0,0
300675,402,402,0,0,0
300680,306,306,0,0,0
300689,114,114,0,0,0
300701,281,281,0,0,0
300705,102,102,0,0,0
300714,58,58,0,0,0
300728,29,29,0,0,0
300740,66,66,0,0,0
300750,102,102,0,0,0
300751,313,313,0,0,0
300774,180,180,0,0,0
300777,82,82,0,0,0
300779,56,56,0,0,0
300787,2,2,0,0,0
300789,345,345,0,0,0
300795,158,158,0,0,0
300802,58,58,0,0,0
300804,152,152,0,0,0
300806,353,353,0,0,0
300809,168,168,0,0,0
300811,18,18,0,0,0
300827,158,158,0,0,0
300835,232,232,0,0,0
300847,353,353,0,0,0
300855,27,27,0,0,0
300861,8,8,0,0,0
300867,232,232,0,0,0
300878,315,315,0,0,0
300902,353,353,0,0,0
300914,56,56,0,0,0
300939,345,345,0,0,0
300957,41,41,0,0,0
300969,255,255,0,0,0
300989,12,12,0,0,0
300990,193,193,0,0,0
301003,114,114,0,0,0
301011,353,353,0,0,0
301015,402,402,0,0,0
301018,3,3,0,0,0
301029,345,345,0,0,0
301033,306,306,0,0,0
301038,137,137,0,0,0
301042,57,57,0,0,0
301059,120,120,0,0,0
301080,102,102,0,0,0
301094,36,36,0,0,0
301096,310,310,0,0,0
301108,137,137,0,0,0
301125,232,232,0,0,0
301130,17,17,0,0,0
301143,137,137,0,0,0
301150,168,168,0,0,0
301198,310,310,0,0,0
301208,353,353,0,0,0
301211,163,163,0,0,0
301226,353,353,0,0,0
301229,259,259,0,0,0
301248,255,255,0,0,0
301266,11,11,0,0,0
301268,151,151,0,0,0
301282,114,114,0,0,0
301294,282,282,0,0,0
301299,193,193,0,0,0
301303,34,34,0,0,0
301304,74,74,0,0,0
301311,163,163,0,0,0
301316,281,281,0,0,0
301328,137,137,0,0,0
301341,232,232,0,0,0
301345,151,151,0,0,0
301364,45,45,0,0,0
301401,72,72,0,0,0
301422,353,353,0,0,0
301432,102,102,0,0,0
301433,310,310,0,0,0
301443,359,359,0,0,0
301448,151,151,0,0,0
301457,94,94,0,0,0
301460,168,168,0,0,0
301463,16,16,0,0,0
301466,232,232,0,0,0
301494,20,20,0,0,0
301499,299,299,0,0,0
301531,63,63,0,0,0
301543,24,24,0,0,0
301550,72,72,0,0,0
301555,259,259,0,0,0
301561,144,144,0,0,0
301569,114,114,0,0,0
301613,58,58,0,0,0
301618,168,168,0,0,0
301622,72,72,0,0,0
301624,43,43,0,0,0
301630,128,128,0,0,0
301635,255,255,0,0,0
301636,113,113,0,0,0
301648,345,345,0,0,0
301649,168,168,0,0,0
301654,130,130,0,0,0
301661,39,39,0,0,0
301673,359,359,0,0,0
301694,74,74,0,0,0
301696,168,168,0,0,0
301704,158,158,0,0,0
301715,299,299,0,0,0
301722,102,102,0,0,0
301725,27,27,0,0,0
301730,310,310,0,0,0
301733,310,310,0,0,0
301737,198,198,0,0,0
301744,6,6,0,0,0
301764,114,114,0,0,0
301782,3,3,0,0,0
301783,353,353,0,0,0
301835,75,75,0,0,0
301840,121,121,0,0,0
301870,345,345,0,0,0
301898,102,102,0,0,0
301900,402,402,0,0,0
301913,171,171,0,0,0
301926,102,102,0,0,0
301935,353,353,0,0,0
301939,143,143,0,0,0
301940,67,67,0,0,0
301946,345,345,0,0,0
301948,151,151,0,0,0
301991,4,4,0,0,0
301998,144,144,0,0,0
302006,353,353,0,0,0
302007,353,353,0,0,0
302025,310,310,0,0,0
302034,63,63,0,0,0
302054,36,36,0,0,0
302058,144,144,0,0,0
302065,281,281,0,0,0
302067,259,259,0,0,0
302095,252,252,0,0,0
302101,102,102,0,0,0
302114,27,27,0,0,0
302138,120,120,0,0,0
302173,299,299,0,0,0
302208,50,50,0,0,0
302224,193,193,0,0,0
302228,306,306,0,0,0
302246,282,282,0,0,0
302266,345,345,0,0,0
302317,12,12,0,0,0
302357,121,121,0,0,0
302365,255,255,0,0,0
302370,50,50,0,0,0
302377,315,315,0,0,0
302397,402,402,0,0,0
302398,44,44,0,0,0
302406,137,137,0,0,0
302412,65,65,0,0,0
302425,76,76,0,0,0
302431,171,171,0,0,0
302432,402,402,0,0,0
302442,102,102,0,0,0
302452,359,359,0,0,0
302480,201,201,0,0,0
302483,15,15,0,0,0
302505,113,113,0,0,0
302514,259,259,0,0,0
302527,168,168,0,0,0
302535,345,345,0,0,0
302540,184,184,0,0,0
302542,45,45,0,0,0
302546,27,27,0,0,0
302563,151,151,0,0,0
302579,20,20,0,0,0
302581,158,158,0,0,0
302595,306,306,0,0,0
302599,29,29,0,0,0
302614,94,94,0,0,0
302621,402,402,0,0,0
302623,8,8,0,0,0
302628,114,114,0,0,0
302629,299,299,0,0,0
302652,259,259,0,0,0
302686,152,152,0,0,0
302702,6,6,0,0,0
302713,306,306,0,0,0
302723,359,359,0,0,0
302726,168,168,0,0,0
302736,255,255,0,0,0
302779,353,353,0,0,0
302797,251,251,0,0,0
302799,4,4,0,0,0
302807,282,282,0,0,0
302830,76,76,0,0,0
302843,232,232,0,0,0
302876,114,114,0,0,0
302886,29,29,0,0,0
302893,282,282,0,0,0
302907,171,171,0,0,0
302919,121,121,0,0,0
302927,259,259,0,0,0
302931,76,76,0,0,0
302934,77,77,0,0,0
302945,151,151,0,0,0
302953,70,70,0,0,0
302955,102,102,0,0,0
302968,180,180,0,0,0
302972,144,144,0,0,0
302973,29,29,0,0,0
302975,306,306,0,0,0
302976,310,310,0,0,0
302981,137,137,0,0,0
303007,282,282,0,0,0
303008,27,27,0,0,0
303029,74,74,0,0,0
303033,137,137,0,0,0
303037,11,11,0,0,0
303056,70,70,0,0,0
303078,299,299,0,0,0
303087,359,359,0,0,0
303097,121,121,0,0,0
303099,313,313,0,0,0
303104,310,310,0,0,0
303116,152,152,0,0,0
303122,180,180,0,0,0
303124,44,44,0,0,0
303139,85,85,0,0,0
303158,359,359,0,0,0
303177,67,67,0,0,0
303183,201,201,0,0,0
303188,251,251,0,0,0
303198,167,167,0,0,0
303206,13,13,0,0,0
303213,18,18,0,0,0
303219,310,310,0,0,0
303247,251,251,0,0,0
303276,87,87,0,0,0
303277,1,1,0,0,0
303286,102,102,0,0,0
303291,22,22,0,0,0
303298,77,77,0,0,0
303303,251,251,0,0,0
303306,299,299,0,0,0
303311,252,252,0,0,0
303314,345,345,0,0,0
303341,72,72,0,0,0
303358,132,132,0,0,0
303365,313,313,0,0,0
303378,120,120,0,0,0
303380,299,299,0,0,0
303389,24,24,0,0,0
303408,198,198,0,0,0
303415,232,232,0,0,0
303416,251,251,0,0,0
303428,74,74,0,0,0
303432,19,19,0,0,0
303437,246,246,0,0,0
303454,313,313,0,0,0
303482,282,282,0,0,0
303510,69,69,0,0,0
303514,306,306,0,0,0
303515,63,63,0,0,0
303529,36,36,0,0,0
303530,310,310,0,0,0
303531,121,121,0,0,0
303552,310,310,0,0,0
303578,299,299,0,0,0
303589,16,16,0,0,0
303595,180,180,0,0,0
303597,184,184,0,0,0
303636,184,184,0,0,0
303639,55,55,0,0,0
303646,171,171,0,0,0
303652,113,113,0,0,0
303659,17,17,0,0,0
303663,121,121,0,0,0
303670,246,246,0,0,0
303681,255,255,0,0,0
303690,310,310,0,0,0
303723,114,114,0,0,0
303724,15,15,0,0,0
303732,58,58,0,0,0
303737,198,198,0,0,0
303740,359,359,0,0,0
303742,232,232,0,0,0
303745,359,359,0,0,0
303750,57,57,0,0,0
303781,82,82,0,0,0
303799,11,11,0,0,0
303827,252,252,0,0,0
303851,359,359,0,0,0
303852,17,17,0,0,0
303858,313,313,0,0,0
303861,353,353,0,0,0
303873,57,57,0,0,0
303879,76,76,0,0,0
303880,50,50,0,0,0
303901,143,143,0,0,0
303908,315,315,0,0,0
303911,144,144,0,0,0
303915,69,69,0,0,0
303933,83,83,0,0,0
303934,76,76,0,0,0
303943,345,345,0,0,0
303949,281,281,0,0,0
303964,402,402,0,0,0
303975,24,24,0,0,0
303985,184,184,0,0,0
303991,151,151,0,0,0
303995,19,19,0,0,0
304012,121,121,0,0,0
304025,143,143,0,0,0
304054,180,180,0,0,0
304081,402,402,0,0,0
304082,232,232,0,0,0
304083,128,128,0,0,0
304084,259,259,0,0,0
304092,3,3,0,0,0
304100,137,137,0,0,0
304108,101,101,0,0,0
304109,77,77,0,0,0
304116,353,353,0,0,0
304117,255,255,0,0,0
304134,144,144,0,0,0
304146,83,83,0,0,0
304160,144,144,0,0,0
304173,17,17,0,0,0
304180,313,313,0,0,0
304189,255,255,0,0,0
304190,9,9,0,0,0
304213,246,246,0,0,0
304215,251,251,0,0,0
304235,345,345,0,0,0
304264,97,97,0,0,0
304273,180,180,0,0,0
304279,8,8,0,0,0
304296,152,152,0,0,0
304304,58,58,0,0,0
304307,24,24,0,0,0
304309,97,97,0,0,0
304315,252,252,0,0,0
304316,5,5,0,0,0
304319,353,353,0,0,0
304338,20,20,0,0,0
304361,54,54,0,0,0
304364,402,402,0,0,0
304374,281,281,0,0,0
304375,158,158,0,0,0
304382,255,255,0,0,0
304400,15,15,0,0,0
304401,313,313,0,0,0
304404,168,168,0,0,0
304405,251,251,0,0,0
304420,299,299,0,0,0
304426,306,306,0,0,0
304433,252,252,0,0,0
304438,246,246,0,0,0
304451,50,50,0,0,0
304455,137,137,0,0,0
304458,180,180,0,0,0
304461,310,310,0,0,0
304466,402,402,0,0,0
304472,402,402,0,0,0
304473,137,137,0,0,0
304477,167,167,0,0,0
304478,137,137,0,0,0
304490,306,306,0,0,0
304493,402,402,0,0,0
304523,102,102,0,0,0
304524,282,282,0,0,0
304542,246,246,0,0,0
304547,7,7,0,0,0
304566,19,19,0,0,0
304568,15,15,0,0,0
304573,252,252,0,0,0
304580,102,102,0,0,0
304581,359,359,0,0,0
304599,44,44,0,0,0
304610,359,359,0,0,0
304613,76,76,0,0,0
304627,21,21,0,0,0
304628,77,77,0,0,0
304640,133,133,0,0,0
304643,143,143,0,0,0
304649,171,171,0,0,0
304650,13,13,0,0,0
304659,17,17,0,0,0
304670,40,40,0,0,0
304678,252,252,0,0,0
304681,193,193,0,0,0
304684,306,306,0,0,0
304719,345,345,0,0,0
304723,345,345,0,0,0
304761,94,94,0,0,0
304762,77,77,0,0,0
304766,313,313,0,0,0
304774,163,163,0,0,0
304775,18,18,0,0,0
304776,76,76,0,0,0
304777,121,121,0,0,0
304781,345,345,0,0,0
304783,24,24,0,0,0
304788,44,44,0,0,0
304797,353,353,0,0,0
304806,132,132,0,0,0
304809,345,345,0,0,0
304833,4,4,0,0,0
304842,82,82,0,0,0
304844,359,359,0,0,0
304854,114,114,0,0,0
304856,402,402,0,0,0
304877,151,151,0,0,0
304888,315,315,0,0,0
304890,35,35,0,0,0
304907,402,402,0,0,0
304915,168,168,0,0,0
304916,152,152,0,0,0
304920,359,359,0,0,0
304927,180,180,0,0,0
304937,313,313,0,0,0
304948,94,94,0,0,0
304957,281,281,0,0,0
304970,113,113,0,0,0
304990,50,50,0,0,0
305021,315,315,0,0,0
305036,97,97,0,0,0
305073,171,171,0,0,0
305105,252,252,0,0,0
305108,44,44,0,0,0
305112,359,359,0,0,0
305122,7,7,0,0,0
305137,65,65,0,0,0
305142,36,36,0,0,0
305158,69,69,0,0,0
305161,306,306,0,0,0
305167,74,74,0,0,0
305175,83,83,0,0,0
305179,121,121,0,0,0
305180,76,76,0,0,0
305187,306,306,0,0,0
305191,22,22,0,0,0
305200,35,35,0,0,0
305205,353,353,0,0,0
305225,252,252,0,0,0
305227,402,402,0,0,0
305238,306,306,0,0,0
305288,251,251,0,0,0
305299,11,11,0,0,0
305307,137,137,0,0,0
305331,137,137,0,0,0
305355,69,69,0,0,0
305361,402,402,0,0,0
305362,69,69,0,0,0
305376,36,36,0,0,0
305395,102,102,0,0,0
305402,74,74,0,0,0
305405,58,58,0,0,0
305409,151,151,0,0,0
305419,137,137,0,0,0
305433,113,113,0,0,0
305447,43,43,0,0,0
305457,121,121,0,0,0
305473,25,25,0,0,0
305475,201,201,0,0,0
305479,259,259,0,0,0
305484,359,359,0,0,0
305489,113,113,0,0,0
305504,102,102,0,0,0
305530,131,131,0,0,0
305532,102,102,0,0,0
305539,345,345,0,0,0
305540,167,167,0,0,0
305545,306,306,0,0,0
305548,402,402,0,0,0
305549,299,299,0,0,0
305550,15,15,0,0,0
305553,171,171,0,0,0
305562,282,282,0,0,0
305563,255,255,0,0,0
305569,152,152,0,0,0
305575,281,281,0,0,0
305606,74,74,0,0,0
305607,137,137,0,0,0
305626,315,315,0,0,0
305629,132,132,0,0,0
305632,232,232,0,0,0
305638,282,282,0,0,0
305655,70,70,0,0,0
305657,102,102,0,0,0
305662,251,251,0,0,0
305668,232,232,0,0,0
305674,313,313,0,0,0
305682,85,85,0,0,0
305691,35,35,0,0,0
305710,168,168,0,0,0
305711,32,32,0,0,0
305714,299,299,0,0,0
305718,299,299,0,0,0
305728,2,2,0,0,0
305733,353,353,0,0,0
305748,75,75,0,0,0
305764,152,152,0,0,0
305769,20,20,0,0,0
305774,315,315,0,0,0
305778,255,255,0,0,0
305790,75,75,0,0,0
305801,75,75,0,0,0
305812,121,121,0,0,0
305866,144,144,0,0,0
305893,128,128,0,0,0
305901,85,85,0,0,0
305904,402,402,0,0,0
305915,193,193,0,0,0
305916,313,313,0,0,0
305920,102,102,0,0,0
305921,246,246,0,0,0
305939,66,66,0,0,0
305945,15,15,0,0,0
305958,198,198,0,0,0
305963,97,97,0,0,0
305970,299,299,0,0,0
305975,137,137,0,0,0
305989,77,77,0,0,0
305999,102,102,0,0,0
306009,299,299,0,0,0
306033,94,94,0,0,0
306041,402,402,0,0,0
306045,94,94,0,0,0
306060,128,128,0,0,0
306073,94,94,0,0,0
306077,132,132,0,0,0
306086,246,246,0,0,0
306090,56,56,0,0,0
306097,281,281,0,0,0
306099,201,201,0,0,0
306123,16,16,0,0,0
306143,152,152,0,0,0
306153,310,310,0,0,0
306159,45,45,0,0,0
306172,76,76,0,0,0
306191,167,167,0,0,0
306246,402,402,0,0,0
306250,310,310,0,0,0
306272,24,24,0,0,0
306285,1,1,0,0,0
306289,201,201,0,0,0
306290,87,87,0,0,0
306297,252,252,0,0,0
306320,102,102,0,0,0
306333,151,151,0,0,0
306334,1,1,0,0,0
306364,67,67,0,0,0
306377,345,345,0,0,0
306380,144,144,0,0,0
306415,184,184,0,0,0
306429,402,402,0,0,0
306444,65,65,0,0,0
306450,44,44,0,0,0
306453,345,345,0,0,0
306472,310,310,0,0,0
306475,315,315,0,0,0
306508,310,310,0,0,0
306518,359,359,0,0,0
306520,75,75,0,0,0
306521,232,232,0,0,0
306522,353,353,0,0,0
306533,14,14,0,0,0
306546,315,315,0,0,0
306550,87,87,0,0,0
306556,143,143,0,0,0
306558,19,19,0,0,0
306559,121,121,0,0,0
306568,310,310,0,0,0
306575,74,74,0,0,0
306576,306,306,0,0,0
306583,128,128,0,0,0
306607,133,133,0,0,0
306613,246,246,0,0,0
306626,76,76,0,0,0
306633,353,353,0,0,0
306643,232,232,0,0,0
306663,12,12,0,0,0
306669,310,310,0,0,0
306671,20,20,0,0,0
306688,306,306,0,0,0
306707,359,359,0,0,0
306709,70,70,0,0,0
306720,56,56,0,0,0
306724,63,63,0,0,0
306728,252,252,0,0,0
306742,102,102,0,0,0
306750,4,4,0,0,0
306751,152,152,0,0,0
306764,144,144,0,0,0
306767,58,58,0,0,0
306780,2,2,0,0,0
306783,193,193,0,0,0
306792,102,102,0,0,0
306813,121,121,0,0,0
306817,402,402,0,0,0
306821,6,6,0,0,0
306829,345,345,0,0,0
306831,6,6,0,0,0
306839,27,27,0,0,0
306855,10,10,0,0,0
306866,246,246,0,0,0
306868,184,184,0,0,0
306872,32,32,0,0,0
306881,198,198,0,0,0
306894,171,171,0,0,0
306912,6,6,0,0,0
306917,310,310,0,0,0
306935,180,180,0,0,0
306946,168,168,0,0,0
306947,74,74,0,0,0
306949,20,20,0,0,0
306960,128,128,0,0,0
306964,167,167,0,0,0
306965,77,77,0,0,0
306973,246,246,0,0,0
306989,102,102,0,0,0
307000,114,114,0,0,0
307006,306,306,0,0,0
307020,137,137,0,0,0
307030,29,29,0,0,0
307034,313,313,0,0,0
307076,128,128,0,0,0
307090,34,34,0,0,0
307099,74,74,0,0,0
307114,130,130,0,0,0
307159,168,168,0,0,0
307169,313,313,0,0,0
307170,167,167,0,0,0
307182,137,137,0,0,0
307186,252,252,0,0,0
307194,306,306,0,0,0
307195,15,15,0,0,0
307196,76,76,0,0,0
307215,184,184,0,0,0
307219,251,251,0,0,0
307231,7,7,0,0,0
307232,359,359,0,0,0
307243,353,353,0,0,0
307248,310,310,0,0,0
307251,7,7,0,0,0
307254,251,251,0,0,0
307267,76,76,0,0,0
307275,101,101,0,0,0
307296,171,171,0,0,0
307307,72,72,0,0,0
307309,24,24,0,0,0
307349,83,83,0,0,0
307353,313,313,0,0,0
307370,252,252,0,0,0
307381,4,4,0,0,0
307403,103,103,0,0,0
307407,310,310,0,0,0
307414,85,85,0,0,0
307453,101,101,0,0,0
307461,152,152,0,0,0
307462,359,359,0,0,0
307463,171,171,0,0,0
307468,232,232,0,0,0
307469,17,17,0,0,0
307491,120,120,0,0,0
307519,232,232,0,0,0
307530,315,315,0,0,0
307587,11,11,0,0,0
307589,259,259,0,0,0
307602,201,201,0,0,0
307604,310,310,0,0,0
307635,281,281,0,0,0
307654,315,315,0,0,0
307662,103,103,0,0,0
307663,313,313,0,0,0
307676,158,158,0,0,0
307708,353,353,0,0,0
307709,6,6,0,0,0
307727,74,74,0,0,0
307729,359,359,0,0,0
307763,251,251,0,0,0
307765,144,144,0,0,0
307772,36,36,0,0,0
307774,10,10,0,0,0
307784,167,167,0,0,0
307806,9,9,0,0,0
307812,75,75,0,0,0
307820,402,402,0,0,0
307829,114,114,0,0,0
307830,101,101,0,0,0
307831,24,24,0,0,0
307834,3,3,0,0,0
307835,168,168,0,0,0
307850,29,29,0,0,0
307852,201,201,0,0,0
307859,72,72,0,0,0
307871,113,113,0,0,0
307908,19,19,0,0,0
307938,2,2,0,0,0
307940,71,71,0,0,0
307947,180,180,0,0,0
307984,1,1,0,0,0
307987,252,252,0,0,0
307991,5,5,0,0,0
307998,70,70,0,0,0
308009,306,306,0,0,0
308017,25,25,0,0,0
308038,151,151,0,0,0
308040,306,306,0,0,0
308057,29,29,0,0,0
308075,3,3,0,0,0
308086,43,43,0,0,0
308092,252,252,0,0,0
308099,402,402,0,0,0
308105,144,144,0,0,0
308106,232,232,0,0,0
308122,85,85,0,0,0
308132,345,345,0,0,0
308136,198,198,0,0,0
308170,255,255,0,0,0
308176,281,281,0,0,0
308191,102,102,0,0,0
308198,102,102,0,0,0
308206,310,310,0,0,0
308223,310,310,0,0,0
308224,3,3,0,0,0
308256,121,121,0,0,0
308262,151,151,0,0,0
308270,232,232,0,0,0
308286,201,201,0,0,0
308292,198,198,0,0,0
308296,11,11,0,0,0
308298,12,12,0,0,0
308304,171,171,0,0,0
308309,259,259,0,0,0
308326,30,30,0,0,0
308333,102,102,0,0,0
308347,121,121,0,0,0
308363,359,359,0,0,0
308370,113,113,0,0,0
308402,313,313,0,0,0
308405,94,94,0,0,0
308474,35,35,0,0,0
308488,315,315,0,0,0
308490,306,306,0,0,0
308496,281,281,0,0,0
308510,184,184,0,0,0
308512,43,43,0,0,0
308519,77,77,0,0,0
308525,15,15,0,0,0
308528,310,310,0,0,0
308542,120,120,0,0,0
308557,259,259,0,0,0
308578,128,128,0,0,0
308580,74,74,0,0,0
308608,359,359,0,0,0
308612,74,74,0,0,0
308623,12,12,0,0,0
308624,70,70,0,0,0
308652,281,281,0,0,0
308654,94,94,0,0,0
308661,353,353,0,0,0
308663,299,299,0,0,0
308689,402,402,0,0,0
308704,151,151,0,0,0
308717,359,359,0,0,0
308720,44,44,0,0,0
308736,402,402,0,0,0
308738,345,345,0,0,0
308753,306,306,0,0,0
308764,1,1,0,0,0
308768,133,133,0,0,0
308777,24,24,0,0,0
308793,345,345,0,0,0
308819,102,102,0,0,0
308848,5,5,0,0,0
308868,131,131,0,0,0
308880,345,345,0,0,0
308896,251,251,0,0,0
308898,184,184,0,0,0
308901,113,113,0,0,0
308922,18,18,0,0,0
308928,50,50,0,0,0
308933,201,201,0,0,0
308957,151,151,0,0,0
308967,20,20,0,0,0
309002,163,163,0,0,0
309011,255,255,0,0,0
309013,74,74,0,0,0
309015,255,255,0,0,0
309038,114,114,0,0,0
309056,315,315,0,0,0
309090,282,282,0,0,0
309112,131,131,0,0,0
309114,282,282,0,0,0
309120,402,402,0,0,0
309148,345,345,0,0,0
309158,152,152,0,0,0
309172,168,168,0,0,0
309190,251,251,0,0,0
309197,255,255,0,0,0
309206,43,43,0,0,0
309215,57,57,0,0,0
309247,345,345,0,0,0
309248,281,281,0,0,0
309263,39,39,0,0,0
309277,402,402,0,0,0
309308,152,152,0,0,0
309325,39,39,0,0,0
309329,310,310,0,0,0
309343,171,171,0,0,0
309346,353,353,0,0,0
309387,281,281,0,0,0
309401,168,168,0,0,0
309413,121,121,0,0,0
309419,143,143,0,0,0
309445,353,353,0,0,0
309460,94,94,0,0,0
309461,133,133,0,0,0
309473,315,315,0,0,0
309479,137,137,0,0,0
309497,306,306,0,0,0
309501,50,50,0,0,0
309507,180,180,0,0,0
309511,71,71,0,0,0
309512,103,103,0,0,0
309517,82,82,0,0,0
309545,310,310,0,0,0
309551,313,313,0,0,0
309562,76,76,0,0,0
309572,359,359,0,0,0
309573,8,8,0,0,0
309582,252,252,0,0,0
309586,259,259,0,0,0
309596,315,315,0,0,0
309602,201,201,0,0,0
309614,34,34,0,0,0
309634,66,66,0,0,0
309640,133,133,0,0,0
309643,282,282,0,0,0
309658,251,251,0,0,0
309672,246,246,0,0,0
309677,20,20,0,0,0
309695,85,85,0,0,0
309702,281,281,0,0,0
309718,345,345,0,0,0
309725,44,44,0,0,0
309752,193,193,0,0,0
309769,66,66,0,0,0
309783,11,11,0,0,0
309784,69,69,0,0,0
309786,281,281,0,0,0
309790,167,167,0,0,0
309798,158,158,0,0,0
309805,353,353,0,0,0
309831,151,151,0,0,0
309875,85,85,0,0,0
309884,2,2,0,0,0
309905,201,201,0,0,0
309911,315,315,0,0,0
309925,315,315,0,0,0
309934,282,282,0,0,0
309947,71,71,0,0,0
309963,101,101,0,0,0
309975,251,251,0,0,0
310009,133,133,0,0,0
310015,74,74,0,0,0
310021,310,310,0,0,0
310041,251,251,0,0,0
310063,198,198,0,0,0
310075,130,130,0,0,0
310076,25,25,0,0,0
310090,137,137,0,0,0
310097,85,85,0,0,0
310102,193,193,0,0,0
310111,306,306,0,0,0
310138,180,180,0,0,0
310146,56,56,0,0,0
310160,44,44,0,0,0
310169,171,171,0,0,0
310211,130,130,0,0,0
310228,121,121,0,0,0
310229,9,9,0,0,0
310252,103,103,0,0,0
310268,12,12,0,0,0
310285,36,36,0,0,0
310323,29,29,0,0,0
310332,133,133,0,0,0
310335,74,74,0,0,0
310340,43,43,0,0,0
310341,313,313,0,0,0
310374,20,20,0,0,0
310378,158,158,0,0,0
310398,74,74,0,0,0
310399,281,281,0,0,0
310406,71,71,0,0,0
310417,306,306,0,0,0
310424,113,113,0,0,0
310439,18,18,0,0,0
310440,252,252,0,0,0
310443,180,180,0,0,0
310449,167,167,0,0,0
310453,313,313,0,0,0
310454,281,281,0,0,0
310462,402,402,0,0,0
310515,74,74,0,0,0
310532,310,310,0,0,0
310535,252,252,0,0,0
310536,74,74,0,0,0
310540,246,246,0,0,0
310560,281,281,0,0,0
310563,353,353,0,0,0
310575,252,252,0,0,0
310600,120,120,0,0,0
310604,353,353,0,0,0
310605,251,251,0,0,0
310614,359,359,0,0,0
310619,158,158,0,0,0
310631,39,39,0,0,0
310635,345,345,0,0,0
310636,310,310,0,0,0
310642,7,7,0,0,0
310662,171,171,0,0,0
310681,8,8,0,0,0
310709,315,315,0,0,0
310712,137,137,0,0,0
310713,23,23,0,0,0
310738,7,7,0,0,0
310740,137,137,0,0,0
310745,251,251,0,0,0
310746,87,87,0,0,0
310756,25,25,0,0,0
310762,63,63,0,0,0
310773,133,133,0,0,0
310809,101,101,0,0,0
310812,259,259,0,0,0
310829,281,281,0,0,0
310843,198,198,0,0,0
310844,151,151,0,0,0
310864,193,193,0,0,0
310870,193,193,0,0,0
310871,56,56,0,0,0
310887,168,168,0,0,0
310895,158,158,0,0,0
310902,130,130,0,0,0
310919,171,171,0,0,0
310928,345,345,0,0,0
310930,77,77,0,0,0
310942,255,255,0,0,0
310954,402,402,0,0,0
310960,76,76,0,0,0
310963,32,32,0,0,0
310968,232,232,0,0,0
310998,232,232,0,0,0
311019,101,101,0,0,0
311021,9,9,0,0,0
311026,151,151,0,0,0
311035,144,144,0,0,0
311044,345,345,0,0,0
311071,40,40,0,0,0
311074,299,299,0,0,0
311102,6,6,0,0,0
311124,313,313,0,0,0
311126,315,315,0,0,0
311154,74,74,0,0,0
311168,168,168,0,0,0
311171,102,102,0,0,0
311179,310,310,0,0,0
311201,133,133,0,0,0
311204,102,102,0,0,0
311216,252,252,0,0,0
311236,15,15,0,0,0
311241,35,35,0,0,0
311252,5,5,0,0,0
311262,121,121,0,0,0
311278,252,252,0,0,0
311293,167,167,0,0,0
311313,128,128,0,0,0
311321,17,17,0,0,0
311324,158,158,0,0,0
311343,121,121,0,0,0
311351,121,121,0,0,0
311358,359,359,0,0,0
311410,259,259,0,0,0
311416,359,359,0,0,0
311430,163,163,0,0,0
311433,299,299,0,0,0
311434,152,152,0,0,0
311451,167,167,0,0,0
311460,402,402,0,0,0
311463,306,306,0,0,0
311491,56,56,0,0,0
311506,345,345,0,0,0
311524,137,137,0,0,0
311527,77,77,0,0,0
311536,55,55,0,0,0
311548,281,281,0,0,0
311560,32,32,0,0,0
311563,144,144,0,0,0
311578,163,163,0,0,0
311603,103,103,0,0,0
311626,359,359,0,0,0
311628,130,130,0,0,0
311636,167,167,0,0,0
311643,255,255,0,0,0
311678,255,255,0,0,0
311684,313,313,0,0,0
311694,310,310,0,0,0
311716,17,17,0,0,0
311731,58,58,0,0,0
311732,71,71,0,0,0
311758,282,282,0,0,0
311774,63,63,0,0,0
311775,232,232,0,0,0
311777,137,137,0,0,0
311789,193,193,0,0,0
311808,36,36,0,0,0
311832,151,151,0,0,0
311856,402,402,0,0,0
311861,193,193,0,0,0
311869,29,29,0,0,0
311874,70,70,0,0,0
311878,72,72,0,0,0
311880,315,315,0,0,0
311881,137,137,0,0,0
311893,171,171,0,0,0
311898,44,44,0,0,0
311901,184,184,0,0,0
311906,14,14,0,0,0
311911,313,313,0,0,0
311923,152,152,0,0,0
311934,313,313,0,0,0
311941,255,255,0,0,0
311943,201,201,0,0,0
311946,299,299,0,0,0
311953,198,198,0,0,0
311960,67,67,0,0,0
311966,34,34,0,0,0
311988,306,306,0,0,0
311994,44,44,0,0,0
312012,299,299,0,0,0
312042,171,171,0,0,0
312049,75,75,0,0,0
312057,259,259,0,0,0
312064,121,121,0,0,0
312071,345,345,0,0,0
312087,171,171,0,0,0
312098,82,82,0,0,0
312099,259,259,0,0,0
312118,56,56,0,0,0
312121,299,299,0,0,0
312129,121,121,0,0,0
312131,18,18,0,0,0
312138,6,6,0,0,0
312151,315,315,0,0,0
312168,281,281,0,0,0
312172,402,402,0,0,0
312175,8,8,0,0,0
312188,255,255,0,0,0
312191,56,56,0,0,0
312236,353,353,0,0,0
312246,246,246,0,0,0
312251,402,402,0,0,0
312302,16,16,0,0,0
312323,14,14,0,0,0
312332,120,120,0,0,0
312333,151,151,0,0,0
312346,25,25,0,0,0
312362,193,193,0,0,0
312376,34,34,0,0,0
312378,72,72,0,0,0
312380,198,198,0,0,0
312389,76,76,0,0,0
312390,143,143,0,0,0
312405,259,259,0,0,0
312410,198,198,0,0,0
312414,171,171,0,0,0
312429,15,15,0,0,0
312442,7,7,0,0,0
312450,251,251,0,0,0
312459,13,13,0,0,0
312466,82,82,0,0,0
312479,54,54,0,0,0
312483,10,10,0,0,0
312487,54,54,0,0,0
312501,359,359,0,0,0
312511,65,65,0,0,0
312523,113,113,0,0,0
312532,63,63,0,0,0
312553,3,3,0,0,0
312555,45,45,0,0,0
312558,66,66,0,0,0
312567,168,168,0,0,0
312585,152,152,0,0,0
312590,171,171,0,0,0
312592,113,113,0,0,0
312604,313,313,0,0,0
312618,36,36,0,0,0
312633,82,82,0,0,0
312639,359,359,0,0,0
312646,70,70,0,0,0
312654,87,87,0,0,0
312658,133,133,0,0,0
312667,114,114,0,0,0
312671,13,13,0,0,0
312688,402,402,0,0,0
312691,94,94,0,0,0
312693,259,259,0,0,0
312694,345,345,0,0,0
312696,198,198,0,0,0
312698,144,144,0,0,0
312699,20,20,0,0,0
312742,36,36,0,0,0
312744,252,252,0,0,0
312749,72,72,0,0,0
312751,44,44,0,0,0
312754,168,168,0,0,0
312776,255,255,0,0,0
312797,359,359,0,0,0
312799,306,306,0,0,0
312811,3,3,0,0,0
312814,36,36,0,0,0
312838,313,313,0,0,0
312843,82,82,0,0,0
312845,137,137,0,0,0
312846,306,306,0,0,0
312849,114,114,0,0,0
312870,193,193,0,0,0
312874,198,198,0,0,0
312890,3,3,0,0,0
312896,7,7,0,0,0
312905,36,36,0,0,0
312928,41,41,0,0,0
312976,171,171,0,0,0
312982,72,72,0,0,0
312986,353,353,0,0,0
313014,299,299,0,0,0
313062,255,255,0,0,0
313069,345,345,0,0,0
313070,345,345,0,0,0
313094,313,313,0,0,0
313101,168,168,0,0,0
313109,69,69,0,0,0
313132,22,22,0,0,0
313156,137,137,0,0,0
313159,281,281,0,0,0
313172,83,83,0,0,0
313192,8,8,0,0,0
313200,306,306,0,0,0
313253,121,121,0,0,0
313257,36,36,0,0,0
313259,144,144,0,0,0
313263,87,87,0,0,0
313271,76,76,0,0,0
313272,251,251,0,0,0
313275,74,74,0,0,0
313290,193,193,0,0,0
313292,402,402,0,0,0
313298,128,128,0,0,0
313300,313,313,0,0,0
313305,130,130,0,0,0
313313,65,65,0,0,0
313323,24,24,0,0,0
313330,353,353,0,0,0
313351,70,70,0,0,0
313363,50,50,0,0,0
313384,353,353,0,0,0
313391,30,30,0,0,0
313436,85,85,0,0,0
313451,402,402,0,0,0
313459,310,310,0,0,0
313478,359,359,0,0,0
313497,137,137,0,0,0
313500,24,24,0,0,0
313532,103,103,0,0,0
313540,201,201,0,0,0
313547,121,121,0,0,0
313557,103,103,0,0,0
313559,168,168,0,0,0
313603,102,102,0,0,0
313604,83,83,0,0,0
313650,345,345,0,0,0
313655,353,353,0,0,0
313664,180,180,0,0,0
313683,9,9,0,0,0
313689,180,180,0,0,0
313692,193,193,0,0,0
313713,232,232,0,0,0
313720,76,76,0,0,0
313742,57,57,0,0,0
313764,72,72,0,0,0
313765,143,143,0,0,0
313773,137,137,0,0,0
313780,3,3,0,0,0
313781,282,282,0,0,0
313790,281,281,0,0,0
313808,76,76,0,0,0
313832,167,167,0,0,0
313833,281,281,0,0,0
313845,76,76,0,0,0
313846,70,70,0,0,0
313852,54,54,0,0,0
313858,402,402,0,0,0
313877,102,102,0,0,0
313892,32,32,0,0,0
313907,252,252,0,0,0
313915,402,402,0,0,0
313927,345,345,0,0,0
313935,12,12,0,0,0
313938,83,83,0,0,0
313939,69,69,0,0,0
313955,27,27,0,0,0
313969,34,34,0,0,0
313971,56,56,0,0,0
313973,113,113,0,0,0
313980,259,259,0,0,0
313982,281,281,0,0,0
313999,353,353,0,0,0
314008,130,130,0,0,0
314012,121,121,0,0,0
314046,87,87,0,0,0
314054,184,184,0,0,0
314085,70,70,0,0,0
314088,22,22,0,0,0
314093,201,201,0,0,0
314111,143,143,0,0,0
314128,246,246,0,0,0
314133,353,353,0,0,0
314134,55,55,0,0,0
314137,137,137,0,0,0
314141,255,255,0,0,0
314156,102,102,0,0,0
314162,39,39,0,0,0
314168,299,299,0,0,0
314194,313,313,0,0,0
314195,121,121,0,0,0
314209,76,76,0,0,0
314211,30,30,0,0,0
314217,130,130,0,0,0
314225,259,259,0,0,0
314230,7,7,0,0,0
314237,22,22,0,0,0
314238,103,103,0,0,0
314259,30,30,0,0,0
314264,201,201,0,0,0
314280,4,4,0,0,0
314281,281,281,0,0,0
314285,282,282,0,0,0
314286,32,32,0,0,0
314303,133,133,0,0,0
314305,255,255,0,0,0
314319,133,133,0,0,0
314336,8,8,0,0,0
314357,184,184,0,0,0
314361,310,310,0,0,0
314363,282,282,0,0,0
314384,74,74,0,0,0
314391,252,252,0,0,0
314394,97,97,0,0,0
314413,65,65,0,0,0
314422,313,313,0,0,0
314434,58,58,0,0,0
314440,198,198,0,0,0
314448,259,259,0,0,0
314449,22,22,0,0,0
314467,44,44,0,0,0
314474,313,313,0,0,0
314484,102,102,0,0,0
314493,101,101,0,0,0
314496,167,167,0,0,0
314506,198,198,0,0,0
314521,130,130,0,0,0
314538,193,193,0,0,0
314543,255,255,0,0,0
314559,259,259,0,0,0
314565,158,158,0,0,0
314569,313,313,0,0,0
314580,144,144,0,0,0
314582,180,180,0,0,0
314595,22,22,0,0,0
314609,251,251,0,0,0
314620,315,315,0,0,0
314654,17,17,0,0,0
314655,102,102,0,0,0
314659,144,144,0,0,0
314671,22,22,0,0,0
314681,101,101,0,0,0
314692,232,232,0,0,0
314699,44,44,0,0,0
314700,85,85,0,0,0
314720,158,158,0,0,0
314723,137,137,0,0,0
314743,76,76,0,0,0
314747,359,359,0,0,0
314755,121,121,0,0,0
314756,259,259,0,0,0
314784,9,9,0,0,0
314793,246,246,0,0,0
314802,281,281,0,0,0
314803,359,359,0,0,0
314811,310,310,0,0,0
314838,3,3,0,0,0
314840,36,36,0,0,0
314852,82,82,0,0,0
314863,313,313,0,0,0
314864,359,359,0,0,0
314865,310,310,0,0,0
314887,23,23,0,0,0
314893,193,193,0,0,0
314895,184,184,0,0,0
314906,121,121,0,0,0
314918,76,76,0,0,0
314920,114,114,0,0,0
314936,151,151,0,0,0
314947,137,137,0,0,0
314949,17,17,0,0,0
314961,259,259,0,0,0
315004,2,2,0,0,0
315021,152,152,0,0,0
315034,70,70,0,0,0
315078,76,76,0,0,0
315099,24,24,0,0,0
315101,345,345,0,0,0
315112,128,128,0,0,0
315113,21,21,0,0,0
315135,345,345,0,0,0
315140,82,82,0,0,0
315162,128,128,0,0,0
315163,180,180,0,0,0
315182,144,144,0,0,0
315195,121,121,0,0,0
315237,310,310,0,0,0
315238,255,255,0,0,0
315258,67,67,0,0,0
315266,35,35,0,0,0
315274,7,7,0,0,0
315275,66,66,0,0,0
315276,29,29,0,0,0
315308,13,13,0,0,0
315317,198,198,0,0,0
315318,101,101,0,0,0
315332,56,56,0,0,0
315337,281,281,0,0,0
315354,143,143,0,0,0
315366,83,83,0,0,0
315373,313,313,0,0,0
315424,282,282,0,0,0
315447,345,345,0,0,0
315462,171,171,0,0,0
315468,7,7,0,0,0
315470,281,281,0,0,0
315472,9,9,0,0,0
315478,114,114,0,0,0
315489,27,27,0,0,0
315490,158,158,0,0,0
315512,180,180,0,0,0
315518,21,21,0,0,0
315520,310,310,0,0,0
315525,252,252,0,0,0
315544,25,25,0,0,0
315552,131,131,0,0,0
315556,9,9,0,0,0
315566,310,310,0,0,0
315570,44,44,0,0,0
315573,313,313,0,0,0
315589,102,102,0,0,0
315617,12,12,0,0,0
315658,25,25,0,0,0
315664,299,299,0,0,0
315671,128,128,0,0,0
315684,163,163,0,0,0
315685,306,306,0,0,0
315686,102,102,0,0,0
315688,76,76,0,0,0
315706,17,17,0,0,0
315714,180,180,0,0,0
315717,137,137,0,0,0
315723,56,56,0,0,0
315732,251,251,0,0,0
315735,76,76,0,0,0
315747,171,171,0,0,0
315750,158,158,0,0,0
315756,180,180,0,0,0
315777,252,252,0,0,0
315779,65,65,0,0,0
315781,315,315,0,0,0
315789,76,76,0,0,0
315811,232,232,0,0,0
315814,255,255,0,0,0
315817,121,121,0,0,0
315827,114,114,0,0,0
315828,85,85,0,0,0
315830,306,306,0,0,0
315837,77,77,0,0,0
315849,345,345,0,0,0
315860,252,252,0,0,0
315880,171,171,0,0,0
315882,246,246,0,0,0
315883,163,163,0,0,0
315888,201,201,0,0,0
315898,94,94,0,0,0
315901,144,144,0,0,0
315911,193,193,0,0,0
315923,50,50,0,0,0
315938,16,16,0,0,0
315957,57,57,0,0,0
315960,167,167,0,0,0
315968,180,180,0,0,0
315983,281,281,0,0,0
315984,281,281,0,0,0
316020,30,30,0,0,0
316027,246,246,0,0,0
316037,151,151,0,0,0
316054,32,32,0,0,0
316080,306,306,0,0,0
316088,299,299,0,0,0
316096,66,66,0,0,0
316100,313,313,0,0,0
316123,34,34,0,0,0
316134,76,76,0,0,0
316178,114,114,0,0,0
316180,353,353,0,0,0
316190,30,30,0,0,0
316214,315,315,0,0,0
316226,14,14,0,0,0
316236,402,402,0,0,0
316251,5,5,0,0,0
316257,299,299,0,0,0
316264,310,310,0,0,0
316277,246,246,0,0,0
316282,94,94,0,0,0
316293,193,193,0,0,0
316330,101,101,0,0,0
316347,282,282,0,0,0
316351,310,310,0,0,0
316353,152,152,0,0,0
316359,66,66,0,0,0
316361,232,232,0,0,0
316365,45,45,0,0,0
316367,77,77,0,0,0
316375,151,151,0,0,0
316386,167,167,0,0,0
316388,359,359,0,0,0
316399,359,359,0,0,0
316418,74,74,0,0,0
316422,345,345,0,0,0
316436,137,137,0,0,0
316446,143,143,0,0,0
316472,66,66,0,0,0
316473,77,77,0,0,0
316479,251,251,0,0,0
316495,36,36,0,0,0
316510,70,70,0,0,0
316520,359,359,0,0,0
316527,306,306,0,0,0
316533,76,76,0,0,0
316560,281,281,0,0,0
316561,299,299,0,0,0
316565,313,313,0,0,0
316569,232,232,0,0,0
316583,184,184,0,0,0
316593,3,3,0,0,0
316596,310,310,0,0,0
316597,18,18,0,0,0
316605,5,5,0,0,0
316613,402,402,0,0,0
316622,27,27,0,0,0
316624,39,39,0,0,0
316633,255,255,0,0,0
316650,102,102,0,0,0
316665,131,131,0,0,0
316668,40,40,0,0,0
316741,171,171,0,0,0
316750,23,23,0,0,0
316757,14,14,0,0,0
316775,5,5,0,0,0
316776,313,313,0,0,0
316799,180,180,0,0,0
316802,251,251,0,0,0
316811,315,315,0,0,0
316817,193,193,0,0,0
316827,310,310,0,0,0
316840,232,232,0,0,0
316855,299,299,0,0,0
316872,310,310,0,0,0
316876,171,171,0,0,0
316880,137,137,0,0,0
316890,259,259,0,0,0
316895,67,67,0,0,0
316898,54,54,0,0,0
316902,281,281,0,0,0
316909,246,246,0,0,0
316916,41,41,0,0,0
316920,34,34,0,0,0
316937,402,402,0,0,0
316945,402,402,0,0,0
316988,128,128,0,0,0
316991,345,345,0,0,0
316994,184,184,0,0,0
316998,201,201,0,0,0
317008,158,158,0,0,0
317046,35,35,0,0,0
317050,74,74,0,0,0
317057,310,310,0,0,0
317068,306,306,0,0,0
317100,310,310,0,0,0
317101,313,313,0,0,0
317116,163,163,0,0,0
317117,345,345,0,0,0
317127,4,4,0,0,0
317142,44,44,0,0,0
317144,66,66,0,0,0
317146,128,128,0,0,0
317162,102,102,0,0,0
317195,11,11,0,0,0
317250,152,152,0,0,0
317253,281,281,0,0,0
317256,252,252,0,0,0
317260,246,246,0,0,0
317267,114,114,0,0,0
317285,402,402,0,0,0
317286,402,402,0,0,0
317289,163,163,0,0,0
317302,56,56,0,0,0
317307,359,359,0,0,0
317308,29,29,0,0,0
317312,168,168,0,0,0
317331,144,144,0,0,0
317334,198,198,0,0,0
317337,35,35,0,0,0
317349,198,198,0,0,0
317351,137,137,0,0,0
317387,137,137,0,0,0
317403,114,114,0,0,0
317407,353,353,0,0,0
317425,101,101,0,0,0
317427,259,259,0,0,0
317428,359,359,0,0,0
317434,402,402,0,0,0
317441,65,65,0,0,0
317454,6,6,0,0,0
317461,402,402,0,0,0
317462,359,359,0,0,0
317474,32,32,0,0,0
317479,44,44,0,0,0
317488,94,94,0,0,0
317493,168,168,0,0,0
317526,137,137,0,0,0
317542,306,306,0,0,0
317555,310,310,0,0,0
317558,359,359,0,0,0
317584,54,54,0,0,0
317588,71,71,0,0,0
317597,353,353,0,0,0
317598,74,74,0,0,0
317599,120,120,0,0,0
317622,152,152,0,0,0
317629,50,50,0,0,0
317645,402,402,0,0,0
317647,128,128,0,0,0
317676,25,25,0,0,0
317682,143,143,0,0,0
317687,345,345,0,0,0
317720,232,232,0,0,0
317740,251,251,0,0,0
317746,120,120,0,0,0
317758,76,76,0,0,0
317781,310,310,0,0,0
317822,94,94,0,0,0
317870,97,97,0,0,0
317871,167,167,0,0,0
317872,167,167,0,0,0
317898,313,313,0,0,0
317914,30,30,0,0,0
317952,306,306,0,0,0
317959,251,251,0,0,0
317963,315,315,0,0,0
317968,13,13,0,0,0
317979,102,102,0,0,0
317999,137,137,0,0,0
318004,143,143,0,0,0
318021,353,353,0,0,0
318032,232,232,0,0,0
318033,18,18,0,0,0
318040,12,12,0,0,0
318041,359,359,0,0,0
318063,152,152,0,0,0
318090,255,255,0,0,0
318091,8,8,0,0,0
318100,310,310,0,0,0
318103,402,402,0,0,0
318134,345,345,0,0,0
318135,1,1,0,0,0
318138,121,121,0,0,0
318146,193,193,0,0,0
318152,306,306,0,0,0
318154,168,168,0,0,0
318156,103,103,0,0,0
318161,44,44,0,0,0
318163,66,66,0,0,0
318196,282,282,0,0,0
318206,56,56,0,0,0
318231,94,94,0,0,0
318245,259,259,0,0,0
318249,299,299,0,0,0
318268,232,232,0,0,0
318290,167,167,0,0,0
318294,97,97,0,0,0
318295,252,252,0,0,0
318300,76,76,0,0,0
318315,282,282,0,0,0
318321,7,7,0,0,0
318326,306,306,0,0,0
318340,306,306,0,0,0
318357,83,83,0,0,0
318369,102,102,0,0,0
318392,310,310,0,0,0
318403,120,120,0,0,0
318410,121,121,0,0,0
318414,35,35,0,0,0
318416,281,281,0,0,0
318433,74,74,0,0,0
318444,41,41,0,0,0
318460,281,281,0,0,0
318464,77,77,0,0,0
318484,163,163,0,0,0
318491,75,75,0,0,0
318506,193,193,0,0,0
318520,12,12,0,0,0
318521,152,152,0,0,0
318539,359,359,0,0,0
318550,97,97,0,0,0
318575,121,121,0,0,0
318581,15,15,0,0,0
318589,310,310,0,0,0
318598,10,10,0,0,0
318612,101,101,0,0,0
318619,128,128,0,0,0
318624,402,402,0,0,0
318629,5,5,0,0,0
318641,36,36,0,0,0
318653,252,252,0,0,0
318695,281,281,0,0,0
318702,20,20,0,0,0
318712,306,306,0,0,0
318713,101,101,0,0,0
318714,65,65,0,0,0
318719,76,76,0,0,0
318722,402,402,0,0,0
318729,36,36,0,0,0
318745,299,299,0,0,0
318759,103,103,0,0,0
318791,6,6,0,0,0
318796,120,120,0,0,0
318800,345,345,0,0,0
318801,255,255,0,0,0
318817,113,113,0,0,0
318824,2,2,0,0,0
318829,353,353,0,0,0
318845,299,299,0,0,0
318852,97,97,0,0,0
318856,27,27,0,0,0
318859,315,315,0,0,0
318903,102,102,0,0,0
318905,306,306,0,0,0
318920,120,120,0,0,0
318934,69,69,0,0,0
318935,32,32,0,0,0
318937,18,18,0,0,0
318944,255,255,0,0,0
318951,137,137,0,0,0
318972,76,76,0,0,0
318977,3,3,0,0,0
319000,299,299,0,0,0
319011,17,17,0,0,0
319014,137,137,0,0,0
319036,14,14,0,0,0
319037,97,97,0,0,0
319043,359,359,0,0,0
319044,313,313,0,0,0
319055,28,28,0,0,0
319121,63,63,0,0,0
319135,130,130,0,0,0
319187,85,85,0,0,0
319197,74,74,0,0,0
319209,310,310,0,0,0
319214,15,15,0,0,0
319219,69,69,0,0,0
319234,180,180,0,0,0
319239,65,65,0,0,0
319251,180,180,0,0,0
319252,76,76,0,0,0
319257,246,246,0,0,0
319266,299,299,0,0,0
319269,151,151,0,0,0
319276,102,102,0,0,0
319290,252,252,0,0,0
319293,43,43,0,0,0
319294,77,77,0,0,0
319299,71,71,0,0,0
319308,71,71,0,0,0
319311,201,201,0,0,0
319312,232,232,0,0,0
319315,137,137,0,0,0
319324,151,151,0,0,0
319351,306,306,0,0,0
319352,56,56,0,0,0
319365,180,180,0,0,0
319368,6,6,0,0,0
319374,359,359,0,0,0
319393,402,402,0,0,0
319399,15,15,0,0,0
319404,29,29,0,0,0
319405,101,101,0,0,0
319416,67,67,0,0,0
319418,353,353,0,0,0
319428,97,97,0,0,0
319441,144,144,0,0,0
319443,85,85,0,0,0
319460,310,310,0,0,0
319469,171,171,0,0,0
319484,137,137,0,0,0
319490,97,97,0,0,0
319491,32,32,0,0,0
319494,184,184,0,0,0
319518,71,71,0,0,0
319525,306,306,0,0,0
319533,1,1,0,0,0
319541,246,246,0,0,0
319549,163,163,0,0,0
319590,359,359,0,0,0
319598,306,306,0,0,0
319631,151,151,0,0,0
319646,359,359,0,0,0
319649,359,359,0,0,0
319655,252,252,0,0,0
319669,152,152,0,0,0
319690,75,75,0,0,0
319696,101,101,0,0,0
319707,128,128,0,0,0
319727,57,57,0,0,0
319728,201,201,0,0,0
319735,353,353,0,0,0
319737,255,255,0,0,0
319746,168,168,0,0,0
319760,255,255,0,0,0
319772,128,128,0,0,0
319775,167,167,0,0,0
319776,315,315,0,0,0
319786,193,193,0,0,0
319805,14,14,0,0,0
319833,180,180,0,0,0
319846,29,29,0,0,0
319853,299,299,0,0,0
319861,114,114,0,0,0
319871,345,345,0,0,0
319897,114,114,0,0,0
319908,7,7,0,0,0
319921,121,121,0,0,0
319938,313,313,0,0,0
319943,18,18,0,0,0
319957,299,299,0,0,0
319967,184,184,0,0,0
319976,144,144,0,0,0
319979,313,313,0,0,0
319980,50,50,0,0,0
319992,315,315,0,0,0
320010,3,3,0,0,0
320039,201,201,0,0,0
320042,137,137,0,0,0
320044,158,158,0,0,0
320073,75,75,0,0,0
320086,44,44,0,0,0
320095,252,252,0,0,0
320104,180,180,0,0,0
320128,1,1,0,0,0
320150,171,171,0,0,0
320159,255,255,0,0,0
320160,18,18,0,0,0
320161,255,255,0,0,0
320190,163,163,0,0,0
320192,83,83,0,0,0
320204,120,120,0,0,0
320209,143,143,0,0,0
320218,34,34,0,0,0
320230,310,310,0,0,0
320235,282,282,0,0,0
320240,28,28,0,0,0
320257,359,359,0,0,0
320262,43,43,0,0,0
320272,345,345,0,0,0
320273,151,151,0,0,0
320274,299,299,0,0,0
320285,130,130,0,0,0
320293,20,20,0,0,0
320294,259,259,0,0,0
320297,121,121,0,0,0
320299,232,232,0,0,0
320304,21,21,0,0,0
320310,121,121,0,0,0
320324,255,255,0,0,0
320325,17,17,0,0,0
320330,32,32,0,0,0
320333,66,66,0,0,0
320349,94,94,0,0,0
320351,180,180,0,0,0
320382,353,353,0,0,0
320390,24,24,0,0,0
320422,130,130,0,0,0
320457,171,171,0,0,0
320458,402,402,0,0,0
320471,39,39,0,0,0
320477,20,20,0,0,0
320478,70,70,0,0,0
320482,232,232,0,0,0
320485,55,55,0,0,0
320491,163,163,0,0,0
320501,144,144,0,0,0
320507,198,198,0,0,0
320522,180,180,0,0,0
320574,246,246,0,0,0
320575,11,11,0,0,0
320579,353,353,0,0,0
320597,167,167,0,0,0
320615,281,281,0,0,0
320616,402,402,0,0,0
320641,3,3,0,0,0
320645,94,94,0,0,0
320656,315,315,0,0,0
320672,167,167,0,0,0
320730,75,75,0,0,0
320732,55,55,0,0,0
320750,345,345,0,0,0
320776,69,69,0,0,0
320791,167,167,0,0,0
320821,402,402,0,0,0
320827,306,306,0,0,0
320834,171,171,0,0,0
320841,121,121,0,0,0
320852,24,24,0,0,0
320854,74,74,0,0,0
320873,10,10,0,0,0
320879,193,193,0,0,0
320902,85,85,0,0,0
320907,83,83,0,0,0
320911,232,232,0,0,0
320923,137,137,0,0,0
320925,137,137,0,0,0
320935,198,198,0,0,0
320944,201,201,0,0,0
320953,152,152,0,0,0
320960,251,251,0,0,0
320964,143,143,0,0,0
320969,193,193,0,0,0
320974,70,70,0,0,0
321001,168,168,0,0,0
321018,359,359,0,0,0
321019,50,50,0,0,0
321025,144,144,0,0,0
321044,70,70,0,0,0
321046,8,8,0,0,0
321050,252,252,0,0,0
321052,359,359,0,0,0
321065,246,246,0,0,0
321090,113,113,0,0,0
321092,56,56,0,0,0
321096,76,76,0,0,0
321115,299,299,0,0,0
321117,359,359,0,0,0
321125,36,36,0,0,0
321142,232,232,0,0,0
321170,72,72,0,0,0
321179,10,10,0,0,0
321181,193,193,0,0,0
321183,21,21,0,0,0
321192,76,76,0,0,0
321193,313,313,0,0,0
321201,144,144,0,0,0
321202,158,158,0,0,0
321209,66,66,0,0,0
321212,144,144,0,0,0
321215,103,103,0,0,0
321217,171,171,0,0,0
321223,143,143,0,0,0
321241,121,121,0,0,0
321255,102,102,0,0,0
321279,163,163,0,0,0
321282,120,120,0,0,0
321284,36,36,0,0,0
321289,57,57,0,0,0
321292,113,113,0,0,0
321294,113,113,0,0,0
321310,310,310,0,0,0
321334,137,137,0,0,0
321346,54,54,0,0,0
321355,54,54,0,0,0
321365,259,259,0,0,0
321392,39,39,0,0,0
321410,158,158,0,0,0
321424,71,71,0,0,0
321436,184,184,0,0,0
321445,201,201,0,0,0
321447,102,102,0,0,0
321450,315,315,0,0,0
321460,8,8,0,0,0
321467,259,259,0,0,0
321486,184,184,0,0,0
321487,184,184,0,0,0
321493,82,82,0,0,0
321502,71,71,0,0,0
321514,259,259,0,0,0
321515,74,74,0,0,0
321516,315,315,0,0,0
321528,299,299,0,0,0
321535,201,201,0,0,0
321556,39,39,0,0,0
321572,251,251,0,0,0
321586,121,121,0,0,0
321592,158,158,0,0,0
321607,313,313,0,0,0
321626,66,66,0,0,0
321644,359,359,0,0,0
321682,345,345,0,0,0
321701,232,232,0,0,0
321702,306,306,0,0,0
321703,306,306,0,0,0
321719,69,69,0,0,0
321726,299,299,0,0,0
321727,151,151,0,0,0
321731,353,353,0,0,0
321735,353,353,0,0,0
321741,3,3,0,0,0
321752,151,151,0,0,0
321754,63,63,0,0,0
321763,131,131,0,0,0
321777,132,132,0,0,0
321801,313,313,0,0,0
321807,143,143,0,0,0
321813,128,128,0,0,0
321815,82,82,0,0,0
321832,25,25,0,0,0
321836,158,158,0,0,0
321862,69,69,0,0,0
321864,45,45,0,0,0
321877,6,6,0,0,0
321879,17,17,0,0,0
321881,198,198,0,0,0
321884,246,246,0,0,0
321891,198,198,0,0,0
321945,282,282,0,0,0
321949,44,44,0,0,0
321966,45,45,0,0,0
321994,282,282,0,0,0
322003,180,180,0,0,0
322020,168,168,0,0,0
322032,246,246,0,0,0
322045,306,306,0,0,0
322054,201,201,0,0,0
322064,144,144,0,0,0
322086,97,97,0,0,0
322097,74,74,0,0,0
322115,120,120,0,0,0
322116,232,232,0,0,0
322120,63,63,0,0,0
322122,299,299,0,0,0
322123,255,255,0,0,0
322128,359,359,0,0,0
322142,345,345,0,0,0
322151,171,171,0,0,0
322164,67,67,0,0,0
322181,315,315,0,0,0
322191,137,137,0,0,0
322196,113,113,0,0,0
322204,17,17,0,0,0
322221,313,313,0,0,0
322222,251,251,0,0,0
322223,163,163,0,0,0
322234,310,310,0,0,0
322235,36,36,0,0,0
322239,259,259,0,0,0
322258,27,27,0,0,0
322261,180,180,0,0,0
322268,345,345,0,0,0
322281,232,232,0,0,0
322309,402,402,0,0,0
322317,310,310,0,0,0
322346,66,66,0,0,0
322355,36,36,0,0,0
322358,121,121,0,0,0
322360,198,198,0,0,0
322364,282,282,0,0,0
322376,7,7,0,0,0
322385,151,151,0,0,0
322387,232,232,0,0,0
322388,120,120,0,0,0
322412,36,36,0,0,0
322422,55,55,0,0,0
322428,103,103,0,0,0
322449,77,77,0,0,0
322452,299,299,0,0,0
322463,101,101,0,0,0
322478,310,310,0,0,0
322479,251,251,0,0,0
322495,39,39,0,0,0
322511,87,87,0,0,0
322571,193,193,0,0,0
322572,121,121,0,0,0
322633,255,255,0,0,0
322638,54,54,0,0,0
322640,299,299,0,0,0
322667,128,128,0,0,0
322678,128,128,0,0,0
322687,310,310,0,0,0
322744,9,9,0,0,0
322795,25,25,0,0,0
322797,306,306,0,0,0
322800,259,259,0,0,0
322804,137,137,0,0,0
322817,50,50,0,0,0
322820,402,402,0,0,0
322827,281,281,0,0,0
322835,315,315,0,0,0
322837,102,102,0,0,0
322839,193,193,0,0,0
322843,232,232,0,0,0
322855,306,306,0,0,0
322866,12,12,0,0,0
322873,232,232,0,0,0
322884,85,85,0,0,0
322889,353,353,0,0,0
322890,193,193,0,0,0
322908,133,133,0,0,0
322920,22,22,0,0,0
322930,315,315,0,0,0
322932,83,83,0,0,0
322939,402,402,0,0,0
322949,310,310,0,0,0
322958,198,198,0,0,0
322959,255,255,0,0,0
322963,281,281,0,0,0
322979,11,11,0,0,0
322992,313,313,0,0,0
322993,310,310,0,0,0
323001,167,167,0,0,0
323015,113,113,0,0,0
323025,83,83,0,0,0
323028,310,310,0,0,0
323029,259,259,0,0,0
323032,299,299,0,0,0
323073,313,313,0,0,0
323090,353,353,0,0,0
323093,198,198,0,0,0
323096,359,359,0,0,0
323123,315,315,0,0,0
323130,76,76,0,0,0
323136,246,246,0,0,0
323137,22,22,0,0,0
323142,74,74,0,0,0
323143,310,310,0,0,0
323158,151,151,0,0,0
323162,102,102,0,0,0
323167,121,121,0,0,0
323174,201,201,0,0,0
323176,171,171,0,0,0
323183,402,402,0,0,0
323190,24,24,0,0,0
323207,144,144,0,0,0
323212,114,114,0,0,0
323227,152,152,0,0,0
323229,310,310,0,0,0
323235,306,306,0,0,0
323238,246,246,0,0,0
323277,299,299,0,0,0
323279,25,25,0,0,0
323292,74,74,0,0,0
323293,282,282,0,0,0
323307,163,163,0,0,0
323323,102,102,0,0,0
323336,255,255,0,0,0
323350,56,56,0,0,0
323351,353,353,0,0,0
323368,232,232,0,0,0
323371,402,402,0,0,0
323372,180,180,0,0,0
323382,34,34,0,0,0
323392,299,299,0,0,0
323412,1,1,0,0,0
323413,246,246,0,0,0
323416,313,313,0,0,0
323418,50,50,0,0,0
323424,63,63,0,0,0
323425,8,8,0,0,0
323442,281,281,0,0,0
323463,77,77,0,0,0
323476,97,97,0,0,0
323482,121,121,0,0,0
323483,246,246,0,0,0
323509,94,94,0,0,0
323522,255,255,0,0,0
323523,54,54,0,0,0
323573,306,306,0,0,0
323576,82,82,0,0,0
323580,102,102,0,0,0
323586,35,35,0,0,0
323597,259,259,0,0,0
323604,315,315,0,0,0
323606,310,310,0,0,0
323618,69,69,0,0,0
323638,402,402,0,0,0
323642,259,259,0,0,0
323648,232,232,0,0,0
323665,54,54,0,0,0
323670,259,259,0,0,0
323695,282,282,0,0,0
323698,402,402,0,0,0
323711,29,29,0,0,0
323715,10,10,0,0,0
323730,281,281,0,0,0
323735,281,281,0,0,0
323736,76,76,0,0,0
323745,6,6,0,0,0
323772,144,144,0,0,0
323793,151,151,0,0,0
323813,232,232,0,0,0
323814,402,402,0,0,0
323841,359,359,0,0,0
323846,22,22,0,0,0
323866,359,359,0,0,0
323869,29,29,0,0,0
323888,39,39,0,0,0
323889,353,353,0,0,0
323893,353,353,0,0,0
323895,18,18,0,0,0
323904,151,151,0,0,0
323914,144,144,0,0,0
323920,251,251,0,0,0
323921,97,97,0,0,0
323933,299,299,0,0,0
323946,12,12,0,0,0
323948,55,55,0,0,0
323952,13,13,0,0,0
323955,131,131,0,0,0
323962,281,281,0,0,0
323990,259,259,0,0,0
323996,29,29,0,0,0
324007,402,402,0,0,0
324008,402,402,0,0,0
324010,85,85,0,0,0
324037,7,7,0,0,0
324057,163,163,0,0,0
324069,158,158,0,0,0
324070,143,143,0,0,0
324140,180,180,0,0,0
324141,45,45,0,0,0
324145,57,57,0,0,0
324155,259,259,0,0,0
324157,345,345,0,0,0
324170,1,1,0,0,0
324187,310,310,0,0,0
324195,281,281,0,0,0
324201,306,306,0,0,0
324220,306,306,0,0,0
324224,137,137,0,0,0
324249,315,315,0,0,0
324295,201,201,0,0,0
324307,121,121,0,0,0
324321,251,251,0,0,0
324345,315,315,0,0,0
324348,158,158,0,0,0
324394,310,310,0,0,0
324397,193,193,0,0,0
324411,43,43,0,0,0
324416,281,281,0,0,0
324427,25,25,0,0,0
324439,2,2,0,0,0
324442,359,359,0,0,0
324444,353,353,0,0,0
324455,22,22,0,0,0
324491,306,306,0,0,0
324497,306,306,0,0,0
324501,353,353,0,0,0
324510,299,299,0,0,0
324515,35,35,0,0,0
324517,251,251,0,0,0
324531,299,299,0,0,0
324548,70,70,0,0,0
324550,193,193,0,0,0
324561,201,201,0,0,0
324574,353,353,0,0,0
324575,113,113,0,0,0
324598,198,198,0,0,0
324605,114,114,0,0,0
324621,158,158,0,0,0
324648,22,22,0,0,0
324651,137,137,0,0,0
324667,76,76,0,0,0
324700,299,299,0,0,0
324715,128,128,0,0,0
324716,180,180,0,0,0
324718,102,102,0,0,0
324719,121,121,0,0,0
324729,41,41,0,0,0
324731,402,402,0,0,0
324734,102,102,0,0,0
324759,67,67,0,0,0
324768,43,43,0,0,0
324782,18,18,0,0,0
324785,120,120,0,0,0
324789,152,152,0,0,0
324793,310,310,0,0,0
324826,313,313,0,0,0
324833,168,168,0,0,0
324842,359,359,0,0,0
324846,201,201,0,0,0
324848,259,259,0,0,0
324855,353,353,0,0,0
324858,94,94,0,0,0
324866,359,359,0,0,0
324869,281,281,0,0,0
324884,5,5,0,0,0
324917,251,251,0,0,0
324920,313,313,0,0,0
324934,255,255,0,0,0
324943,137,137,0,0,0
324965,299,299,0,0,0
324969,54,54,0,0,0
324977,114,114,0,0,0
325004,180,180,0,0,0
325006,17,17,0,0,0
325007,120,120,0,0,0
325013,143,143,0,0,0
325022,246,246,0,0,0
325023,259,259,0,0,0
325029,133,133,0,0,0
325064,1,1,0,0,0
325066,54,54,0,0,0
325076,1,1,0,0,0
325077,36,36,0,0,0
325088,353,353,0,0,0
325091,281,281,0,0,0
325095,359,359,0,0,0
325105,44,44,0,0,0
325119,43,43,0,0,0
325127,315,315,0,0,0
325134,121,121,0,0,0
325137,353,353,0,0,0
325140,128,128,0,0,0
325145,85,85,0,0,0
325157,402,402,0,0,0
325161,63,63,0,0,0
325167,193,193,0,0,0
325184,120,120,0,0,0
325194,137,137,0,0,0
325200,12,12,0,0,0
325224,114,114,0,0,0
325241,34,34,0,0,0
325243,246,246,0,0,0
325244,251,251,0,0,0
325253,25,25,0,0,0
325255,313,313,0,0,0
325256,77,77,0,0,0
325266,184,184,0,0,0
325273,3,3,0,0,0
325279,114,114,0,0,0
325295,151,151,0,0,0
325335,144,144,0,0,0
325342,402,402,0,0,0
325348,198,198,0,0,0
325356,76,76,0,0,0
325363,83,83,0,0,0
325374,75,75,0,0,0
325389,137,137,0,0,0
325396,72,72,0,0,0
325417,310,310,0,0,0
325419,251,251,0,0,0
325421,72,72,0,0,0
325429,255,255,0,0,0
325454,41,41,0,0,0
325463,184,184,0,0,0
325469,97,97,0,0,0
325484,144,144,0,0,0
325488,168,168,0,0,0
325491,3,3,0,0,0
325514,282,282,0,0,0
325533,158,158,0,0,0
325548,76,76,0,0,0
325590,94,94,0,0,0
325606,41,41,0,0,0
325607,137,137,0,0,0
325608,13,13,0,0,0
325617,402,402,0,0,0
325644,121,121,0,0,0
325649,103,103,0,0,0
325654,121,121,0,0,0
325659,232,232,0,0,0
325669,65,65,0,0,0
325673,299,299,0,0,0
325676,359,359,0,0,0
325691,201,201,0,0,0
325692,121,121,0,0,0
325693,56,56,0,0,0
325702,246,246,0,0,0
325703,306,306,0,0,0
325716,102,102,0,0,0
325734,143,143,0,0,0
325745,167,167,0,0,0
325759,345,345,0,0,0
325768,359,359,0,0,0
325781,1,1,0,0,0
325798,43,43,0,0,0
325842,281,281,0,0,0
325843,232,232,0,0,0
325845,184,184,0,0,0
325864,36,36,0,0,0
325873,163,163,0,0,0
325876,8,8,0,0,0
325915,76,76,0,0,0
325923,102,102,0,0,0
325928,58,58,0,0,0
325946,103,103,0,0,0
325951,299,299,0,0,0
325958,10,10,0,0,0
325959,143,143,0,0,0
325960,315,315,0,0,0
325963,168,168,0,0,0
325964,6,6,0,0,0
325971,83,83,0,0,0
325976,345,345,0,0,0
325988,281,281,0,0,0
325992,70,70,0,0,0
326000,25,25,0,0,0
326013,359,359,0,0,0
326039,151,151,0,0,0
326068,315,315,0,0,0
326083,299,299,0,0,0
326142,259,259,0,0,0
326159,251,251,0,0,0
326164,76,76,0,0,0
326189,353,353,0,0,0
326192,71,71,0,0,0
326193,72,72,0,0,0
326205,232,232,0,0,0
326229,1,1,0,0,0
326230,402,402,0,0,0
326238,35,35,0,0,0
326242,345,345,0,0,0
326263,76,76,0,0,0
326265,163,163,0,0,0
326268,137,137,0,0,0
326270,29,29,0,0,0
326282,144,144,0,0,0
326289,11,11,0,0,0
326298,120,120,0,0,0
326311,144,144,0,0,0
326319,152,152,0,0,0
326322,198,198,0,0,0
326325,77,77,0,0,0
326327,70,70,0,0,0
326333,114,114,0,0,0
326356,114,114,0,0,0
326357,55,55,0,0,0
326376,133,133,0,0,0
326381,121,121,0,0,0
326384,402,402,0,0,0
326407,359,359,0,0,0
326427,184,184,0,0,0
326428,114,114,0,0,0
326447,72,72,0,0,0
326465,315,315,0,0,0
326466,252,252,0,0,0
326473,74,74,0,0,0
326486,114,114,0,0,0
326492,35,35,0,0,0
326522,23,23,0,0,0
326526,299,299,0,0,0
326535,198,198,0,0,0
326539,87,87,0,0,0
326591,315,315,0,0,0
326600,43,43,0,0,0
326610,310,310,0,0,0
326624,281,281,0,0,0
326653,54,54,0,0,0
326656,54,54,0,0,0
326670,114,114,0,0,0
326674,282,282,0,0,0
326676,11,11,0,0,0
326677,44,44,0,0,0
326680,128,128,0,0,0
326688,102,102,0,0,0
326697,77,77,0,0,0
326701,168,168,0,0,0
326702,54,54,0,0,0
326749,101,101,0,0,0
326778,313,313,0,0,0
326787,128,128,0,0,0
326796,22,22,0,0,0
326801,56,56,0,0,0
326806,70,70,0,0,0
326825,232,232,0,0,0
326843,17,17,0,0,0
326849,25,25,0,0,0
326863,198,198,0,0,0
326872,143,143,0,0,0
326875,299,299,0,0,0
326892,2,2,0,0,0
326899,4,4,0,0,0
326900,310,310,0,0,0
326903,85,85,0,0,0
326937,43,43,0,0,0
326942,29,29,0,0,0
326947,94,94,0,0,0
326973,55,55,0,0,0
326984,82,82,0,0,0
326995,299,299,0,0,0
327001,63,63,0,0,0
327007,198,198,0,0,0
327030,12,12,0,0,0
327046,345,345,0,0,0
327048,359,359,0,0,0
327050,15,15,0,0,0
327052,131,131,0,0,0
327053,114,114,0,0,0
327055,282,282,0,0,0
327056,345,345,0,0,0
327062,67,67,0,0,0
327097,252,252,0,0,0
327101,201,201,0,0,0
327104,359,359,0,0,0
327122,50,50,0,0,0
327134,151,151,0,0,0
327140,193,193,0,0,0
327166,180,180,0,0,0
327179,315,315,0,0,0
327187,75,75,0,0,0
327190,55,55,0,0,0
327216,74,74,0,0,0
327279,7,7,0,0,0
327307,306,306,0,0,0
327311,83,83,0,0,0
327327,180,180,0,0,0
327329,310,310,0,0,0
327345,313,313,0,0,0
327352,25,25,0,0,0
327353,259,259,0,0,0
327376,310,310,0,0,0
327392,12,12,0,0,0
327395,55,55,0,0,0
327401,36,36,0,0,0
327421,70,70,0,0,0
327425,70,70,0,0,0
327446,103,103,0,0,0
327461,255,255,0,0,0
327465,25,25,0,0,0
327479,152,152,0,0,0
327489,143,143,0,0,0
327498,27,27,0,0,0
327529,251,251,0,0,0
327536,21,21,0,0,0
327551,246,246,0,0,0
327555,359,359,0,0,0
327559,114,114,0,0,0
327581,7,7,0,0,0
327596,306,306,0,0,0
327603,70,70,0,0,0
327606,12,12,0,0,0
327607,251,251,0,0,0
327635,94,94,0,0,0
327645,94,94,0,0,0
327655,50,50,0,0,0
327666,13,13,0,0,0
327709,251,251,0,0,0
327715,55,55,0,0,0
327716,353,353,0,0,0
327717,76,76,0,0,0
327718,315,315,0,0,0
327726,41,41,0,0,0
327727,24,24,0,0,0
327730,246,246,0,0,0
327748,306,306,0,0,0
327764,201,201,0,0,0
327776,29,29,0,0,0
327780,27,27,0,0,0
327799,133,133,0,0,0
327827,255,255,0,0,0
327828,313,313,0,0,0
327840,130,130,0,0,0
327848,255,255,0,0,0
327864,310,310,0,0,0
327871,282,282,0,0,0
327872,5,5,0,0,0
327895,19,19,0,0,0
327897,3,3,0,0,0
327906,163,163,0,0,0
327910,168,168,0,0,0
327915,24,24,0,0,0
327944,75,75,0,0,0
327956,402,402,0,0,0
327965,137,137,0,0,0
327971,36,36,0,0,0
327985,87,87,0,0,0
327991,402,402,0,0,0
327998,171,171,0,0,0
328003,4,4,0,0,0
328038,198,198,0,0,0
328042,353,353,0,0,0
328050,353,353,0,0,0
328102,306,306,0,0,0
328103,70,70,0,0,0
328104,193,193,0,0,0
328110,137,137,0,0,0
328125,133,133,0,0,0
328131,232,232,0,0,0
328151,152,152,0,0,0
328160,101,101,0,0,0
328163,120,120,0,0,0
328164,39,39,0,0,0
328173,167,167,0,0,0
328180,252,252,0,0,0
328183,82,82,0,0,0
328186,121,121,0,0,0
328205,167,167,0,0,0
328219,232,232,0,0,0
328244,43,43,0,0,0
328252,17,17,0,0,0
328254,315,315,0,0,0
328258,70,70,0,0,0
328270,299,299,0,0,0
328298,76,76,0,0,0
328303,282,282,0,0,0
328307,353,353,0,0,0
328311,144,144,0,0,0
328313,168,168,0,0,0
328328,402,402,0,0,0
328372,114,114,0,0,0
328373,180,180,0,0,0
328374,39,39,0,0,0
328398,85,85,0,0,0
328433,255,255,0,0,0
328447,252,252,0,0,0
328476,34,34,0,0,0
328498,65,65,0,0,0
328505,163,163,0,0,0
328506,114,114,0,0,0
328513,402,402,0,0,0
328520,103,103,0,0,0
328524,402,402,0,0,0
328541,19,19,0,0,0
328543,299,299,0,0,0
328545,54,54,0,0,0
328551,4,4,0,0,0
328557,259,259,0,0,0
328559,315,315,0,0,0
328584,193,193,0,0,0
328585,281,281,0,0,0
328608,306,306,0,0,0
328630,28,28,0,0,0
328660,43,43,0,0,0
328672,167,167,0,0,0
328676,359,359,0,0,0
328684,180,180,0,0,0
328686,151,151,0,0,0
328691,11,11,0,0,0
328700,255,255,0,0,0
328711,74,74,0,0,0
328716,313,313,0,0,0
328723,5,5,0,0,0
328730,345,345,0,0,0
328737,85,85,0,0,0
328740,83,83,0,0,0
328741,102,102,0,0,0
328759,281,281,0,0,0
328760,252,252,0,0,0
328778,193,193,0,0,0
328781,87,87,0,0,0
328782,151,151,0,0,0
328784,232,232,0,0,0
328811,313,313,0,0,0
328818,315,315,0,0,0
328834,114,114,0,0,0
328842,34,34,0,0,0
328846,137,137,0,0,0
328851,313,313,0,0,0
328858,313,313,0,0,0
328891,69,69,0,0,0
328897,232,232,0,0,0
328908,359,359,0,0,0
328913,114,114,0,0,0
328939,359,359,0,0,0
328962,44,44,0,0,0
328963,310,310,0,0,0
328980,402,402,0,0,0
328996,103,103,0,0,0
329002,58,58,0,0,0
329015,402,402,0,0,0
329017,252,252,0,0,0
329029,353,353,0,0,0
329033,252,252,0,0,0
329036,246,246,0,0,0
329048,310,310,0,0,0
329086,151,151,0,0,0
329089,36,36,0,0,0
329097,113,113,0,0,0
329106,315,315,0,0,0
329107,282,282,0,0,0
329110,113,113,0,0,0
329119,353,353,0,0,0
329141,50,50,0,0,0
329160,152,152,0,0,0
329189,313,313,0,0,0
329191,158,158,0,0,0
329204,24,24,0,0,0
329211,255,255,0,0,0
329227,12,12,0,0,0
329252,75,75,0,0,0
329268,402,402,0,0,0
329277,201,201,0,0,0
329278,171,171,0,0,0
329316,71,71,0,0,0
329329,158,158,0,0,0
329331,152,152,0,0,0
329332,121,121,0,0,0
329345,282,282,0,0,0
329365,8,8,0,0,0
329368,121,121,0,0,0
329376,34,34,0,0,0
329390,402,402,0,0,0
329392,11,11,0,0,0
329393,24,24,0,0,0
329394,10,10,0,0,0
329404,72,72,0,0,0
329407,102,102,0,0,0
329431,3,3,0,0,0
329435,11,11,0,0,0
329438,315,315,0,0,0
329450,255,255,0,0,0
329455,315,315,0,0,0
329458,246,246,0,0,0
329466,66,66,0,0,0
329467,20,20,0,0,0
329470,5,5,0,0,0
329478,76,76,0,0,0
329480,313,313,0,0,0
329482,56,56,0,0,0
329509,36,36,0,0,0
329514,306,306,0,0,0
329516,133,133,0,0,0
329544,402,402,0,0,0
329555,94,94,0,0,0
329576,143,143,0,0,0
329579,83,83,0,0,0
329586,50,50,0,0,0
329603,163,163,0,0,0
329606,144,144,0,0,0
329608,345,345,0,0,0
329615,75,75,0,0,0
329618,137,137,0,0,0
329624,1,1,0,0,0
329632,121,121,0,0,0
329643,54,54,0,0,0
329672,251,251,0,0,0
329676,94,94,0,0,0
329680,55,55,0,0,0
329684,75,75,0,0,0
329686,94,94,0,0,0
329692,144,144,0,0,0
329736,198,198,0,0,0
329747,23,23,0,0,0
329752,34,34,0,0,0
329760,65,65,0,0,0
329762,143,143,0,0,0
329798,180,180,0,0,0
329813,82,82,0,0,0
329827,70,70,0,0,0
329832,251,251,0,0,0
329847,313,313,0,0,0
329865,315,315,0,0,0
329871,232,232,0,0,0
329882,87,87,0,0,0
329883,114,114,0,0,0
329884,201,201,0,0,0
329889,193,193,0,0,0
329897,193,193,0,0,0
329898,251,251,0,0,0
329919,24,24,0,0,0
329929,74,74,0,0,0
329931,180,180,0,0,0
329936,76,76,0,0,0
329938,232,232,0,0,0
329951,259,259,0,0,0
329959,252,252,0,0,0
329961,103,103,0,0,0
329962,315,315,0,0,0
329984,198,198,0,0,0
329987,281,281,0,0,0
329989,158,158,0,0,0
329992,54,54,0,0,0
330005,74,74,0,0,0
330010,282,282,0,0,0
330015,168,168,0,0,0
330021,315,315,0,0,0
330037,306,306,0,0,0
330044,133,133,0,0,0
330058,20,20,0,0,0
330082,131,131,0,0,0
330083,232,232,0,0,0
330087,310,310,0,0,0
330097,158,158,0,0,0
330107,16,16,0,0,0
330114,101,101,0,0,0
330116,315,315,0,0,0
330125,20,20,0,0,0
330129,184,184,0,0,0
330150,32,32,0,0,0
330191,184,184,0,0,0
330198,1,1,0,0,0
330205,102,102,0,0,0
330207,313,313,0,0,0
330213,353,353,0,0,0
330216,45,45,0,0,0
330218,24,24,0,0,0
330227,102,102,0,0,0
330243,22,22,0,0,0
330246,114,114,0,0,0
330260,359,359,0,0,0
330267,76,76,0,0,0
330272,143,143,0,0,0
330287,313,313,0,0,0
330291,259,259,0,0,0
330292,158,158,0,0,0
330303,137,137,0,0,0
330340,180,180,0,0,0
330346,12,12,0,0,0
330359,4,4,0,0,0
330363,281,281,0,0,0
330375,402,402,0,0,0
330411,345,345,0,0,0
330417,3,3,0,0,0
330426,306,306,0,0,0
330428,15,15,0,0,0
330430,198,198,0,0,0
330439,75,75,0,0,0
330451,137,137,0,0,0
330460,282,282,0,0,0
330470,128,128,0,0,0
330477,57,57,0,0,0
330493,246,246,0,0,0
330515,151,151,0,0,0
330520,97,97,0,0,0
330536,158,158,0,0,0
330544,282,282,0,0,0
330555,299,299,0,0,0
330559,10,10,0,0,0
330561,50,50,0,0,0
330597,201,201,0,0,0
330613,72,72,0,0,0
330635,3,3,0,0,0
330653,167,167,0,0,0
330674,281,281,0,0,0
330688,402,402,0,0,0
330690,76,76,0,0,0
330691,315,315,0,0,0
330723,132,132,0,0,0
330755,251,251,0,0,0
330759,310,310,0,0,0
330764,19,19,0,0,0
330768,102,102,0,0,0
330784,133,133,0,0,0
330805,315,315,0,0,0
330812,121,121,0,0,0
330830,306,306,0,0,0
330841,251,251,0,0,0
330849,168,168,0,0,0
330863,57,57,0,0,0
330881,1,1,0,0,0
330931,306,306,0,0,0
330934,171,171,0,0,0
330957,246,246,0,0,0
330963,97,97,0,0,0
330965,310,310,0,0,0
330973,198,198,0,0,0
330979,151,151,0,0,0
330987,402,402,0,0,0
330989,246,246,0,0,0
330992,102,102,0,0,0
331001,402,402,0,0,0
331017,255,255,0,0,0
331019,259,259,0,0,0
331020,39,39,0,0,0
331042,7,7,0,0,0
331046,152,152,0,0,0
331068,167,167,0,0,0
331102,345,345,0,0,0
331106,23,23,0,0,0
331129,75,75,0,0,0
331132,158,158,0,0,0
331141,102,102,0,0,0
331144,5,5,0,0,0
331154,114,114,0,0,0
331157,345,345,0,0,0
331170,5,5,0,0,0
331178,5,5,0,0,0
331179,252,252,0,0,0
331190,101,101,0,0,0
331202,313,313,0,0,0
331207,252,252,0,0,0
331208,251,251,0,0,0
331231,171,171,0,0,0
331244,246,246,0,0,0
331249,133,133,0,0,0
331255,130,130,0,0,0
331257,10,10,0,0,0
331275,158,158,0,0,0
331279,315,315,0,0,0
331292,359,359,0,0,0
331315,168,168,0,0,0
331320,28,28,0,0,0
331321,184,184,0,0,0
331322,255,255,0,0,0
331327,22,22,0,0,0
331333,281,281,0,0,0
331334,198,198,0,0,0
331335,193,193,0,0,0
331339,102,102,0,0,0
331340,114,114,0,0,0
331342,198,198,0,0,0
331349,36,36,0,0,0
331350,171,171,0,0,0
331370,132,132,0,0,0
331394,353,353,0,0,0
331406,315,315,0,0,0
331411,3,3,0,0,0
331420,299,299,0,0,0
331429,281,281,0,0,0
331435,359,359,0,0,0
331448,66,66,0,0,0
331450,21,21,0,0,0
331462,113,113,0,0,0
331470,282,282,0,0,0
331491,281,281,0,0,0
331492,74,74,0,0,0
331501,65,65,0,0,0
331506,353,353,0,0,0
331520,83,83,0,0,0
331534,57,57,0,0,0
331566,44,44,0,0,0
331577,20,20,0,0,0
331591,168,168,0,0,0
331593,193,193,0,0,0
331599,198,198,0,0,0
331603,14,14,0,0,0
331609,67,67,0,0,0
331643,94,94,0,0,0
331673,5,5,0,0,0
331682,2,2,0,0,0
331688,402,402,0,0,0
331735,201,201,0,0,0
331737,74,74,0,0,0
331740,9,9,0,0,0
331742,131,131,0,0,0
331743,402,402,0,0,0
331747,102,102,0,0,0
331755,299,299,0,0,0
331776,2,2,0,0,0
331777,18,18,0,0,0
331785,76,76,0,0,0
331814,102,102,0,0,0
331829,251,251,0,0,0
331844,252,252,0,0,0
331851,232,232,0,0,0
331854,345,345,0,0,0
331855,87,87,0,0,0
331859,252,252,0,0,0
331867,252,252,0,0,0
331874,232,232,0,0,0
331920,151,151,0,0,0
331922,137,137,0,0,0
331944,201,201,0,0,0
331954,345,345,0,0,0
331968,87,87,0,0,0
331978,299,299,0,0,0
332022,281,281,0,0,0
332026,12,12,0,0,0
332040,97,97,0,0,0
332049,281,281,0,0,0
332055,359,359,0,0,0
332062,15,15,0,0,0
332069,137,137,0,0,0
332086,315,315,0,0,0
332092,76,76,0,0,0
332105,50,50,0,0,0
332106,8,8,0,0,0
332115,63,63,0,0,0
332124,3,3,0,0,0
332126,313,313,0,0,0
332127,74,74,0,0,0
332138,18,18,0,0,0
332140,130,130,0,0,0
332146,163,163,0,0,0
332169,58,58,0,0,0
332170,102,102,0,0,0
332174,76,76,0,0,0
332175,359,359,0,0,0
332199,252,252,0,0,0
332208,87,87,0,0,0
332225,232,232,0,0,0
332226,25,25,0,0,0
332234,193,193,0,0,0
332240,94,94,0,0,0
332242,282,282,0,0,0
332249,70,70,0,0,0
332256,43,43,0,0,0
332259,76,76,0,0,0
332279,353,353,0,0,0
332317,259,259,0,0,0
332327,143,143,0,0,0
332352,87,87,0,0,0
332364,130,130,0,0,0
332365,121,121,0,0,0
332372,167,167,0,0,0
332383,184,184,0,0,0
332393,168,168,0,0,0
332402,94,94,0,0,0
332430,58,58,0,0,0
332441,402,402,0,0,0
332449,193,193,0,0,0
332462,184,184,0,0,0
332480,102,102,0,0,0
332482,163,163,0,0,0
332499,137,137,0,0,0
332524,71,71,0,0,0
332538,310,310,0,0,0
332551,113,113,0,0,0
332554,158,158,0,0,0
332559,75,75,0,0,0
332564,345,345,0,0,0
332565,102,102,0,0,0
332573,87,87,0,0,0
332580,39,39,0,0,0
332592,70,70,0,0,0
332610,97,97,0,0,0
332645,143,143,0,0,0
332659,193,193,0,0,0
332675,359,359,0,0,0
332710,158,158,0,0,0
332719,315,315,0,0,0
332727,345,345,0,0,0
332728,121,121,0,0,0
332730,133,133,0,0,0
332735,163,163,0,0,0
332756,299,299,0,0,0
332762,67,67,0,0,0
332780,246,246,0,0,0
332811,25,25,0,0,0
332820,94,94,0,0,0
332843,281,281,0,0,0
332855,121,121,0,0,0
332858,359,359,0,0,0
332865,180,180,0,0,0
332866,232,232,0,0,0
332872,12,12,0,0,0
332883,251,251,0,0,0
332892,1,1,0,0,0
332907,310,310,0,0,0
332912,67,67,0,0,0
332916,27,27,0,0,0
332942,359,359,0,0,0
332944,282,282,0,0,0
332962,152,152,0,0,0
332989,34,34,0,0,0
332998,282,282,0,0,0
333001,87,87,0,0,0
333033,315,315,0,0,0
333072,102,102,0,0,0
333079,359,359,0,0,0
333081,87,87,0,0,0
333097,143,143,0,0,0
333100,94,94,0,0,0
333106,315,315,0,0,0
333121,13,13,0,0,0
333135,25,25,0,0,0
333159,55,55,0,0,0
333174,180,180,0,0,0
333185,29,29,0,0,0
333189,19,19,0,0,0
333194,114,114,0,0,0
333195,128,128,0,0,0
333198,345,345,0,0,0
333234,359,359,0,0,0
333238,313,313,0,0,0
333250,102,102,0,0,0
333258,158,158,0,0,0
333259,55,55,0,0,0
333275,193,193,0,0,0
333284,402,402,0,0,0
333293,251,251,0,0,0
333307,20,20,0,0,0
333338,313,313,0,0,0
333340,7,7,0,0,0
333357,76,76,0,0,0
333358,27,27,0,0,0
333368,121,121,0,0,0
333374,114,114,0,0,0
333378,359,359,0,0,0
333387,168,168,0,0,0
333402,353,353,0,0,0
333407,251,251,0,0,0
333433,72,72,0,0,0
333446,27,27,0,0,0
333461,35,35,0,0,0
333471,232,232,0,0,0
333472,232,232,0,0,0
333473,359,359,0,0,0
333481,27,27,0,0,0
333487,10,10,0,0,0
333489,315,315,0,0,0
333518,306,306,0,0,0
333519,353,353,0,0,0
333521,359,359,0,0,0
333534,76,76,0,0,0
333537,56,56,0,0,0
333540,9,9,0,0,0
333557,281,281,0,0,0
333565,255,255,0,0,0
333596,12,12,0,0,0
333598,128,128,0,0,0
333603,359,359,0,0,0
333609,315,315,0,0,0
333611,8,8,0,0,0
333649,131,131,0,0,0
333659,167,167,0,0,0
333660,306,306,0,0,0
333676,44,44,0,0,0
333679,102,102,0,0,0
333685,402,402,0,0,0
333687,21,21,0,0,0
333705,137,137,0,0,0
333726,171,171,0,0,0
333730,282,282,0,0,0
333737,402,402,0,0,0
333761,232,232,0,0,0
333771,255,255,0,0,0
333776,113,113,0,0,0
333794,252,252,0,0,0
333824,36,36,0,0,0
333830,70,70,0,0,0
333831,313,313,0,0,0
333834,69,69,0,0,0
333838,201,201,0,0,0
333851,85,85,0,0,0
333859,121,121,0,0,0
333865,114,114,0,0,0
333877,22,22,0,0,0
333881,130,130,0,0,0
333890,353,353,0,0,0
333912,144,144,0,0,0
333932,353,353,0,0,0
333934,144,144,0,0,0
333937,102,102,0,0,0
333941,359,359,0,0,0
333973,144,144,0,0,0
333980,167,167,0,0,0
333986,282,282,0,0,0
334000,19,19,0,0,0
334002,137,137,0,0,0
334006,58,58,0,0,0
334025,281,281,0,0,0
334033,34,34,0,0,0
334037,310,310,0,0,0
334039,201,201,0,0,0
334055,252,252,0,0,0
334072,353,353,0,0,0
334091,310,310,0,0,0
334114,137,137,0,0,0
334121,18,18,0,0,0
334127,76,76,0,0,0
334139,9,9,0,0,0
334147,171,171,0,0,0
334153,137,137,0,0,0
334173,306,306,0,0,0
334191,402,402,0,0,0
334214,97,97,0,0,0
334224,163,163,0,0,0
334230,87,87,0,0,0
334231,359,359,0,0,0
334242,121,121,0,0,0
334257,113,113,0,0,0
334258,198,198,0,0,0
334259,87,87,0,0,0
334267,4,4,0,0,0
334269,71,71,0,0,0
334281,76,76,0,0,0
334289,259,259,0,0,0
334290,252,252,0,0,0
334295,137,137,0,0,0
334309,310,310,0,0,0
334318,246,246,0,0,0
334331,246,246,0,0,0
334338,41,41,0,0,0
334344,50,50,0,0,0
334356,198,198,0,0,0
334362,22,22,0,0,0
334367,76,76,0,0,0
334379,184,184,0,0,0
334385,12,12,0,0,0
334386,7,7,0,0,0
334388,65,65,0,0,0
334406,252,252,0,0,0
334419,57,57,0,0,0
334433,113,113,0,0,0
334438,198,198,0,0,0
334443,151,151,0,0,0
334444,255,255,0,0,0
334452,306,306,0,0,0
334480,306,306,0,0,0
334498,151,151,0,0,0
334499,29,29,0,0,0
334503,251,251,0,0,0
334524,246,246,0,0,0
334529,313,313,0,0,0
334534,310,310,0,0,0
334551,259,259,0,0,0
334557,137,137,0,0,0
334559,198,198,0,0,0
334564,102,102,0,0,0
334578,15,15,0,0,0
334604,101,101,0,0,0
334608,36,36,0,0,0
334638,3,3,0,0,0
334647,315,315,0,0,0
334654,252,252,0,0,0
334663,40,40,0,0,0
334667,359,359,0,0,0
334674,167,167,0,0,0
334679,158,158,0,0,0
334686,158,158,0,0,0
334691,131,131,0,0,0
334707,315,315,0,0,0
334719,251,251,0,0,0
334720,315,315,0,0,0
334737,24,24,0,0,0
334758,313,313,0,0,0
334772,310,310,0,0,0
334773,345,345,0,0,0
334782,315,315,0,0,0
334784,313,313,0,0,0
334815,299,299,0,0,0
334816,163,163,0,0,0
334821,114,114,0,0,0
334829,193,193,0,0,0
334831,281,281,0,0,0
334848,65,65,0,0,0
334850,7,7,0,0,0
334852,39,39,0,0,0
334857,82,82,0,0,0
334858,102,102,0,0,0
334861,144,144,0,0,0
334910,114,114,0,0,0
334927,14,14,0,0,0
334940,121,121,0,0,0
334953,50,50,0,0,0
334993,102,102,0,0,0
335028,353,353,0,0,0
335029,232,232,0,0,0
335051,353,353,0,0,0
335054,83,83,0,0,0
335064,402,402,0,0,0
335079,252,252,0,0,0
335100,137,137,0,0,0
335110,66,66,0,0,0
335111,310,310,0,0,0
335115,97,97,0,0,0
335124,7,7,0,0,0
335144,128,128,0,0,0
335187,232,232,0,0,0
335189,87,87,0,0,0
335199,158,158,0,0,0
335222,167,167,0,0,0
335225,310,310,0,0,0
335229,85,85,0,0,0
335249,87,87,0,0,0
335259,359,359,0,0,0
335276,29,29,0,0,0
335289,25,25,0,0,0
335291,114,114,0,0,0
335292,55,55,0,0,0
335298,282,282,0,0,0
335304,402,402,0,0,0
335310,35,35,0,0,0
335323,121,121,0,0,0
335331,23,23,0,0,0
335332,25,25,0,0,0
335351,359,359,0,0,0
335359,402,402,0,0,0
335392,34,34,0,0,0
335399,114,114,0,0,0
335401,299,299,0,0,0
335408,259,259,0,0,0
335414,246,246,0,0,0
335415,57,57,0,0,0
335434,102,102,0,0,0
335438,167,167,0,0,0
335452,44,44,0,0,0
335453,114,114,0,0,0
335471,34,34,0,0,0
335497,345,345,0,0,0
335501,25,25,0,0,0
335503,4,4,0,0,0
335522,43,43,0,0,0
335527,30,30,0,0,0
335538,353,353,0,0,0
335554,144,144,0,0,0
335559,12,12,0,0,0
335564,167,167,0,0,0
335566,353,353,0,0,0
335586,2,2,0,0,0
335594,252,252,0,0,0
335609,345,345,0,0,0
335617,85,85,0,0,0
335620,20,20,0,0,0
335621,252,252,0,0,0
335624,24,24,0,0,0
335625,35,35,0,0,0
335627,75,75,0,0,0
335642,299,299,0,0,0
335661,70,70,0,0,0
335681,198,198,0,0,0
335715,359,359,0,0,0
335722,82,82,0,0,0
335732,8,8,0,0,0
335734,306,306,0,0,0
335738,259,259,0,0,0
335756,180,180,0,0,0
335776,198,198,0,0,0
335801,151,151,0,0,0
335827,171,171,0,0,0
335846,246,246,0,0,0
335859,402,402,0,0,0
335880,359,359,0,0,0
335889,359,359,0,0,0
335891,193,193,0,0,0
335895,121,121,0,0,0
335907,128,128,0,0,0
335924,121,121,0,0,0
335926,353,353,0,0,0
335927,4,4,0,0,0
335967,252,252,0,0,0
335972,131,131,0,0,0
336009,310,310,0,0,0
336028,310,310,0,0,0
336051,315,315,0,0,0
336054,168,168,0,0,0
336056,255,255,0,0,0
336082,180,180,0,0,0
336112,12,12,0,0,0
336120,121,121,0,0,0
336136,299,299,0,0,0
336141,18,18,0,0,0
336164,359,359,0,0,0
336167,359,359,0,0,0
336184,168,168,0,0,0
336186,345,345,0,0,0
336190,6,6,0,0,0
336200,281,281,0,0,0
336201,171,171,0,0,0
336202,66,66,0,0,0
336250,44,44,0,0,0
336251,36,36,0,0,0
336260,121,121,0,0,0
336261,252,252,0,0,0
336266,15,15,0,0,0
336270,144,144,0,0,0
336284,128,128,0,0,0
336297,251,251,0,0,0
336298,74,74,0,0,0
336304,255,255,0,0,0
336326,40,40,0,0,0
336360,251,251,0,0,0
336369,359,359,0,0,0
336370,15,15,0,0,0
336375,143,143,0,0,0
336383,103,103,0,0,0
336387,72,72,0,0,0
336405,252,252,0,0,0
336408,72,72,0,0,0
336410,313,313,0,0,0
336463,19,19,0,0,0
336483,180,180,0,0,0
336488,114,114,0,0,0
336499,50,50,0,0,0
336510,137,137,0,0,0
336517,75,75,0,0,0
336568,144,144,0,0,0
336570,63,63,0,0,0
336584,102,102,0,0,0
336593,17,17,0,0,0
336613,198,198,0,0,0
336641,359,359,0,0,0
336649,402,402,0,0,0
336673,83,83,0,0,0
336677,193,193,0,0,0
336686,152,152,0,0,0
336692,17,17,0,0,0
336730,74,74,0,0,0
336764,58,58,0,0,0
336778,54,54,0,0,0
336785,20,20,0,0,0
336792,40,40,0,0,0
336806,43,43,0,0,0
336815,44,44,0,0,0
336816,198,198,0,0,0
336819,18,18,0,0,0
336834,259,259,0,0,0
336835,310,310,0,0,0
336837,121,121,0,0,0
336844,128,128,0,0,0
336866,232,232,0,0,0
336871,70,70,0,0,0
336877,113,113,0,0,0
336879,193,193,0,0,0
336886,24,24,0,0,0
336896,36,36,0,0,0
336900,163,163,0,0,0
336902,315,315,0,0,0
336914,25,25,0,0,0
336916,402,402,0,0,0
336922,34,34,0,0,0
336924,1,1,0,0,0
336931,402,402,0,0,0
336932,310,310,0,0,0
336935,102,102,0,0,0
336937,198,198,0,0,0
336941,131,131,0,0,0
336952,171,171,0,0,0
336970,198,198,0,0,0
336971,113,113,0,0,0
336977,113,113,0,0,0
336982,313,313,0,0,0
336986,114,114,0,0,0
336996,180,180,0,0,0
337009,25,25,0,0,0
337012,76,76,0,0,0
337015,313,313,0,0,0
337023,315,315,0,0,0
337030,18,18,0,0,0
337035,167,167,0,0,0
337037,70,70,0,0,0
337051,252,252,0,0,0
337069,259,259,0,0,0
337090,56,56,0,0,0
337092,70,70,0,0,0
337096,255,255,0,0,0
337102,101,101,0,0,0
337119,18,18,0,0,0
337120,345,345,0,0,0
337125,57,57,0,0,0
337142,128,128,0,0,0
337146,3,3,0,0,0
337148,167,167,0,0,0
337170,313,313,0,0,0
337182,54,54,0,0,0
337187,22,22,0,0,0
337193,282,282,0,0,0
337216,251,251,0,0,0
337217,9,9,0,0,0
337221,255,255,0,0,0
337230,102,102,0,0,0
337234,7,7,0,0,0
337246,345,345,0,0,0
337256,259,259,0,0,0
337270,103,103,0,0,0
337276,70,70,0,0,0
337289,255,255,0,0,0
337290,232,232,0,0,0
337293,1,1,0,0,0
337296,201,201,0,0,0
337329,252,252,0,0,0
337331,158,158,0,0,0
337334,56,56,0,0,0
337358,345,345,0,0,0
337375,35,35,0,0,0
337379,3,3,0,0,0
337384,251,251,0,0,0
337393,299,299,0,0,0
337413,7,7,0,0,0
337455,359,359,0,0,0
337459,35,35,0,0,0
337471,171,171,0,0,0
337474,23,23,0,0,0
337493,114,114,0,0,0
337536,259,259,0,0,0
337541,45,45,0,0,0
337545,121,121,0,0,0
337550,28,28,0,0,0
337554,151,151,0,0,0
337562,345,345,0,0,0
337567,16,16,0,0,0
337582,103,103,0,0,0
337612,40,40,0,0,0
337617,75,75,0,0,0
337628,15,15,0,0,0
337644,345,345,0,0,0
337649,259,259,0,0,0
337677,315,315,0,0,0
337680,102,102,0,0,0
337706,34,34,0,0,0
337713,29,29,0,0,0
337724,102,102,0,0,0
337726,63,63,0,0,0
337738,246,246,0,0,0
337743,120,120,0,0,0
337746,255,255,0,0,0
337749,193,193,0,0,0
337750,359,359,0,0,0
337751,76,76,0,0,0
337752,193,193,0,0,0
337760,315,315,0,0,0
337766,359,359,0,0,0
337774,402,402,0,0,0
337777,184,184,0,0,0
337790,130,130,0,0,0
337798,306,306,0,0,0
337803,359,359,0,0,0
337806,76,76,0,0,0
337810,299,299,0,0,0
337813,353,353,0,0,0
337815,66,66,0,0,0
337822,143,143,0,0,0
337834,252,252,0,0,0
337843,29,29,0,0,0
337851,259,259,0,0,0
337854,310,310,0,0,0
337863,306,306,0,0,0
337880,315,315,0,0,0
337902,281,281,0,0,0
337912,259,259,0,0,0
337914,39,39,0,0,0
337917,345,345,0,0,0
337938,402,402,0,0,0
337950,56,56,0,0,0
337958,168,168,0,0,0
337961,310,310,0,0,0
337962,259,259,0,0,0
337984,315,315,0,0,0
337985,3,3,0,0,0
337989,29,29,0,0,0
337994,101,101,0,0,0
338007,255,255,0,0,0
338010,246,246,0,0,0
338030,137,137,0,0,0
338035,133,133,0,0,0
338054,246,246,0,0,0
338064,121,121,0,0,0
338068,103,103,0,0,0
338071,313,313,0,0,0
338074,22,22,0,0,0
338082,3,3,0,0,0
338098,143,143,0,0,0
338102,167,167,0,0,0
338124,137,137,0,0,0
338135,252,252,0,0,0
338186,299,299,0,0,0
338189,180,180,0,0,0
338191,9,9,0,0,0
338203,255,255,0,0,0
338225,252,252,0,0,0
338240,74,74,0,0,0
338242,259,259,0,0,0
338252,50,50,0,0,0
338253,13,13,0,0,0
338260,152,152,0,0,0
338263,44,44,0,0,0
338268,9,9,0,0,0
338285,3,3,0,0,0
338288,36,36,0,0,0
338310,402,402,0,0,0
338312,184,184,0,0,0
338318,345,345,0,0,0
338332,121,121,0,0,0
338334,144,144,0,0,0
338348,252,252,0,0,0
338350,137,137,0,0,0
338357,14,14,0,0,0
338370,121,121,0,0,0
338390,16,16,0,0,0
338402,36,36,0,0,0
338404,402,402,0,0,0
338444,76,76,0,0,0
338458,55,55,0,0,0
338463,306,306,0,0,0
338487,32,32,0,0,0
338502,313,313,0,0,0
338512,359,359,0,0,0
338514,313,313,0,0,0
338525,255,255,0,0,0
338549,32,32,0,0,0
338556,282,282,0,0,0
338574,18,18,0,0,0
338585,359,359,0,0,0
338587,10,10,0,0,0
338590,74,74,0,0,0
338599,313,313,0,0,0
338601,232,232,0,0,0
338602,54,54,0,0,0
338606,299,299,0,0,0
338624,282,282,0,0,0
338637,158,158,0,0,0
338640,102,102,0,0,0
338683,259,259,0,0,0
338706,359,359,0,0,0
338712,201,201,0,0,0
338717,16,16,0,0,0
338746,76,76,0,0,0
338759,402,402,0,0,0
338772,315,315,0,0,0
338787,180,180,0,0,0
338800,3,3,0,0,0
338813,101,101,0,0,0
338847,69,69,0,0,0
338869,50,50,0,0,0
338876,201,201,0,0,0
338881,36,36,0,0,0
338883,345,345,0,0,0
338899,71,71,0,0,0
338914,121,121,0,0,0
338961,299,299,0,0,0
338964,72,72,0,0,0
338970,198,198,0,0,0
338971,151,151,0,0,0
338977,259,259,0,0,0
338993,4,4,0,0,0
338999,29,29,0,0,0
339007,180,180,0,0,0
339020,310,310,0,0,0
339023,359,359,0,0,0
339026,72,72,0,0,0
339027,306,306,0,0,0
339032,402,402,0,0,0
339038,94,94,0,0,0
339047,56,56,0,0,0
339052,18,18,0,0,0
339056,137,137,0,0,0
339065,15,15,0,0,0
339074,74,74,0,0,0
339084,71,71,0,0,0
339110,2,2,0,0,0
339116,353,353,0,0,0
339151,310,310,0,0,0
339155,306,306,0,0,0
339157,252,252,0,0,0
339168,152,152,0,0,0
339171,137,137,0,0,0
339178,36,36,0,0,0
339180,9,9,0,0,0
339190,28,28,0,0,0
339192,71,71,0,0,0
339222,306,306,0,0,0
339234,251,251,0,0,0
339236,353,353,0,0,0
339257,74,74,0,0,0
339260,43,43,0,0,0
339282,77,77,0,0,0
339306,1,1,0,0,0
339311,130,130,0,0,0
339332,306,306,0,0,0
339339,168,168,0,0,0
339348,402,402,0,0,0
339352,65,65,0,0,0
339354,20,20,0,0,0
339355,402,402,0,0,0
339395,43,43,0,0,0
339400,306,306,0,0,0
339403,158,158,0,0,0
339405,15,15,0,0,0
339406,24,24,0,0,0
339439,45,45,0,0,0
339444,359,359,0,0,0
339450,29,29,0,0,0
339468,2,2,0,0,0
339477,133,133,0,0,0
339485,9,9,0,0,0
339491,193,193,0,0,0
339495,313,313,0,0,0
339503,310,310,0,0,0
339516,137,137,0,0,0
339517,43,43,0,0,0
339540,87,87,0,0,0
339574,281,281,0,0,0
339582,137,137,0,0,0
339585,232,232,0,0,0
339590,345,345,0,0,0
339602,402,402,0,0,0
339634,143,143,0,0,0
339635,345,345,0,0,0
339640,22,22,0,0,0
339647,66,66,0,0,0
339648,359,359,0,0,0
339673,345,345,0,0,0
339711,232,232,0,0,0
339714,144,144,0,0,0
339728,315,315,0,0,0
339746,168,168,0,0,0
339749,50,50,0,0,0
339764,299,299,0,0,0
339772,7,7,0,0,0
339780,114,114,0,0,0
339790,259,259,0,0,0
339804,281,281,0,0,0
339807,77,77,0,0,0
339819,281,281,0,0,0
339839,25,25,0,0,0
339851,299,299,0,0,0
339852,8,8,0,0,0
339864,168,168,0,0,0
339865,315,315,0,0,0
339900,315,315,0,0,0
339918,255,255,0,0,0
339923,246,246,0,0,0
339928,359,359,0,0,0
339938,168,168,0,0,0
339947,25,25,0,0,0
339948,353,353,0,0,0
339974,120,120,0,0,0
340003,168,168,0,0,0
340007,402,402,0,0,0
340014,102,102,0,0,0
340022,313,313,0,0,0
340027,353,353,0,0,0
340058,121,121,0,0,0
340076,198,198,0,0,0
340077,30,30,0,0,0
340100,70,70,0,0,0
340102,201,201,0,0,0
340127,130,130,0,0,0
340136,34,34,0,0,0
340149,128,128,0,0,0
340162,198,198,0,0,0
340166,25,25,0,0,0
340175,131,131,0,0,0
340176,101,101,0,0,0
340179,32,32,0,0,0
340181,29,29,0,0,0
340205,10,10,0,0,0
340206,184,184,0,0,0
340208,74,74,0,0,0
340227,252,252,0,0,0
340247,4,4,0,0,0
340294,313,313,0,0,0
340321,313,313,0,0,0
340323,63,63,0,0,0
340330,282,282,0,0,0
340334,32,32,0,0,0
340341,114,114,0,0,0
340344,359,359,0,0,0
340352,8,8,0,0,0
340361,94,94,0,0,0
340374,345,345,0,0,0
340378,143,143,0,0,0
340400,180,180,0,0,0
340422,315,315,0,0,0
340439,180,180,0,0,0
340455,359,359,0,0,0
340458,152,152,0,0,0
340461,137,137,0,0,0
340466,163,163,0,0,0
340467,353,353,0,0,0
340468,113,113,0,0,0
340471,40,40,0,0,0
340473,28,28,0,0,0
340476,137,137,0,0,0
340489,306,306,0,0,0
340491,306,306,0,0,0
340502,259,259,0,0,0
340510,315,315,0,0,0
340530,83,83,0,0,0
340547,402,402,0,0,0
340554,9,9,0,0,0
340561,184,184,0,0,0
340563,168,168,0,0,0
340580,306,306,0,0,0
340608,171,171,0,0,0
340611,232,232,0,0,0
340613,103,103,0,0,0
340627,151,151,0,0,0
340640,152,152,0,0,0
340648,20,20,0,0,0
340662,10,10,0,0,0
340689,74,74,0,0,0
340691,137,137,0,0,0
340715,151,151,0,0,0
340718,353,353,0,0,0
340732,252,252,0,0,0
340751,345,345,0,0,0
340760,45,45,0,0,0
340771,29,29,0,0,0
340773,8,8,0,0,0
340779,180,180,0,0,0
340781,345,345,0,0,0
340787,132,132,0,0,0
340796,71,71,0,0,0
340806,198,198,0,0,0
340823,281,281,0,0,0
340830,198,198,0,0,0
340841,83,83,0,0,0
340852,16,16,0,0,0
340862,12,12,0,0,0
340870,36,36,0,0,0
340881,114,114,0,0,0
340891,75,75,0,0,0
340922,23,23,0,0,0
340932,82,82,0,0,0
340934,121,121,0,0,0
340935,24,24,0,0,0
340983,94,94,0,0,0
341007,232,232,0,0,0
341013,255,255,0,0,0
341027,359,359,0,0,0
341034,22,22,0,0,0
341045,3,3,0,0,0
341046,71,71,0,0,0
341049,310,310,0,0,0
341059,50,50,0,0,0
341081,353,353,0,0,0
341089,24,24,0,0,0
341098,121,121,0,0,0
341105,180,180,0,0,0
341110,402,402,0,0,0
341117,54,54,0,0,0
341130,259,259,0,0,0
341139,44,44,0,0,0
341150,168,168,0,0,0
341157,251,251,0,0,0
341158,345,345,0,0,0
341204,131,131,0,0,0
341222,94,94,0,0,0
341236,82,82,0,0,0
341248,143,143,0,0,0
341257,101,101,0,0,0
341270,72,72,0,0,0
341271,3,3,0,0,0
341289,72,72,0,0,0
341293,87,87,0,0,0
341299,315,315,0,0,0
341303,17,17,0,0,0
341326,313,313,0,0,0
341330,50,50,0,0,0
341337,114,114,0,0,0
341338,193,193,0,0,0
341393,152,152,0,0,0
341394,353,353,0,0,0
341399,151,151,0,0,0
341408,251,251,0,0,0
341415,75,75,0,0,0
341417,171,171,0,0,0
341432,114,114,0,0,0
341451,163,163,0,0,0
341452,77,77,0,0,0
341454,35,35,0,0,0
341456,3,3,0,0,0
341495,130,130,0,0,0
341513,12,12,0,0,0
341516,313,313,0,0,0
341519,9,9,0,0,0
341536,246,246,0,0,0
341565,306,306,0,0,0
341567,102,102,0,0,0
341605,102,102,0,0,0
341625,36,36,0,0,0
341626,65,65,0,0,0
341630,137,137,0,0,0
341633,18,18,0,0,0
341635,310,310,0,0,0
341638,128,128,0,0,0
341666,121,121,0,0,0
341667,353,353,0,0,0
341681,345,345,0,0,0
341690,137,137,0,0,0
341697,255,255,0,0,0
341701,282,282,0,0,0
341728,255,255,0,0,0
341739,359,359,0,0,0
341753,17,17,0,0,0
341769,180,180,0,0,0
341812,58,58,0,0,0
341813,24,24,0,0,0
341815,39,39,0,0,0
341822,34,34,0,0,0
341832,180,180,0,0,0
341833,97,97,0,0,0
341835,345,345,0,0,0
341840,131,131,0,0,0
341846,402,402,0,0,0
341859,252,252,0,0,0
341888,5,5,0,0,0
341914,184,184,0,0,0
341926,35,35,0,0,0
341935,281,281,0,0,0
341945,201,201,0,0,0
341959,43,43,0,0,0
341960,128,128,0,0,0
341966,232,232,0,0,0
341977,359,359,0,0,0
341986,143,143,0,0,0
341987,299,299,0,0,0
341988,315,315,0,0,0
342004,8,8,0,0,0
342010,201,201,0,0,0
342013,313,313,0,0,0
342015,15,15,0,0,0
342019,402,402,0,0,0
342022,310,310,0,0,0
342037,102,102,0,0,0
342073,353,353,0,0,0
342077,180,180,0,0,0
342095,359,359,0,0,0
342097,102,102,0,0,0
342101,137,137,0,0,0
342117,54,54,0,0,0
342118,103,103,0,0,0
342136,97,97,0,0,0
342147,3,3,0,0,0
342155,315,315,0,0,0
342162,121,121,0,0,0
342166,282,282,0,0,0
342171,32,32,0,0,0
342180,345,345,0,0,0
342188,198,198,0,0,0
342200,359,359,0,0,0
342227,315,315,0,0,0
342231,251,251,0,0,0
342236,402,402,0,0,0
342237,345,345,0,0,0
342239,27,27,0,0,0
342248,128,128,0,0,0
342258,282,282,0,0,0
342288,29,29,0,0,0
342293,310,310,0,0,0
342333,8,8,0,0,0
342359,19,19,0,0,0
342361,255,255,0,0,0
342362,402,402,0,0,0
342365,133,133,0,0,0
342377,282,282,0,0,0
342388,281,281,0,0,0
342391,180,180,0,0,0
342403,158,158,0,0,0
342408,184,184,0,0,0
342409,193,193,0,0,0
342413,255,255,0,0,0
342420,246,246,0,0,0
342432,15,15,0,0,0
342446,310,310,0,0,0
342447,313,313,0,0,0
342461,168,168,0,0,0
342475,66,66,0,0,0
342481,67,67,0,0,0
342483,402,402,0,0,0
342511,58,58,0,0,0
342517,251,251,0,0,0
342520,252,252,0,0,0
342521,299,299,0,0,0
342527,144,144,0,0,0
342537,232,232,0,0,0
342540,143,143,0,0,0
342553,232,232,0,0,0
342555,281,281,0,0,0
342578,74,74,0,0,0
342581,19,19,0,0,0
342589,252,252,0,0,0
342596,14,14,0,0,0
342603,44,44,0,0,0
342610,8,8,0,0,0
342620,299,299,0,0,0
342621,54,54,0,0,0
342623,144,144,0,0,0
342625,168,168,0,0,0
342629,74,74,0,0,0
342644,85,85,0,0,0
342647,315,315,0,0,0
342651,56,56,0,0,0
342675,113,113,0,0,0
342694,282,282,0,0,0
342706,163,163,0,0,0
342716,359,359,0,0,0
342745,359,359,0,0,0
342751,16,16,0,0,0
342755,255,255,0,0,0
342786,193,193,0,0,0
342789,359,359,0,0,0
342799,29,29,0,0,0
342838,143,143,0,0,0
342850,132,132,0,0,0
342858,353,353,0,0,0
342872,299,299,0,0,0
342898,15,15,0,0,0
342911,82,82,0,0,0
342941,193,193,0,0,0
342951,232,232,0,0,0
342962,313,313,0,0,0
342993,144,144,0,0,0
342995,353,353,0,0,0
343008,82,82,0,0,0
343042,306,306,0,0,0
343044,246,246,0,0,0
343053,85,85,0,0,0
343064,171,171,0,0,0
343068,306,306,0,0,0
343073,310,310,0,0,0
343074,130,130,0,0,0
343081,77,77,0,0,0
343084,281,281,0,0,0
343094,232,232,0,0,0
343109,44,44,0,0,0
343110,69,69,0,0,0
343160,201,201,0,0,0
343162,359,359,0,0,0
343169,67,67,0,0,0
343170,402,402,0,0,0
343177,32,32,0,0,0
343182,57,57,0,0,0
343183,180,180,0,0,0
343201,5,5,0,0,0
343208,345,345,0,0,0
343219,252,252,0,0,0
343233,27,27,0,0,0
343244,76,76,0,0,0
343251,144,144,0,0,0
343254,85,85,0,0,0
343258,144,144,0,0,0
343269,121,121,0,0,0
343290,1,1,0,0,0
343297,114,114,0,0,0
343298,299,299,0,0,0
343307,23,23,0,0,0
343325,246,246,0,0,0
343329,101,101,0,0,0
343339,252,252,0,0,0
343360,3,3,0,0,0
343379,128,128,0,0,0
343403,152,152,0,0,0
343406,345,345,0,0,0
343411,163,163,0,0,0
343420,252,252,0,0,0
343422,299,299,0,0,0
343432,151,151,0,0,0
343434,114,114,0,0,0
343435,315,315,0,0,0
343439,198,198,0,0,0
343449,35,35,0,0,0
343472,167,167,0,0,0
343473,299,299,0,0,0
343485,198,198,0,0,0
343497,25,25,0,0,0
343502,72,72,0,0,0
343510,345,345,0,0,0
343521,201,201,0,0,0
343522,201,201,0,0,0
343551,12,12,0,0,0
343555,198,198,0,0,0
343612,102,102,0,0,0
343613,144,144,0,0,0
343625,345,345,0,0,0
343633,255,255,0,0,0
343645,167,167,0,0,0
343646,232,232,0,0,0
343662,113,113,0,0,0
343666,315,315,0,0,0
343673,25,25,0,0,0
343687,315,315,0,0,0
343699,137,137,0,0,0
343701,315,315,0,0,0
343707,133,133,0,0,0
343718,25,25,0,0,0
343729,120,120,0,0,0
343751,315,315,0,0,0
343756,180,180,0,0,0
343761,402,402,0,0,0
343773,299,299,0,0,0
343774,306,306,0,0,0
343804,32,32,0,0,0
343805,50,50,0,0,0
343821,193,193,0,0,0
343829,82,82,0,0,0
343851,184,184,0,0,0
343862,58,58,0,0,0
343868,101,101,0,0,0
343886,171,171,0,0,0
343890,69,69,0,0,0
343894,77,77,0,0,0
343896,193,193,0,0,0
343897,76,76,0,0,0
343908,246,246,0,0,0
343916,152,152,0,0,0
343923,315,315,0,0,0
343968,306,306,0,0,0
343969,158,158,0,0,0
343988,255,255,0,0,0
343989,63,63,0,0,0
343998,282,282,0,0,0
344012,102,102,0,0,0
344027,55,55,0,0,0
344030,306,306,0,0,0
344034,353,353,0,0,0
344044,255,255,0,0,0
344050,27,27,0,0,0
344053,143,143,0,0,0
344058,315,315,0,0,0
344059,232,232,0,0,0
344072,259,259,0,0,0
344073,103,103,0,0,0
344107,101,101,0,0,0
344111,281,281,0,0,0
344112,282,282,0,0,0
344118,246,246,0,0,0
344123,345,345,0,0,0
344130,18,18,0,0,0
344144,315,315,0,0,0
344145,353,353,0,0,0
344150,158,158,0,0,0
344188,313,313,0,0,0
344193,10,10,0,0,0
344197,310,310,0,0,0
344222,131,131,0,0,0
344233,34,34,0,0,0
344241,128,128,0,0,0
344242,137,137,0,0,0
344267,131,131,0,0,0
344271,359,359,0,0,0
344288,345,345,0,0,0
344291,315,315,0,0,0
344295,259,259,0,0,0
344334,87,87,0,0,0
344344,13,13,0,0,0
344348,102,102,0,0,0
344355,281,281,0,0,0
344364,163,163,0,0,0
344384,167,167,0,0,0
344389,281,281,0,0,0
344391,353,353,0,0,0
344393,17,17,0,0,0
344396,402,402,0,0,0
344402,168,168,0,0,0
344433,5,5,0,0,0
344443,353,353,0,0,0
344444,306,306,0,0,0
344455,306,306,0,0,0
344470,252,252,0,0,0
344493,121,121,0,0,0
344504,55,55,0,0,0
344508,72,72,0,0,0
344527,306,306,0,0,0
344537,83,83,0,0,0
344542,17,17,0,0,0
344557,306,306,0,0,0
344572,71,71,0,0,0
344581,4,4,0,0,0
344583,128,128,0,0,0
344592,252,252,0,0,0
344596,402,402,0,0,0
344602,167,167,0,0,0
344614,345,345,0,0,0
344621,259,259,0,0,0
344633,255,255,0,0,0
344643,198,198,0,0,0
344646,359,359,0,0,0
344671,29,29,0,0,0
344680,171,171,0,0,0
344681,25,25,0,0,0
344682,232,232,0,0,0
344693,121,121,0,0,0
344697,158,158,0,0,0
344711,281,281,0,0,0
344723,315,315,0,0,0
344736,87,87,0,0,0
344739,14,14,0,0,0
344741,28,28,0,0,0
344756,315,315,0,0,0
344774,128,128,0,0,0
344785,2,2,0,0,0
344819,255,255,0,0,0
344860,15,15,0,0,0
344870,101,101,0,0,0
344881,120,120,0,0,0
344883,281,281,0,0,0
344894,30,30,0,0,0
344917,25,25,0,0,0
344934,359,359,0,0,0
344943,184,184,0,0,0
344957,137,137,0,0,0
344970,171,171,0,0,0
344982,151,151,0,0,0
344987,14,14,0,0,0
344992,56,56,0,0,0
345033,71,71,0,0,0
345034,168,168,0,0,0
345043,69,69,0,0,0
345089,34,34,0,0,0
345109,184,184,0,0,0
345113,128,128,0,0,0
345134,114,114,0,0,0
345142,201,201,0,0,0
345144,310,310,0,0,0
345153,180,180,0,0,0
345160,152,152,0,0,0
345168,306,306,0,0,0
345182,299,299,0,0,0
345183,144,144,0,0,0
345198,97,97,0,0,0
345202,310,310,0,0,0
345203,18,18,0,0,0
345220,345,345,0,0,0
345228,16,16,0,0,0
345248,57,57,0,0,0
345249,87,87,0,0,0
345251,313,313,0,0,0
345261,102,102,0,0,0
345265,180,180,0,0,0
345277,315,315,0,0,0
345280,66,66,0,0,0
345289,306,306,0,0,0
345296,15,15,0,0,0
345310,21,21,0,0,0
345331,310,310,0,0,0
345333,299,299,0,0,0
345355,74,74,0,0,0
345375,255,255,0,0,0
345383,70,70,0,0,0
345401,306,306,0,0,0
345405,255,255,0,0,0
345422,310,310,0,0,0
345457,22,22,0,0,0
345465,121,121,0,0,0
345482,113,113,0,0,0
345491,201,201,0,0,0
345496,82,82,0,0,0
345498,143,143,0,0,0
345512,34,34,0,0,0
345513,259,259,0,0,0
345533,259,259,0,0,0
345538,281,281,0,0,0
345551,313,313,0,0,0
345557,402,402,0,0,0
345558,158,158,0,0,0
345566,74,74,0,0,0
345578,67,67,0,0,0
345595,193,193,0,0,0
345602,128,128,0,0,0
345604,76,76,0,0,0
345609,315,315,0,0,0
345611,163,163,0,0,0
345620,35,35,0,0,0
345621,114,114,0,0,0
345629,167,167,0,0,0
345633,34,34,0,0,0
345635,70,70,0,0,0
345661,97,97,0,0,0
345669,306,306,0,0,0
345688,5,5,0,0,0
345695,313,313,0,0,0
345726,94,94,0,0,0
345757,201,201,0,0,0
345764,137,137,0,0,0
345773,87,87,0,0,0
345775,282,282,0,0,0
345803,313,313,0,0,0
345813,71,71,0,0,0
345822,345,345,0,0,0
345824,20,20,0,0,0
345838,131,131,0,0,0
345845,101,101,0,0,0
345859,359,359,0,0,0
345872,306,306,0,0,0
345875,114,114,0,0,0
345889,252,252,0,0,0
345891,133,133,0,0,0
345898,171,171,0,0,0
345901,55,55,0,0,0
345907,402,402,0,0,0
345918,94,94,0,0,0
345928,101,101,0,0,0
345930,232,232,0,0,0
345946,255,255,0,0,0
345965,137,137,0,0,0
345971,94,94,0,0,0
345987,44,44,0,0,0
345989,201,201,0,0,0
346003,13,13,0,0,0
346007,16,16,0,0,0
346011,313,313,0,0,0
346012,101,101,0,0,0
346017,180,180,0,0,0
346019,35,35,0,0,0
346042,168,168,0,0,0
346066,310,310,0,0,0
346071,151,151,0,0,0
346081,359,359,0,0,0
346087,163,163,0,0,0
346098,232,232,0,0,0
346102,94,94,0,0,0
346112,246,246,0,0,0
346122,103,103,0,0,0
346123,353,353,0,0,0
346128,299,299,0,0,0
346145,251,251,0,0,0
346146,252,252,0,0,0
346162,128,128,0,0,0
346168,359,359,0,0,0
346199,121,121,0,0,0
346200,58,58,0,0,0
346207,85,85,0,0,0
346213,198,198,0,0,0
346225,76,76,0,0,0
346252,281,281,0,0,0
346258,255,255,0,0,0
346262,132,132,0,0,0
346295,180,180,0,0,0
346305,18,18,0,0,0
346319,299,299,0,0,0
346340,35,35,0,0,0
346348,259,259,0,0,0
346384,299,299,0,0,0
346401,19,19,0,0,0
346423,359,359,0,0,0
346442,43,43,0,0,0
346443,114,114,0,0,0
346446,114,114,0,0,0
346494,143,143,0,0,0
346504,50,50,0,0,0
346547,310,310,0,0,0
346565,359,359,0,0,0
346578,44,44,0,0,0
346580,246,246,0,0,0
346588,66,66,0,0,0
346594,171,171,0,0,0
346600,255,255,0,0,0
346609,44,44,0,0,0
346618,16,16,0,0,0
346619,167,167,0,0,0
346631,402,402,0,0,0
346633,306,306,0,0,0
346662,137,137,0,0,0
346669,132,132,0,0,0
346694,299,299,0,0,0
346697,168,168,0,0,0
346723,130,130,0,0,0
346730,158,158,0,0,0
346736,171,171,0,0,0
346738,259,259,0,0,0
346749,6,6,0,0,0
346756,22,22,0,0,0
346757,151,151,0,0,0
346760,144,144,0,0,0
346768,24,24,0,0,0
346777,25,25,0,0,0
346781,255,255,0,0,0
346783,151,151,0,0,0
346793,282,282,0,0,0
346814,251,251,0,0,0
346822,353,353,0,0,0
346828,282,282,0,0,0
346837,313,313,0,0,0
346841,180,180,0,0,0
346846,45,45,0,0,0
346851,121,121,0,0,0
346857,281,281,0,0,0
346864,130,130,0,0,0
346884,201,201,0,0,0
346896,114,114,0,0,0
346902,158,158,0,0,0
346912,232,232,0,0,0
346914,299,299,0,0,0
346916,345,345,0,0,0
346918,77,77,0,0,0
346938,315,315,0,0,0
346939,246,246,0,0,0
346964,39,39,0,0,0
346976,299,299,0,0,0
347020,24,24,0,0,0
347028,128,128,0,0,0
347036,281,281,0,0,0
347053,23,23,0,0,0
347059,306,306,0,0,0
347061,24,24,0,0,0
347062,29,29,0,0,0
347067,310,310,0,0,0
347072,7,7,0,0,0
347077,70,70,0,0,0
347080,281,281,0,0,0
347081,313,313,0,0,0
347092,246,246,0,0,0
347094,65,65,0,0,0
347101,18,18,0,0,0
347108,66,66,0,0,0
347110,359,359,0,0,0
347122,180,180,0,0,0
347134,23,23,0,0,0
347138,18,18,0,0,0
347148,34,34,0,0,0
347151,77,77,0,0,0
347157,2,2,0,0,0
347160,70,70,0,0,0
347161,246,246,0,0,0
347163,315,315,0,0,0
347169,306,306,0,0,0
347187,74,74,0,0,0
347188,232,232,0,0,0
347196,184,184,0,0,0
347211,87,87,0,0,0
347225,152,152,0,0,0
347228,158,158,0,0,0
347237,315,315,0,0,0
347243,246,246,0,0,0
347246,66,66,0,0,0
347256,102,102,0,0,0
347259,255,255,0,0,0
347262,144,144,0,0,0
347280,137,137,0,0,0
347281,168,168,0,0,0
347287,299,299,0,0,0
347295,76,76,0,0,0
347300,6,6,0,0,0
347313,310,310,0,0,0
347314,1,1,0,0,0
347327,359,359,0,0,0
347328,102,102,0,0,0
347330,281,281,0,0,0
347336,281,281,0,0,0
347346,43,43,0,0,0
347354,6,6,0,0,0
347366,198,198,0,0,0
347368,402,402,0,0,0
347385,114,114,0,0,0
347403,306,306,0,0,0
347413,128,128,0,0,0
347425,246,246,0,0,0
347434,402,402,0,0,0
347443,353,353,0,0,0
347451,11,11,0,0,0
347479,87,87,0,0,0
347487,306,306,0,0,0
347495,66,66,0,0,0
347496,299,299,0,0,0
347501,87,87,0,0,0
347504,281,281,0,0,0
347533,246,246,0,0,0
347536,168,168,0,0,0
347538,246,246,0,0,0
347547,10,10,0,0,0
347551,345,345,0,0,0
347552,50,50,0,0,0
347554,353,353,0,0,0
347557,4,4,0,0,0
347582,74,74,0,0,0
347590,130,130,0,0,0
347596,299,299,0,0,0
347607,17,17,0,0,0
347615,345,345,0,0,0
347621,402,402,0,0,0
347658,128,128,0,0,0
347673,167,167,0,0,0
347677,77,77,0,0,0
347694,29,29,0,0,0
347699,282,282,0,0,0
347712,255,255,0,0,0
347748,359,359,0,0,0
347762,144,144,0,0,0
347769,34,34,0,0,0
347775,77,77,0,0,0
347781,255,255,0,0,0
347789,255,255,0,0,0
347791,402,402,0,0,0
347794,5,5,0,0,0
347798,151,151,0,0,0
347823,19,19,0,0,0
347829,359,359,0,0,0
347831,131,131,0,0,0
347855,121,121,0,0,0
347872,184,184,0,0,0
347880,299,299,0,0,0
347887,251,251,0,0,0
347896,255,255,0,0,0
347932,120,120,0,0,0
347964,144,144,0,0,0
347973,1,1,0,0,0
347982,70,70,0,0,0
347986,12,12,0,0,0
348017,232,232,0,0,0
348028,402,402,0,0,0
348036,76,76,0,0,0
348045,11,11,0,0,0
348054,70,70,0,0,0
348062,353,353,0,0,0
348066,167,167,0,0,0
348085,152,152,0,0,0
348086,114,114,0,0,0
348092,101,101,0,0,0
348106,3,3,0,0,0
348107,259,259,0,0,0
348127,15,15,0,0,0
348143,63,63,0,0,0
348162,72,72,0,0,0
348183,137,137,0,0,0
348189,184,184,0,0,0
348214,50,50,0,0,0
348217,198,198,0,0,0
348230,40,40,0,0,0
348237,259,259,0,0,0
348250,306,306,0,0,0
348254,102,102,0,0,0
348257,158,158,0,0,0
348264,10,10,0,0,0
348267,359,359,0,0,0
348311,180,180,0,0,0
348319,102,102,0,0,0
348324,232,232,0,0,0
348347,313,313,0,0,0
348352,114,114,0,0,0
348360,152,152,0,0,0
348404,180,180,0,0,0
348411,345,345,0,0,0
348440,102,102,0,0,0
348474,133,133,0,0,0
348476,353,353,0,0,0
348478,345,345,0,0,0
348480,201,201,0,0,0
348529,345,345,0,0,0
348542,259,259,0,0,0
348556,102,102,0,0,0
348572,353,353,0,0,0
348581,121,121,0,0,0
348585,121,121,0,0,0
348619,144,144,0,0,0
348621,3,3,0,0,0
348626,114,114,0,0,0
348636,54,54,0,0,0
348640,299,299,0,0,0
348648,17,17,0,0,0
348662,74,74,0,0,0
348680,251,251,0,0,0
348689,56,56,0,0,0
348692,94,94,0,0,0
348718,315,315,0,0,0
348733,184,184,0,0,0
348769,121,121,0,0,0
348776,310,310,0,0,0
348779,315,315,0,0,0
348805,28,28,0,0,0
348833,158,158,0,0,0
348839,35,35,0,0,0
348846,137,137,0,0,0
348851,121,121,0,0,0
348874,87,87,0,0,0
348888,251,251,0,0,0
348891,353,353,0,0,0
348892,180,180,0,0,0
348893,152,152,0,0,0
348898,85,85,0,0,0
348909,359,359,0,0,0
348921,103,103,0,0,0
348931,402,402,0,0,0
348933,131,131,0,0,0
348936,255,255,0,0,0
348938,74,74,0,0,0
348948,128,128,0,0,0
348960,310,310,0,0,0
348961,121,121,0,0,0
348965,121,121,0,0,0
348968,29,29,0,0,0
348990,71,71,0,0,0
348993,44,44,0,0,0
348996,306,306,0,0,0
348998,184,184,0,0,0
349002,137,137,0,0,0
349004,246,246,0,0,0
349007,137,137,0,0,0
349036,8,8,0,0,0
349052,259,259,0,0,0
349059,121,121,0,0,0
349070,57,57,0,0,0
349077,71,71,0,0,0
349084,158,158,0,0,0
349087,281,281,0,0,0
349107,353,353,0,0,0
349118,310,310,0,0,0
349126,315,315,0,0,0
349147,17,17,0,0,0
349148,306,306,0,0,0
349153,163,163,0,0,0
349169,353,353,0,0,0
349205,402,402,0,0,0
349218,131,131,0,0,0
349222,3,3,0,0,0
349236,246,246,0,0,0
349245,114,114,0,0,0
349247,193,193,0,0,0
349259,121,121,0,0,0
349262,402,402,0,0,0
349263,171,171,0,0,0
349267,282,282,0,0,0
349274,70,70,0,0,0
349275,201,201,0,0,0
349284,23,23,0,0,0
349290,57,57,0,0,0
349291,353,353,0,0,0
349301,114,114,0,0,0
349303,2,2,0,0,0
349306,74,74,0,0,0
349310,180,180,0,0,0
349358,76,76,0,0,0
349372,130,130,0,0,0
349399,114,114,0,0,0
349401,76,76,0,0,0
349414,128,128,0,0,0
349432,82,82,0,0,0
349466,56,56,0,0,0
349486,281,281,0,0,0
349498,76,76,0,0,0
349505,345,345,0,0,0
349516,120,120,0,0,0
349520,133,133,0,0,0
349529,15,15,0,0,0
349549,313,313,0,0,0
349559,252,252,0,0,0
349580,15,15,0,0,0
349593,43,43,0,0,0
349598,102,102,0,0,0
349600,310,310,0,0,0
349614,255,255,0,0,0
349615,20,20,0,0,0
349626,252,252,0,0,0
349628,15,15,0,0,0
349629,97,97,0,0,0
349633,184,184,0,0,0
349637,152,152,0,0,0
349638,306,306,0,0,0
349652,6,6,0,0,0
349657,144,144,0,0,0
349660,353,353,0,0,0
349666,102,102,0,0,0
349676,56,56,0,0,0
349695,55,55,0,0,0
349699,353,353,0,0,0
349713,310,310,0,0,0
349718,121,121,0,0,0
349727,30,30,0,0,0
349735,76,76,0,0,0
349745,168,168,0,0,0
349750,8,8,0,0,0
349755,246,246,0,0,0
349765,137,137,0,0,0
349781,171,171,0,0,0
349790,120,120,0,0,0
349799,255,255,0,0,0
349806,75,75,0,0,0
349819,63,63,0,0,0
349822,158,158,0,0,0
349827,198,198,0,0,0
349829,35,35,0,0,0
349833,14,14,0,0,0
349845,3,3,0,0,0
349895,299,299,0,0,0
349918,101,101,0,0,0
349949,1,1,0,0,0
349966,167,167,0,0,0
349968,65,65,0,0,0
349971,82,82,0,0,0
349975,281,281,0,0,0
349982,193,193,0,0,0
349987,8,8,0,0,0
349999,16,16,0,0,0
350003,313,313,0,0,0
350015,82,82,0,0,0
350021,130,130,0,0,0
350032,121,121,0,0,0
350068,193,193,0,0,0
350089,201,201,0,0,0
350094,313,313,0,0,0
350101,8,8,0,0,0
350111,201,201,0,0,0
350128,70,70,0,0,0
350152,131,131,0,0,0
350169,137,137,0,0,0
350173,198,198,0,0,0
350206,299,299,0,0,0
350222,402,402,0,0,0
350226,12,12,0,0,0
350241,120,120,0,0,0
350263,114,114,0,0,0
350268,359,359,0,0,0
350269,76,76,0,0,0
350274,76,76,0,0,0
350282,163,163,0,0,0
350286,143,143,0,0,0
350291,315,315,0,0,0
350318,201,201,0,0,0
350327,402,402,0,0,0
350329,2,2,0,0,0
350351,171,171,0,0,0
350353,180,180,0,0,0
350355,74,74,0,0,0
350381,252,252,0,0,0
350383,113,113,0,0,0
350387,306,306,0,0,0
350392,74,74,0,0,0
350410,315,315,0,0,0
350425,131,131,0,0,0
350426,306,306,0,0,0
350472,102,102,0,0,0
350477,252,252,0,0,0
350483,353,353,0,0,0
350522,353,353,0,0,0
350529,74,74,0,0,0
350530,353,353,0,0,0
350537,144,144,0,0,0
350542,74,74,0,0,0
350595,246,246,0,0,0
350607,76,76,0,0,0
350617,259,259,0,0,0
350632,315,315,0,0,0
350638,35,35,0,0,0
350655,137,137,0,0,0
350666,151,151,0,0,0
350680,246,246,0,0,0
350689,50,50,0,0,0
350728,55,55,0,0,0
350750,310,310,0,0,0
350760,151,151,0,0,0
350769,17,17,0,0,0
350777,163,163,0,0,0
350778,12,12,0,0,0
350797,9,9,0,0,0
350804,345,345,0,0,0
350815,4,4,0,0,0
350818,281,281,0,0,0
350838,23,23,0,0,0
350867,121,121,0,0,0
350893,128,128,0,0,0
350898,24,24,0,0,0
350909,54,54,0,0,0
350914,137,137,0,0,0
350915,163,163,0,0,0
350948,131,131,0,0,0
350951,163,163,0,0,0
350976,306,306,0,0,0
350978,15,15,0,0,0
350990,201,201,0,0,0
350995,103,103,0,0,0
350996,315,315,0,0,0
351007,345,345,0,0,0
351016,306,306,0,0,0
351029,143,143,0,0,0
351048,137,137,0,0,0
351072,82,82,0,0,0
351073,171,171,0,0,0
351086,255,255,0,0,0
351095,163,163,0,0,0
351103,137,137,0,0,0
351109,198,198,0,0,0
351114,58,58,0,0,0
351116,19,19,0,0,0
351119,85,85,0,0,0
351120,102,102,0,0,0
351136,50,50,0,0,0
351142,255,255,0,0,0
351144,71,71,0,0,0
351158,402,402,0,0,0
351159,6,6,0,0,0
351163,130,130,0,0,0
351184,8,8,0,0,0
351198,198,198,0,0,0
351214,66,66,0,0,0
351219,34,34,0,0,0
351228,85,85,0,0,0
351239,12,12,0,0,0
351248,13,13,0,0,0
351249,259,259,0,0,0
351254,137,137,0,0,0
351258,299,299,0,0,0
351264,315,315,0,0,0
351270,201,201,0,0,0
351283,131,131,0,0,0
351285,69,69,0,0,0
351287,97,97,0,0,0
351290,353,353,0,0,0
351295,282,282,0,0,0
351296,12,12,0,0,0
351319,103,103,0,0,0
351325,201,201,0,0,0
351329,66,66,0,0,0
351337,232,232,0,0,0
351339,35,35,0,0,0
351340,16,16,0,0,0
351358,315,315,0,0,0
351359,255,255,0,0,0
351371,137,137,0,0,0
351377,22,22,0,0,0
351380,71,71,0,0,0
351385,66,66,0,0,0
351397,251,251,0,0,0
351413,87,87,0,0,0
351437,133,133,0,0,0
351454,246,246,0,0,0
351488,97,97,0,0,0
351490,193,193,0,0,0
351507,74,74,0,0,0
351515,251,251,0,0,0
351520,151,151,0,0,0
351522,402,402,0,0,0
351523,103,103,0,0,0
351534,246,246,0,0,0
351567,128,128,0,0,0
351605,114,114,0,0,0
351621,76,76,0,0,0
351645,201,201,0,0,0
351648,1,1,0,0,0
351657,306,306,0,0,0
351658,74,74,0,0,0
351667,402,402,0,0,0
351707,144,144,0,0,0
351742,65,65,0,0,0
351743,17,17,0,0,0
351747,32,32,0,0,0
351767,102,102,0,0,0
351782,10,10,0,0,0
351816,35,35,0,0,0
351820,168,168,0,0,0
351831,281,281,0,0,0
351836,114,114,0,0,0
351842,306,306,0,0,0
351871,114,114,0,0,0
351879,77,77,0,0,0
351883,353,353,0,0,0
351887,353,353,0,0,0
351897,22,22,0,0,0
351910,133,133,0,0,0
351917,27,27,0,0,0
351928,281,281,0,0,0
351960,69,69,0,0,0
351963,16,16,0,0,0
351973,50,50,0,0,0
351978,193,193,0,0,0
351981,402,402,0,0,0
351982,76,76,0,0,0
351988,143,143,0,0,0
351992,39,39,0,0,0
351999,27,27,0,0,0
352010,120,120,0,0,0
352020,315,315,0,0,0
352050,252,252,0,0,0
352058,39,39,0,0,0
352061,345,345,0,0,0
352069,310,310,0,0,0
352077,114,114,0,0,0
352084,36,36,0,0,0
352102,44,44,0,0,0
352113,345,345,0,0,0
352120,163,163,0,0,0
352123,151,151,0,0,0
352126,3,3,0,0,0
352127,24,24,0,0,0
352129,180,180,0,0,0
352140,20,20,0,0,0
352142,58,58,0,0,0
352145,72,72,0,0,0
352146,201,201,0,0,0
352157,353,353,0,0,0
352184,18,18,0,0,0
352208,17,17,0,0,0
352218,251,251,0,0,0
352255,14,14,0,0,0
352283,75,75,0,0,0
352289,94,94,0,0,0
352290,22,22,0,0,0
352298,299,299,0,0,0
352301,40,40,0,0,0
352304,402,402,0,0,0
352312,74,74,0,0,0
352314,87,87,0,0,0
352319,306,306,0,0,0
352330,402,402,0,0,0
352333,167,167,0,0,0
352341,39,39,0,0,0
352366,152,152,0,0,0
352380,163,163,0,0,0
352387,77,77,0,0,0
352429,251,251,0,0,0
352434,121,121,0,0,0
352440,113,113,0,0,0
352448,251,251,0,0,0
352451,180,180,0,0,0
352460,252,252,0,0,0
352516,10,10,0,0,0
352530,180,180,0,0,0
352531,315,315,0,0,0
352554,151,151,0,0,0
352556,4,4,0,0,0
352559,198,198,0,0,0
352564,144,144,0,0,0
352570,299,299,0,0,0
352582,17,17,0,0,0
352590,232,232,0,0,0
352597,54,54,0,0,0
352607,306,306,0,0,0
352609,345,345,0,0,0
352613,133,133,0,0,0
352615,82,82,0,0,0
352642,34,34,0,0,0
352649,87,87,0,0,0
352651,184,184,0,0,0
352652,345,345,0,0,0
352655,345,345,0,0,0
352659,402,402,0,0,0
352660,402,402,0,0,0
352672,58,58,0,0,0
352674,71,71,0,0,0
352689,76,76,0,0,0
352717,359,359,0,0,0
352732,353,353,0,0,0
352744,163,163,0,0,0
352745,313,313,0,0,0
352747,143,143,0,0,0
352748,102,102,0,0,0
352768,34,34,0,0,0
352801,310,310,0,0,0
352818,315,315,0,0,0
352850,130,130,0,0,0
352858,102,102,0,0,0
352862,3,3,0,0,0
352866,54,54,0,0,0
352880,30,30,0,0,0
352908,131,131,0,0,0
352910,28,28,0,0,0
352925,198,198,0,0,0
352981,152,152,0,0,0
352985,345,345,0,0,0
352993,143,143,0,0,0
353002,74,74,0,0,0
353008,102,102,0,0,0
353025,180,180,0,0,0
353026,144,144,0,0,0
353028,74,74,0,0,0
353036,12,12,0,0,0
353056,11,11,0,0,0
353071,359,359,0,0,0
353088,232,232,0,0,0
353121,137,137,0,0,0
353137,345,345,0,0,0
353146,251,251,0,0,0
353150,306,306,0,0,0
353160,45,45,0,0,0
353170,34,34,0,0,0
353172,18,18,0,0,0
353174,180,180,0,0,0
353184,259,259,0,0,0
353199,22,22,0,0,0
353219,306,306,0,0,0
353230,20,20,0,0,0
353236,2,2,0,0,0
353249,121,121,0,0,0
353255,246,246,0,0,0
353306,137,137,0,0,0
353315,198,198,0,0,0
353316,114,114,0,0,0
353317,63,63,0,0,0
353335,315,315,0,0,0
353338,353,353,0,0,0
353383,402,402,0,0,0
353385,67,67,0,0,0
353402,306,306,0,0,0
353406,74,74,0,0,0
353418,315,315,0,0,0
353419,251,251,0,0,0
353425,114,114,0,0,0
353434,13,13,0,0,0
353439,345,345,0,0,0
353440,45,45,0,0,0
353451,402,402,0,0,0
353481,83,83,0,0,0
353487,71,71,0,0,0
353494,359,359,0,0,0
353507,345,345,0,0,0
353514,5,5,0,0,0
353516,255,255,0,0,0
353524,359,359,0,0,0
353533,402,402,0,0,0
353556,44,44,0,0,0
353594,163,163,0,0,0
353595,232,232,0,0,0
353602,102,102,0,0,0
353616,299,299,0,0,0
353645,74,74,0,0,0
353647,180,180,0,0,0
353703,359,359,0,0,0
353710,94,94,0,0,0
353712,255,255,0,0,0
353739,102,102,0,0,0
353742,345,345,0,0,0
353743,171,171,0,0,0
353756,281,281,0,0,0
353758,87,87,0,0,0
353760,299,299,0,0,0
353765,180,180,0,0,0
353785,252,252,0,0,0
353794,114,114,0,0,0
353816,18,18,0,0,0
353843,281,281,0,0,0
353859,315,315,0,0,0
353873,198,198,0,0,0
353874,345,345,0,0,0
353892,282,282,0,0,0
353894,306,306,0,0,0
353900,85,85,0,0,0
353903,75,75,0,0,0
353914,158,158,0,0,0
353922,251,251,0,0,0
353925,94,94,0,0,0
353932,163,163,0,0,0
353935,246,246,0,0,0
353938,158,158,0,0,0
353943,85,85,0,0,0
353954,163,163,0,0,0
353978,184,184,0,0,0
353984,3,3,0,0,0
353986,353,353,0,0,0
353991,282,282,0,0,0
353994,315,315,0,0,0
354005,313,313,0,0,0
354014,16,16,0,0,0
354024,184,184,0,0,0
354035,121,121,0,0,0
354044,27,27,0,0,0
354053,281,281,0,0,0
354054,27,27,0,0,0
354055,5,5,0,0,0
354056,310,310,0,0,0
354065,299,299,0,0,0
354073,11,11,0,0,0
354109,315,315,0,0,0
354115,251,251,0,0,0
354116,44,44,0,0,0
354120,34,34,0,0,0
354141,402,402,0,0,0
354162,35,35,0,0,0
354164,252,252,0,0,0
354178,198,198,0,0,0
354192,71,71,0,0,0
354194,310,310,0,0,0
354202,76,76,0,0,0
354230,65,65,0,0,0
354237,54,54,0,0,0
354250,184,184,0,0,0
354257,18,18,0,0,0
354296,120,120,0,0,0
354308,282,282,0,0,0
354345,34,34,0,0,0
354370,34,34,0,0,0
354375,259,259,0,0,0
354391,76,76,0,0,0
354399,168,168,0,0,0
354400,74,74,0,0,0
354403,50,50,0,0,0
354443,67,67,0,0,0
354512,198,198,0,0,0
354530,34,34,0,0,0
354531,163,163,0,0,0
354537,45,45,0,0,0
354564,158,158,0,0,0
354578,252,252,0,0,0
354613,17,17,0,0,0
354662,152,152,0,0,0
354699,310,310,0,0,0
354706,144,144,0,0,0
354711,5,5,0,0,0
354724,50,50,0,0,0
354740,50,50,0,0,0
354743,58,58,0,0,0
354747,72,72,0,0,0
354759,171,171,0,0,0
354767,281,281,0,0,0
354774,8,8,0,0,0
354775,151,151,0,0,0
354782,167,167,0,0,0
354789,163,163,0,0,0
354791,76,76,0,0,0
354807,74,74,0,0,0
354814,71,71,0,0,0
354830,168,168,0,0,0
354831,7,7,0,0,0
354840,282,282,0,0,0
354856,402,402,0,0,0
354869,198,198,0,0,0
354876,74,74,0,0,0
354883,43,43,0,0,0
354892,345,345,0,0,0
354901,114,114,0,0,0
354914,20,20,0,0,0
354917,232,232,0,0,0
354919,137,137,0,0,0
354921,43,43,0,0,0
354922,15,15,0,0,0
354957,69,69,0,0,0
354967,198,198,0,0,0
354974,402,402,0,0,0
355002,65,65,0,0,0
355031,8,8,0,0,0
355044,63,63,0,0,0
355052,259,259,0,0,0
355054,232,232,0,0,0
355085,102,102,0,0,0
355087,353,353,0,0,0
355088,402,402,0,0,0
355090,232,232,0,0,0
355096,198,198,0,0,0
355111,66,66,0,0,0
355120,402,402,0,0,0
355123,41,41,0,0,0
355138,168,168,0,0,0
355148,66,66,0,0,0
355179,11,11,0,0,0
355180,246,246,0,0,0
355185,255,255,0,0,0
355200,72,72,0,0,0
355215,345,345,0,0,0
355226,167,167,0,0,0
355238,39,39,0,0,0
355246,34,34,0,0,0
355260,359,359,0,0,0
355283,402,402,0,0,0
355288,72,72,0,0,0
355330,151,151,0,0,0
355332,180,180,0,0,0
355342,282,282,0,0,0
355348,50,50,0,0,0
355360,167,167,0,0,0
355387,76,76,0,0,0
355392,15,15,0,0,0
355404,402,402,0,0,0
355422,120,120,0,0,0
355437,315,315,0,0,0
355438,315,315,0,0,0
355442,74,74,0,0,0
355447,87,87,0,0,0
355453,18,18,0,0,0
355455,163,163,0,0,0
355459,19,19,0,0,0
355461,9,9,0,0,0
355462,40,40,0,0,0
355468,163,163,0,0,0
355477,94,94,0,0,0
355496,281,281,0,0,0
355515,67,67,0,0,0
355526,259,259,0,0,0
355528,281,281,0,0,0
355533,7,7,0,0,0
355535,402,402,0,0,0
355547,74,74,0,0,0
355548,281,281,0,0,0
355551,2,2,0,0,0
355555,76,76,0,0,0
355575,151,151,0,0,0
355582,128,128,0,0,0
355589,281,281,0,0,0
355596,34,34,0,0,0
355613,359,359,0,0,0
355619,54,54,0,0,0
355622,14,14,0,0,0
355624,345,345,0,0,0
355625,313,313,0,0,0
355630,137,137,0,0,0
355635,251,251,0,0,0
355636,282,282,0,0,0
355671,6,6,0,0,0
355725,246,246,0,0,0
355728,34,34,0,0,0
355735,193,193,0,0,0
355736,15,15,0,0,0
355744,255,255,0,0,0
355746,102,102,0,0,0
355747,353,353,0,0,0
355751,402,402,0,0,0
355767,180,180,0,0,0
355770,74,74,0,0,0
355772,77,77,0,0,0
355820,74,74,0,0,0
355821,16,16,0,0,0
355841,20,20,0,0,0
355843,232,232,0,0,0
355847,102,102,0,0,0
355859,310,310,0,0,0
355865,101,101,0,0,0
355868,39,39,0,0,0
355891,402,402,0,0,0
355902,77,77,0,0,0
355929,315,315,0,0,0
355946,353,353,0,0,0
355947,315,315,0,0,0
355956,131,131,0,0,0
355968,43,43,0,0,0
355976,310,310,0,0,0
355978,102,102,0,0,0
356019,102,102,0,0,0
356030,282,282,0,0,0
356037,113,113,0,0,0
356038,201,201,0,0,0
356046,353,353,0,0,0
356054,45,45,0,0,0
356058,345,345,0,0,0
356064,144,144,0,0,0
356077,43,43,0,0,0
356095,94,94,0,0,0
356110,306,306,0,0,0
356111,158,158,0,0,0
356120,76,76,0,0,0
356133,74,74,0,0,0
356141,151,151,0,0,0
356142,163,163,0,0,0
356146,353,353,0,0,0
356170,313,313,0,0,0
356175,167,167,0,0,0
356191,121,121,0,0,0
356197,232,232,0,0,0
356199,310,310,0,0,0
356227,71,71,0,0,0
356230,85,85,0,0,0
356240,345,345,0,0,0
356271,121,121,0,0,0
356273,193,193,0,0,0
356285,137,137,0,0,0
356287,29,29,0,0,0
356296,74,74,0,0,0
356298,353,353,0,0,0
356330,246,246,0,0,0
356356,171,171,0,0,0
356358,299,299,0,0,0
356390,232,232,0,0,0
356393,201,201,0,0,0
356395,345,345,0,0,0
356444,23,23,0,0,0
356446,255,255,0,0,0
356468,232,232,0,0,0
356516,193,193,0,0,0
356528,353,353,0,0,0
356543,120,120,0,0,0
356555,69,69,0,0,0
356557,12,12,0,0,0
356558,75,75,0,0,0
356579,11,11,0,0,0
356598,114,114,0,0,0
356627,310,310,0,0,0
356632,11,11,0,0,0
356665,306,306,0,0,0
356683,315,315,0,0,0
356720,8,8,0,0,0
356734,133,133,0,0,0
356748,35,35,0,0,0
356753,71,71,0,0,0
356757,168,168,0,0,0
356770,198,198,0,0,0
356775,3,3,0,0,0
356777,35,35,0,0,0
356781,75,75,0,0,0
356788,232,232,0,0,0
356819,137,137,0,0,0
356824,30,30,0,0,0
356829,158,158,0,0,0
356836,143,143,0,0,0
356851,94,94,0,0,0
356869,299,299,0,0,0
356873,359,359,0,0,0
356874,171,171,0,0,0
356890,198,198,0,0,0
356893,193,193,0,0,0
356904,2,2,0,0,0
356939,259,259,0,0,0
356943,359,359,0,0,0
356945,23,23,0,0,0
356952,353,353,0,0,0
356968,315,315,0,0,0
357004,77,77,0,0,0
357010,345,345,0,0,0
357031,143,143,0,0,0
357035,255,255,0,0,0
357053,7,7,0,0,0
357068,44,44,0,0,0
357078,193,193,0,0,0
357087,163,163,0,0,0
357088,345,345,0,0,0
357091,299,299,0,0,0
357093,13,13,0,0,0
357118,353,353,0,0,0
357138,45,45,0,0,0
357147,180,180,0,0,0
357172,137,137,0,0,0
357175,66,66,0,0,0
357183,345,345,0,0,0
357191,359,359,0,0,0
357195,180,180,0,0,0
357205,259,259,0,0,0
357206,359,359,0,0,0
357208,353,353,0,0,0
357217,193,193,0,0,0
357231,402,402,0,0,0
357233,10,10,0,0,0
357282,75,75,0,0,0
357301,259,259,0,0,0
357307,97,97,0,0,0
357318,34,34,0,0,0
357319,12,12,0,0,0
357326,35,35,0,0,0
357335,20,20,0,0,0
357352,359,359,0,0,0
357358,66,66,0,0,0
357367,6,6,0,0,0
357376,128,128,0,0,0
357383,252,252,0,0,0
357385,201,201,0,0,0
357386,255,255,0,0,0
357401,30,30,0,0,0
357403,70,70,0,0,0
357417,184,184,0,0,0
357434,359,359,0,0,0
357437,87,87,0,0,0
357439,137,137,0,0,0
357461,252,252,0,0,0
357472,40,40,0,0,0
357492,201,201,0,0,0
357499,251,251,0,0,0
357530,402,402,0,0,0
357534,198,198,0,0,0
357553,101,101,0,0,0
357564,54,54,0,0,0
357584,39,39,0,0,0
357585,85,85,0,0,0
357614,18,18,0,0,0
357618,193,193,0,0,0
357628,299,299,0,0,0
357632,32,32,0,0,0
357640,76,76,0,0,0
357641,70,70,0,0,0
357644,70,70,0,0,0
357648,281,281,0,0,0
357649,137,137,0,0,0
357662,353,353,0,0,0
357668,171,171,0,0,0
357669,345,345,0,0,0
357700,180,180,0,0,0
357704,402,402,0,0,0
357713,102,102,0,0,0
357715,402,402,0,0,0
357730,131,131,0,0,0
357743,54,54,0,0,0
357760,402,402,0,0,0
357770,20,20,0,0,0
357789,63,63,0,0,0
357803,113,113,0,0,0
357807,251,251,0,0,0
357817,72,72,0,0,0
357826,251,251,0,0,0
357833,121,121,0,0,0
357839,87,87,0,0,0
357847,63,63,0,0,0
357863,313,313,0,0,0
357867,83,83,0,0,0
357869,252,252,0,0,0
357877,232,232,0,0,0
357886,252,252,0,0,0
357898,152,152,0,0,0
357902,345,345,0,0,0
357905,255,255,0,0,0
357931,57,57,0,0,0
357948,130,130,0,0,0
357952,313,313,0,0,0
357981,121,121,0,0,0
357982,101,101,0,0,0
357986,259,259,0,0,0
357991,251,251,0,0,0
357999,259,259,0,0,0
358007,259,259,0,0,0
358017,180,180,0,0,0
358020,25,25,0,0,0
358032,201,201,0,0,0
358038,345,345,0,0,0
358061,19,19,0,0,0
358069,193,193,0,0,0
358076,259,259,0,0,0
358078,180,180,0,0,0
358089,74,74,0,0,0
358098,121,121,0,0,0
358101,40,40,0,0,0
358116,306,306,0,0,0
358118,259,259,0,0,0
358120,34,34,0,0,0
358126,131,131,0,0,0
358143,180,180,0,0,0
358168,180,180,0,0,0
358173,299,299,0,0,0
358199,120,120,0,0,0
358202,5,5,0,0,0
358211,306,306,0,0,0
358223,57,57,0,0,0
358225,114,114,0,0,0
358227,252,252,0,0,0
358234,54,54,0,0,0
358247,87,87,0,0,0
358250,345,345,0,0,0
358255,193,193,0,0,0
358274,151,151,0,0,0
358281,133,133,0,0,0
358295,113,113,0,0,0
358303,345,345,0,0,0
358307,3,3,0,0,0
358320,39,39,0,0,0
358325,102,102,0,0,0
358326,171,171,0,0,0
358334,282,282,0,0,0
358337,171,171,0,0,0
358347,66,66,0,0,0
358361,345,345,0,0,0
358363,152,152,0,0,0
358373,75,75,0,0,0
358389,36,36,0,0,0
358411,25,25,0,0,0
358425,252,252,0,0,0
358435,20,20,0,0,0
358444,83,83,0,0,0
358456,144,144,0,0,0
358459,310,310,0,0,0
358472,101,101,0,0,0
358476,152,152,0,0,0
358479,315,315,0,0,0
358480,198,198,0,0,0
358491,19,19,0,0,0
358498,25,25,0,0,0
358518,232,232,0,0,0
358527,82,82,0,0,0
358531,359,359,0,0,0
358552,34,34,0,0,0
358559,137,137,0,0,0
358566,232,232,0,0,0
358598,24,24,0,0,0
358610,3,3,0,0,0
358624,255,255,0,0,0
358654,180,180,0,0,0
358657,114,114,0,0,0
358665,345,345,0,0,0
358688,121,121,0,0,0
358693,16,16,0,0,0
358746,71,71,0,0,0
358801,143,143,0,0,0
358808,9,9,0,0,0
358809,313,313,0,0,0
358823,201,201,0,0,0
358824,198,198,0,0,0
358845,63,63,0,0,0
358847,43,43,0,0,0
358856,114,114,0,0,0
358857,57,57,0,0,0
358861,152,152,0,0,0
358869,163,163,0,0,0
358887,198,198,0,0,0
358896,5,5,0,0,0
358901,315,315,0,0,0
358903,30,30,0,0,0
358919,15,15,0,0,0
358950,353,353,0,0,0
358953,353,353,0,0,0
358960,152,152,0,0,0
358981,252,252,0,0,0
358986,251,251,0,0,0
358990,259,259,0,0,0
358992,128,128,0,0,0
359001,281,281,0,0,0
359013,359,359,0,0,0
359035,353,353,0,0,0
359040,168,168,0,0,0
359044,128,128,0,0,0
359060,35,35,0,0,0
359061,39,39,0,0,0
359077,167,167,0,0,0
359087,35,35,0,0,0
359089,114,114,0,0,0
359101,201,201,0,0,0
359113,345,345,0,0,0
359123,152,152,0,0,0
359165,345,345,0,0,0
359172,29,29,0,0,0
359197,282,282,0,0,0
359206,198,198,0,0,0
359221,70,70,0,0,0
359223,137,137,0,0,0
359231,315,315,0,0,0
359233,184,184,0,0,0
359236,345,345,0,0,0
359247,143,143,0,0,0
359253,13,13,0,0,0
359254,114,114,0,0,0
359255,232,232,0,0,0
359259,168,168,0,0,0
359269,103,103,0,0,0
359292,255,255,0,0,0
359295,198,198,0,0,0
359307,281,281,0,0,0
359312,137,137,0,0,0
359322,66,66,0,0,0
359335,70,70,0,0,0
359338,29,29,0,0,0
359339,167,167,0,0,0
359341,113,113,0,0,0
359357,97,97,0,0,0
359380,158,158,0,0,0
359381,74,74,0,0,0
359404,10,10,0,0,0
359420,345,345,0,0,0
359428,18,18,0,0,0
359435,58,58,0,0,0
359444,246,246,0,0,0
359451,70,70,0,0,0
359455,120,120,0,0,0
359459,28,28,0,0,0
359489,65,65,0,0,0
359537,313,313,0,0,0
359556,313,313,0,0,0
359559,21,21,0,0,0
359560,313,313,0,0,0
359568,282,282,0,0,0
359588,13,13,0,0,0
359601,252,252,0,0,0
359615,193,193,0,0,0
359624,184,184,0,0,0
359626,102,102,0,0,0
359627,29,29,0,0,0
359650,1,1,0,0,0
359656,65,65,0,0,0
359676,259,259,0,0,0
359702,101,101,0,0,0
359715,198,198,0,0,0
359730,50,50,0,0,0
359746,70,70,0,0,0
359749,251,251,0,0,0
359769,137,137,0,0,0
359775,359,359,0,0,0
359778,315,315,0,0,0
359789,281,281,0,0,0
359808,36,36,0,0,0
359822,40,40,0,0,0
359848,313,313,0,0,0
359850,353,353,0,0,0
359854,94,94,0,0,0
359870,1,1,0,0,0
359888,345,345,0,0,0
359895,15,15,0,0,0
359900,137,137,0,0,0
359904,29,29,0,0,0
359905,306,306,0,0,0
359907,163,163,0,0,0
359912,359,359,0,0,0
359923,168,168,0,0,0
359924,36,36,0,0,0
359927,102,102,0,0,0
359945,12,12,0,0,0
359956,85,85,0,0,0
359960,144,144,0,0,0
359962,402,402,0,0,0
359963,359,359,0,0,0
359969,353,353,0,0,0
359971,184,184,0,0,0
359999,6,6,0,0,0
360010,282,282,0,0,0
360021,97,97,0,0,0
360026,310,310,0,0,0
360028,306,306,0,0,0
360032,77,77,0,0,0
360040,232,232,0,0,0
360049,29,29,0,0,0
360053,193,193,0,0,0
360063,24,24,0,0,0
360064,151,151,0,0,0
360072,63,63,0,0,0
360074,20,20,0,0,0
360085,402,402,0,0,0
360094,44,44,0,0,0
360097,74,74,0,0,0
360116,74,74,0,0,0
360134,97,97,0,0,0
360144,402,402,0,0,0
360169,306,306,0,0,0
360176,144,144,0,0,0
360178,29,29,0,0,0
360181,34,34,0,0,0
360185,259,259,0,0,0
360193,167,167,0,0,0
360211,310,310,0,0,0
360212,74,74,0,0,0
360224,121,121,0,0,0
360225,180,180,0,0,0
360240,281,281,0,0,0
360250,128,128,0,0,0
360274,120,120,0,0,0
360281,72,72,0,0,0
360307,76,76,0,0,0
360309,1,1,0,0,0
360310,128,128,0,0,0
360316,251,251,0,0,0
360322,345,345,0,0,0
360329,132,132,0,0,0
360332,87,87,0,0,0
360342,17,17,0,0,0
360354,167,167,0,0,0
360355,39,39,0,0,0
360363,315,315,0,0,0
360377,82,82,0,0,0
360398,281,281,0,0,0
360400,198,198,0,0,0
360407,8,8,0,0,0
360412,19,19,0,0,0
360417,137,137,0,0,0
360427,70,70,0,0,0
360429,14,14,0,0,0
360442,87,87,0,0,0
360473,114,114,0,0,0
360486,144,144,0,0,0
360496,74,74,0,0,0
360523,120,120,0,0,0
360525,70,70,0,0,0
360528,180,180,0,0,0
360530,281,281,0,0,0
360538,10,10,0,0,0
360548,315,315,0,0,0
360560,158,158,0,0,0
360588,201,201,0,0,0
360601,353,353,0,0,0
360602,152,152,0,0,0
360611,102,102,0,0,0
360616,163,163,0,0,0
360638,58,58,0,0,0
360642,23,23,0,0,0
360654,315,315,0,0,0
360668,55,55,0,0,0
360678,3,3,0,0,0
360691,15,15,0,0,0
360704,193,193,0,0,0
360705,282,282,0,0,0
360710,69,69,0,0,0
360726,310,310,0,0,0
360730,113,113,0,0,0
360741,184,184,0,0,0
360742,353,353,0,0,0
360748,282,282,0,0,0
360755,252,252,0,0,0
360799,180,180,0,0,0
360800,121,121,0,0,0
360815,281,281,0,0,0
360817,353,353,0,0,0
360825,310,310,0,0,0
360831,103,103,0,0,0
360842,193,193,0,0,0
360850,130,130,0,0,0
360854,167,167,0,0,0
360917,137,137,0,0,0
360919,94,94,0,0,0
360923,130,130,0,0,0
360928,345,345,0,0,0
360941,252,252,0,0,0
360949,54,54,0,0,0
360955,66,66,0,0,0
360963,201,201,0,0,0
360985,184,184,0,0,0
360996,56,56,0,0,0
360998,252,252,0,0,0
361012,137,137,0,0,0
361016,82,82,0,0,0
361024,58,58,0,0,0
361029,299,299,0,0,0
361034,133,133,0,0,0
361036,152,152,0,0,0
361037,102,102,0,0,0
361042,345,345,0,0,0
361063,255,255,0,0,0
361072,402,402,0,0,0
361083,132,132,0,0,0
361096,3,3,0,0,0
361099,310,310,0,0,0
361128,310,310,0,0,0
361157,180,180,0,0,0
361160,281,281,0,0,0
361163,299,299,0,0,0
361177,299,299,0,0,0
361178,39,39,0,0,0
361182,201,201,0,0,0
361205,163,163,0,0,0
361214,71,71,0,0,0
361231,402,402,0,0,0
361239,171,171,0,0,0
361278,201,201,0,0,0
361281,345,345,0,0,0
361309,259,259,0,0,0
361317,184,184,0,0,0
361323,246,246,0,0,0
361345,120,120,0,0,0
361349,5,5,0,0,0
361376,131,131,0,0,0
361378,56,56,0,0,0
361383,315,315,0,0,0
361385,113,113,0,0,0
361387,167,167,0,0,0
361433,252,252,0,0,0
361437,83,83,0,0,0
361478,167,167,0,0,0
361482,3,3,0,0,0
361489,77,77,0,0,0
361497,167,167,0,0,0
361507,24,24,0,0,0
361509,310,310,0,0,0
361518,102,102,0,0,0
361520,402,402,0,0,0
361524,282,282,0,0,0
361537,143,143,0,0,0
361551,101,101,0,0,0
361552,359,359,0,0,0
361556,168,168,0,0,0
361561,152,152,0,0,0
361573,201,201,0,0,0
361586,77,77,0,0,0
361589,12,12,0,0,0
361596,313,313,0,0,0
361624,402,402,0,0,0
361628,18,18,0,0,0
361735,39,39,0,0,0
361760,281,281,0,0,0
361762,198,198,0,0,0
361781,310,310,0,0,0
361796,39,39,0,0,0
361811,18,18,0,0,0
361819,299,299,0,0,0
361825,359,359,0,0,0
361827,313,313,0,0,0
361833,282,282,0,0,0
361858,251,251,0,0,0
361859,74,74,0,0,0
361867,30,30,0,0,0
361879,35,35,0,0,0
361901,246,246,0,0,0
361902,128,128,0,0,0
361910,3,3,0,0,0
361918,130,130,0,0,0
361947,76,76,0,0,0
361956,54,54,0,0,0
361957,281,281,0,0,0
361963,128,128,0,0,0
361970,353,353,0,0,0
361976,36,36,0,0,0
361981,402,402,0,0,0
362041,74,74,0,0,0
362077,34,34,0,0,0
362086,128,128,0,0,0
362094,20,20,0,0,0
362107,184,184,0,0,0
362125,3,3,0,0,0
362127,6,6,0,0,0
362133,353,353,0,0,0
362152,16,16,0,0,0
362177,74,74,0,0,0
362181,152,152,0,0,0
362189,353,353,0,0,0
362191,345,345,0,0,0
362198,143,143,0,0,0
362206,137,137,0,0,0
362224,299,299,0,0,0
362237,36,36,0,0,0
362278,25,25,0,0,0
362279,83,83,0,0,0
362306,16,16,0,0,0
362327,299,299,0,0,0
362329,198,198,0,0,0
362335,251,251,0,0,0
362336,19,19,0,0,0
362340,193,193,0,0,0
362341,16,16,0,0,0
362342,246,246,0,0,0
362362,30,30,0,0,0
362371,313,313,0,0,0
362373,281,281,0,0,0
362381,184,184,0,0,0
362388,18,18,0,0,0
362389,85,85,0,0,0
362393,137,137,0,0,0
362417,83,83,0,0,0
362429,315,315,0,0,0
362459,310,310,0,0,0
362460,201,201,0,0,0
362467,29,29,0,0,0
362504,232,232,0,0,0
362511,184,184,0,0,0
362512,34,34,0,0,0
362516,54,54,0,0,0
362546,152,152,0,0,0
362551,137,137,0,0,0
362568,313,313,0,0,0
362571,55,55,0,0,0
362578,306,306,0,0,0
362592,193,193,0,0,0
362605,3,3,0,0,0
362620,252,252,0,0,0
362624,201,201,0,0,0
362669,353,353,0,0,0
362671,34,34,0,0,0
362678,171,171,0,0,0
362682,255,255,0,0,0
362692,345,345,0,0,0
362701,198,198,0,0,0
362712,281,281,0,0,0
362732,252,252,0,0,0
362737,82,82,0,0,0
362738,82,82,0,0,0
362765,353,353,0,0,0
362770,74,74,0,0,0
362778,252,252,0,0,0
362791,35,35,0,0,0
362804,252,252,0,0,0
362806,83,83,0,0,0
362822,167,167,0,0,0
362827,151,151,0,0,0
362852,9,9,0,0,0
362858,353,353,0,0,0
362869,75,75,0,0,0
362901,193,193,0,0,0
362922,306,306,0,0,0
362935,402,402,0,0,0
362943,299,299,0,0,0
362955,299,299,0,0,0
362962,282,282,0,0,0
362980,102,102,0,0,0
362990,70,70,0,0,0
362996,8,8,0,0,0
363015,137,137,0,0,0
363022,75,75,0,0,0
363028,299,299,0,0,0
363030,10,10,0,0,0
363044,29,29,0,0,0
363045,102,102,0,0,0
363061,74,74,0,0,0
363065,180,180,0,0,0
363078,184,184,0,0,0
363089,40,40,0,0,0
363114,201,201,0,0,0
363121,121,121,0,0,0
363135,4,4,0,0,0
363154,35,35,0,0,0
363170,34,34,0,0,0
363189,113,113,0,0,0
363202,313,313,0,0,0
363208,35,35,0,0,0
363216,313,313,0,0,0
363233,40,40,0,0,0
363239,3,3,0,0,0
363242,282,282,0,0,0
363268,246,246,0,0,0
363270,50,50,0,0,0
363285,168,168,0,0,0
363295,74,74,0,0,0
363297,163,163,0,0,0
363298,120,120,0,0,0
363305,246,246,0,0,0
363307,359,359,0,0,0
363309,40,40,0,0,0
363321,3,3,0,0,0
363348,67,67,0,0,0
363352,101,101,0,0,0
363357,133,133,0,0,0
363386,75,75,0,0,0
363388,121,121,0,0,0
363395,345,345,0,0,0
363396,83,83,0,0,0
363403,97,97,0,0,0
363409,184,184,0,0,0
363429,255,255,0,0,0
363436,198,198,0,0,0
363441,184,184,0,0,0
363461,74,74,0,0,0
363469,120,120,0,0,0
363476,251,251,0,0,0
363479,8,8,0,0,0
363513,143,143,0,0,0
363533,315,315,0,0,0
363535,246,246,0,0,0
363546,201,201,0,0,0
363551,3,3,0,0,0
363559,2,2,0,0,0
363560,353,353,0,0,0
363583,128,128,0,0,0
363592,198,198,0,0,0
363602,353,353,0,0,0
363614,24,24,0,0,0
363618,143,143,0,0,0
363620,6,6,0,0,0
363626,180,180,0,0,0
363639,402,402,0,0,0
363641,114,114,0,0,0
363642,83,83,0,0,0
363647,74,74,0,0,0
363648,345,345,0,0,0
363649,55,55,0,0,0
363664,131,131,0,0,0
363671,17,17,0,0,0
363681,402,402,0,0,0
363685,83,83,0,0,0
363691,67,67,0,0,0
363707,30,30,0,0,0
363714,132,132,0,0,0
363733,19,19,0,0,0
363758,128,128,0,0,0
363774,281,281,0,0,0
363775,168,168,0,0,0
363780,184,184,0,0,0
363782,359,359,0,0,0
363805,313,313,0,0,0
363839,282,282,0,0,0
363844,259,259,0,0,0
363846,120,120,0,0,0
363848,102,102,0,0,0
363849,7,7,0,0,0
363853,36,36,0,0,0
363856,44,44,0,0,0
363866,137,137,0,0,0
363886,102,102,0,0,0
363890,184,184,0,0,0
363902,17,17,0,0,0
363928,39,39,0,0,0
363941,259,259,0,0,0
363942,402,402,0,0,0
363958,281,281,0,0,0
363973,128,128,0,0,0
364003,87,87,0,0,0
364004,144,144,0,0,0
364024,198,198,0,0,0
364036,167,167,0,0,0
364065,251,251,0,0,0
364068,55,55,0,0,0
364088,76,76,0,0,0
364091,151,151,0,0,0
364099,23,23,0,0,0
364108,232,232,0,0,0
364109,63,63,0,0,0
364111,353,353,0,0,0
364154,151,151,0,0,0
364195,63,63,0,0,0
364200,184,184,0,0,0
364228,35,35,0,0,0
364233,76,76,0,0,0
364237,103,103,0,0,0
364254,74,74,0,0,0
364267,77,77,0,0,0
364283,113,113,0,0,0
364286,402,402,0,0,0
364291,40,40,0,0,0
364295,13,13,0,0,0
364325,58,58,0,0,0
364327,55,55,0,0,0
364332,4,4,0,0,0
364333,313,313,0,0,0
364341,143,143,0,0,0
364359,201,201,0,0,0
364376,251,251,0,0,0
364377,10,10,0,0,0
364380,299,299,0,0,0
364413,151,151,0,0,0
364417,143,143,0,0,0
364426,198,198,0,0,0
364441,310,310,0,0,0
364443,353,353,0,0,0
364450,306,306,0,0,0
364478,306,306,0,0,0
364479,232,232,0,0,0
364496,5,5,0,0,0
364507,102,102,0,0,0
364508,120,120,0,0,0
364509,22,22,0,0,0
364521,87,87,0,0,0
364538,152,152,0,0,0
364541,144,144,0,0,0
364547,12,12,0,0,0
364574,102,102,0,0,0
364576,402,402,0,0,0
364582,128,128,0,0,0
364588,56,56,0,0,0
364592,345,345,0,0,0
364602,151,151,0,0,0
364623,12,12,0,0,0
364626,282,282,0,0,0
364651,43,43,0,0,0
364654,198,198,0,0,0
364655,282,282,0,0,0
364675,168,168,0,0,0
364676,252,252,0,0,0
364678,282,282,0,0,0
364683,87,87,0,0,0
364715,252,252,0,0,0
364723,18,18,0,0,0
364727,128,128,0,0,0
364746,184,184,0,0,0
364753,13,13,0,0,0
364756,359,359,0,0,0
364762,25,25,0,0,0
364766,133,133,0,0,0
364771,3,3,0,0,0
364788,282,282,0,0,0
364817,75,75,0,0,0
364819,54,54,0,0,0
364831,246,246,0,0,0
364849,27,27,0,0,0
364860,102,102,0,0,0
364861,137,137,0,0,0
364869,299,299,0,0,0
364876,402,402,0,0,0
364880,299,299,0,0,0
364898,402,402,0,0,0
364910,17,17,0,0,0
364916,259,259,0,0,0
364931,94,94,0,0,0
364938,345,345,0,0,0
364941,201,201,0,0,0
364942,128,128,0,0,0
364944,345,345,0,0,0
364967,299,299,0,0,0
364974,282,282,0,0,0
364979,402,402,0,0,0
364999,32,32,0,0,0
365013,82,82,0,0,0
365030,120,120,0,0,0
365032,143,143,0,0,0
365047,50,50,0,0,0
365069,251,251,0,0,0
365070,282,282,0,0,0
365101,180,180,0,0,0
365105,315,315,0,0,0
365112,143,143,0,0,0
365120,101,101,0,0,0
365140,114,114,0,0,0
365141,70,70,0,0,0
365173,11,11,0,0,0
365175,251,251,0,0,0
365176,14,14,0,0,0
365188,246,246,0,0,0
365205,103,103,0,0,0
365217,121,121,0,0,0
365218,353,353,0,0,0
365220,102,102,0,0,0
365241,402,402,0,0,0
365244,74,74,0,0,0
365249,30,30,0,0,0
365252,259,259,0,0,0
365253,57,57,0,0,0
365269,281,281,0,0,0
365290,144,144,0,0,0
365308,353,353,0,0,0
365318,255,255,0,0,0
365326,13,13,0,0,0
365327,167,167,0,0,0
365335,102,102,0,0,0
365346,198,198,0,0,0
365347,353,353,0,0,0
365357,246,246,0,0,0
365365,402,402,0,0,0
365373,25,25,0,0,0
365374,131,131,0,0,0
365378,281,281,0,0,0
365400,251,251,0,0,0
365403,3,3,0,0,0
365418,3,3,0,0,0
365423,232,232,0,0,0
365427,41,41,0,0,0
365431,144,144,0,0,0
365437,232,232,0,0,0
365457,259,259,0,0,0
365468,18,18,0,0,0
365479,152,152,0,0,0
365480,94,94,0,0,0
365481,306,306,0,0,0
365491,143,143,0,0,0
365494,282,282,0,0,0
365499,198,198,0,0,0
365503,6,6,0,0,0
365511,313,313,0,0,0
365518,315,315,0,0,0
365528,193,193,0,0,0
365530,114,114,0,0,0
365555,50,50,0,0,0
365575,76,76,0,0,0
365595,171,171,0,0,0
365607,198,198,0,0,0
365618,251,251,0,0,0
365631,25,25,0,0,0
365635,402,402,0,0,0
365674,11,11,0,0,0
365678,18,18,0,0,0
365705,353,353,0,0,0
365709,121,121,0,0,0
365719,180,180,0,0,0
365727,306,306,0,0,0
365729,345,345,0,0,0
365746,103,103,0,0,0
365757,353,353,0,0,0
365760,69,69,0,0,0
365773,281,281,0,0,0
365801,132,132,0,0,0
365811,144,144,0,0,0
365814,259,259,0,0,0
365855,402,402,0,0,0
365890,130,130,0,0,0
365908,315,315,0,0,0
365919,137,137,0,0,0
365934,77,77,0,0,0
365941,71,71,0,0,0
365950,246,246,0,0,0
365982,402,402,0,0,0
365986,7,7,0,0,0
366021,36,36,0,0,0
366030,158,158,0,0,0
366047,77,77,0,0,0
366057,25,25,0,0,0
366068,255,255,0,0,0
366071,29,29,0,0,0
366078,251,251,0,0,0
366081,77,77,0,0,0
366087,201,201,0,0,0
366090,72,72,0,0,0
366108,152,152,0,0,0
366113,180,180,0,0,0
366159,353,353,0,0,0
366163,306,306,0,0,0
366170,94,94,0,0,0
366195,180,180,0,0,0
366202,299,299,0,0,0
366207,310,310,0,0,0
366227,232,232,0,0,0
366235,402,402,0,0,0
366252,359,359,0,0,0
366264,3,3,0,0,0
366278,180,180,0,0,0
366279,143,143,0,0,0
366285,15,15,0,0,0
366290,171,171,0,0,0
366299,128,128,0,0,0
366305,259,259,0,0,0
366345,255,255,0,0,0
366358,345,345,0,0,0
366380,29,29,0,0,0
366414,120,120,0,0,0
366421,137,137,0,0,0
366429,55,55,0,0,0
366449,359,359,0,0,0
366450,25,25,0,0,0
366465,158,158,0,0,0
366472,232,232,0,0,0
366493,34,34,0,0,0
366496,114,114,0,0,0
366498,402,402,0,0,0
366511,102,102,0,0,0
366531,180,180,0,0,0
366540,144,144,0,0,0
366547,21,21,0,0,0
366579,315,315,0,0,0
366601,71,71,0,0,0
366605,232,232,0,0,0
366617,152,152,0,0,0
366622,76,76,0,0,0
366634,113,113,0,0,0
366635,137,137,0,0,0
366701,137,137,0,0,0
366702,102,102,0,0,0
366709,130,130,0,0,0
366716,144,144,0,0,0
366720,353,353,0,0,0
366726,353,353,0,0,0
366729,102,102,0,0,0
366795,246,246,0,0,0
366796,152,152,0,0,0
366807,198,198,0,0,0
366817,120,120,0,0,0
366838,345,345,0,0,0
366845,101,101,0,0,0
366851,252,252,0,0,0
366854,113,113,0,0,0
366859,310,310,0,0,0
366868,75,75,0,0,0
366879,5,5,0,0,0
366887,66,66,0,0,0
366889,102,102,0,0,0
366895,87,87,0,0,0
366921,282,282,0,0,0
366930,251,251,0,0,0
366946,3,3,0,0,0
366963,180,180,0,0,0
366973,171,171,0,0,0
366976,313,313,0,0,0
366977,246,246,0,0,0
366980,259,259,0,0,0
366981,198,198,0,0,0
366982,131,131,0,0,0
366993,255,255,0,0,0
366994,306,306,0,0,0
366996,82,82,0,0,0
367005,12,12,0,0,0
367017,143,143,0,0,0
367031,83,83,0,0,0
367032,41,41,0,0,0
367035,315,315,0,0,0
367038,9,9,0,0,0
367046,5,5,0,0,0
367048,402,402,0,0,0
367120,246,246,0,0,0
367129,201,201,0,0,0
367130,74,74,0,0,0
367139,313,313,0,0,0
367152,299,299,0,0,0
367156,255,255,0,0,0
367160,359,359,0,0,0
367166,359,359,0,0,0
367167,313,313,0,0,0
367184,281,281,0,0,0
367192,201,201,0,0,0
367208,252,252,0,0,0
367209,259,259,0,0,0
367234,131,131,0,0,0
367245,16,16,0,0,0
367258,24,24,0,0,0
367293,58,58,0,0,0
367301,57,57,0,0,0
367308,315,315,0,0,0
367320,345,345,0,0,0
367329,13,13,0,0,0
367342,2,2,0,0,0
367348,63,63,0,0,0
367366,45,45,0,0,0
367370,180,180,0,0,0
367387,259,259,0,0,0
367400,353,353,0,0,0
367424,16,16,0,0,0
367430,310,310,0,0,0
367453,259,259,0,0,0
367474,198,198,0,0,0
367520,251,251,0,0,0
367551,201,201,0,0,0
367562,163,163,0,0,0
367568,20,20,0,0,0
367573,121,121,0,0,0
367610,171,171,0,0,0
367626,313,313,0,0,0
367627,252,252,0,0,0
367635,114,114,0,0,0
367639,299,299,0,0,0
367640,74,74,0,0,0
367666,251,251,0,0,0
367680,402,402,0,0,0
367687,30,30,0,0,0
367719,137,137,0,0,0
367739,171,171,0,0,0
367757,85,85,0,0,0
367764,101,101,0,0,0
367786,50,50,0,0,0
367798,25,25,0,0,0
367806,102,102,0,0,0
367810,97,97,0,0,0
367815,56,56,0,0,0
367824,184,184,0,0,0
367837,306,306,0,0,0
367840,184,184,0,0,0
367842,313,313,0,0,0
367844,143,143,0,0,0
367865,34,34,0,0,0
367868,23,23,0,0,0
367897,402,402,0,0,0
367921,8,8,0,0,0
367944,198,198,0,0,0
367953,40,40,0,0,0
367954,345,345,0,0,0
367966,102,102,0,0,0
367995,259,259,0,0,0
367997,171,171,0,0,0
368004,282,282,0,0,0
368013,74,74,0,0,0
368030,12,12,0,0,0
368039,97,97,0,0,0
368046,29,29,0,0,0
368051,252,252,0,0,0
368070,101,101,0,0,0
368072,18,18,0,0,0
368089,353,353,0,0,0
368093,21,21,0,0,0
368102,306,306,0,0,0
368104,201,201,0,0,0
368106,102,102,0,0,0
368115,76,76,0,0,0
368117,4,4,0,0,0
368135,76,76,0,0,0
368167,77,77,0,0,0
368175,56,56,0,0,0
368176,30,30,0,0,0
368191,359,359,0,0,0
368197,39,39,0,0,0
368216,25,25,0,0,0
368244,54,54,0,0,0
368253,315,315,0,0,0
368275,152,152,0,0,0
368279,9,9,0,0,0
368286,144,144,0,0,0
368288,36,36,0,0,0
368289,70,70,0,0,0
368294,71,71,0,0,0
368300,345,345,0,0,0
368314,310,310,0,0,0
368330,103,103,0,0,0
368348,359,359,0,0,0
368350,7,7,0,0,0
368365,12,12,0,0,0
368368,20,20,0,0,0
368375,143,143,0,0,0
368377,193,193,0,0,0
368386,353,353,0,0,0
368419,345,345,0,0,0
368420,144,144,0,0,0
368422,163,163,0,0,0
368430,259,259,0,0,0
368431,167,167,0,0,0
368432,232,232,0,0,0
368436,402,402,0,0,0
368451,36,36,0,0,0
368452,232,232,0,0,0
368458,402,402,0,0,0
368472,25,25,0,0,0
368479,232,232,0,0,0
368491,246,246,0,0,0
368501,121,121,0,0,0
368519,306,306,0,0,0
368523,259,259,0,0,0
368528,120,120,0,0,0
368554,113,113,0,0,0
368567,36,36,0,0,0
368572,313,313,0,0,0
368578,359,359,0,0,0
368589,259,259,0,0,0
368600,65,65,0,0,0
368605,359,359,0,0,0
368611,282,282,0,0,0
368637,128,128,0,0,0
368644,10,10,0,0,0
368659,310,310,0,0,0
368678,251,251,0,0,0
368695,3,3,0,0,0
368696,83,83,0,0,0
368698,87,87,0,0,0
368710,193,193,0,0,0
368715,313,313,0,0,0
368727,29,29,0,0,0
368730,36,36,0,0,0
368758,72,72,0,0,0
368760,57,57,0,0,0
368763,24,24,0,0,0
368773,306,306,0,0,0
368793,259,259,0,0,0
368796,306,306,0,0,0
368799,75,75,0,0,0
368800,255,255,0,0,0
368851,137,137,0,0,0
368858,313,313,0,0,0
368861,102,102,0,0,0
368866,70,70,0,0,0
368881,359,359,0,0,0
368905,15,15,0,0,0
368918,113,113,0,0,0
368953,12,12,0,0,0
368974,13,13,0,0,0
368982,252,252,0,0,0
368997,353,353,0,0,0
369011,128,128,0,0,0
369023,402,402,0,0,0
369036,10,10,0,0,0
369052,193,193,0,0,0
369053,102,102,0,0,0
369067,299,299,0,0,0
369070,131,131,0,0,0
369085,345,345,0,0,0
369095,29,29,0,0,0
369099,345,345,0,0,0
369102,402,402,0,0,0
369121,20,20,0,0,0
369147,299,299,0,0,0
369152,130,130,0,0,0
369160,232,232,0,0,0
369164,315,315,0,0,0
369182,402,402,0,0,0
369191,402,402,0,0,0
369193,40,40,0,0,0
369220,14,14,0,0,0
369268,255,255,0,0,0
369276,15,15,0,0,0
369284,58,58,0,0,0
369310,180,180,0,0,0
369312,310,310,0,0,0
369349,353,353,0,0,0
369371,201,201,0,0,0
369383,70,70,0,0,0
369394,121,121,0,0,0
369397,163,163,0,0,0
369407,24,24,0,0,0
369446,29,29,0,0,0
369452,77,77,0,0,0
369515,184,184,0,0,0
369528,359,359,0,0,0
369533,77,77,0,0,0
369534,198,198,0,0,0
369553,171,171,0,0,0
369564,151,151,0,0,0
369574,144,144,0,0,0
369577,83,83,0,0,0
369587,3,3,0,0,0
369591,251,251,0,0,0
369630,114,114,0,0,0
369647,232,232,0,0,0
369659,168,168,0,0,0
369671,359,359,0,0,0
369678,193,193,0,0,0
369679,6,6,0,0,0
369689,158,158,0,0,0
369691,255,255,0,0,0
369696,72,72,0,0,0
369698,2,2,0,0,0
369707,56,56,0,0,0
369710,184,184,0,0,0
369717,27,27,0,0,0
369726,151,151,0,0,0
369730,171,171,0,0,0
369731,259,259,0,0,0
369732,313,313,0,0,0
369743,315,315,0,0,0
369766,9,9,0,0,0
369784,17,17,0,0,0
369808,198,198,0,0,0
369810,163,163,0,0,0
369818,36,36,0,0,0
369822,32,32,0,0,0
369826,27,27,0,0,0
369829,22,22,0,0,0
369847,306,306,0,0,0
369848,70,70,0,0,0
369873,201,201,0,0,0
369900,281,281,0,0,0
369901,251,251,0,0,0
369924,144,144,0,0,0
369927,246,246,0,0,0
369941,359,359,0,0,0
369963,299,299,0,0,0
369978,246,246,0,0,0
369996,167,167,0,0,0
369997,252,252,0,0,0
369999,40,40,0,0,0
370016,45,45,0,0,0
370077,12,12,0,0,0
370080,151,151,0,0,0
370090,137,137,0,0,0
370094,50,50,0,0,0
370119,306,306,0,0,0
370124,39,39,0,0,0
370159,74,74,0,0,0
370160,6,6,0,0,0
370161,282,282,0,0,0
370164,402,402,0,0,0
370175,193,193,0,0,0
370185,152,152,0,0,0
370206,171,171,0,0,0
370208,1,1,0,0,0
370254,87,87,0,0,0
370257,20,20,0,0,0
370266,246,246,0,0,0
370282,158,158,0,0,0
370285,252,252,0,0,0
370296,299,299,0,0,0
370306,281,281,0,0,0
370316,67,67,0,0,0
370323,259,259,0,0,0
370336,402,402,0,0,0
370352,85,85,0,0,0
370354,345,345,0,0,0
370366,132,132,0,0,0
370408,12,12,0,0,0
370412,29,29,0,0,0
370415,281,281,0,0,0
370425,282,282,0,0,0
370444,281,281,0,0,0
370446,128,128,0,0,0
370450,121,121,0,0,0
370454,130,130,0,0,0
370458,101,101,0,0,0
370469,313,313,0,0,0
370558,20,20,0,0,0
370561,359,359,0,0,0
370573,359,359,0,0,0
370574,75,75,0,0,0
370582,55,55,0,0,0
370590,74,74,0,0,0
370598,151,151,0,0,0
370616,54,54,0,0,0
370618,152,152,0,0,0
370619,281,281,0,0,0
370622,22,22,0,0,0
370623,65,65,0,0,0
370662,8,8,0,0,0
370667,94,94,0,0,0
370677,144,144,0,0,0
370707,20,20,0,0,0
370713,306,306,0,0,0
370716,66,66,0,0,0
370717,313,313,0,0,0
370731,299,299,0,0,0
370754,143,143,0,0,0
370774,345,345,0,0,0
370787,24,24,0,0,0
370791,83,83,0,0,0
370802,128,128,0,0,0
370815,9,9,0,0,0
370818,168,168,0,0,0
370825,114,114,0,0,0
370837,168,168,0,0,0
370856,36,36,0,0,0
370860,14,14,0,0,0
370866,3,3,0,0,0
370871,1,1,0,0,0
370880,158,158,0,0,0
370899,85,85,0,0,0
370905,151,151,0,0,0
370926,143,143,0,0,0
370935,353,353,0,0,0
370944,281,281,0,0,0
370946,23,23,0,0,0
370967,130,130,0,0,0
370969,20,20,0,0,0
370981,315,315,0,0,0
370984,71,71,0,0,0
370990,180,180,0,0,0
370992,359,359,0,0,0
370993,24,24,0,0,0
370994,198,198,0,0,0
370998,359,359,0,0,0
371036,113,113,0,0,0
371053,137,137,0,0,0
371055,102,102,0,0,0
371069,27,27,0,0,0
371078,180,180,0,0,0
371108,152,152,0,0,0
371109,76,76,0,0,0
371117,345,345,0,0,0
371121,193,193,0,0,0
371163,255,255,0,0,0
371183,167,167,0,0,0
371204,77,77,0,0,0
371247,2,2,0,0,0
371254,3,3,0,0,0
371257,43,43,0,0,0
371269,5,5,0,0,0
371282,198,198,0,0,0
371286,102,102,0,0,0
371287,299,299,0,0,0
371312,17,17,0,0,0
371324,201,201,0,0,0
371334,198,198,0,0,0
371338,198,198,0,0,0
371368,201,201,0,0,0
371372,359,359,0,0,0
371380,137,137,0,0,0
371400,168,168,0,0,0
371402,27,27,0,0,0
371414,315,315,0,0,0
371418,184,184,0,0,0
371423,12,12,0,0,0
371434,251,251,0,0,0
371435,163,163,0,0,0
371437,168,168,0,0,0
371446,201,201,0,0,0
371456,97,97,0,0,0
371461,120,120,0,0,0
371493,143,143,0,0,0
371502,306,306,0,0,0
371509,65,65,0,0,0
371513,128,128,0,0,0
371528,5,5,0,0,0
371536,198,198,0,0,0
371542,252,252,0,0,0
371565,103,103,0,0,0
371571,101,101,0,0,0
371595,30,30,0,0,0
371601,201,201,0,0,0
371607,20,20,0,0,0
371633,21,21,0,0,0
371641,251,251,0,0,0
371696,246,246,0,0,0
371709,180,180,0,0,0
371715,103,103,0,0,0
371728,163,163,0,0,0
371734,63,63,0,0,0
371735,39,39,0,0,0
371740,74,74,0,0,0
371745,101,101,0,0,0
371747,5,5,0,0,0
371759,167,167,0,0,0
371762,114,114,0,0,0
371795,50,50,0,0,0
371797,201,201,0,0,0
371818,259,259,0,0,0
371832,7,7,0,0,0
371842,50,50,0,0,0
371843,306,306,0,0,0
371888,17,17,0,0,0
371909,252,252,0,0,0
371919,128,128,0,0,0
371925,34,34,0,0,0
371950,402,402,0,0,0
371960,144,144,0,0,0
371977,94,94,0,0,0
371985,131,131,0,0,0
371995,131,131,0,0,0
371999,353,353,0,0,0
372032,359,359,0,0,0
372052,5,5,0,0,0
372053,345,345,0,0,0
372060,310,310,0,0,0
372071,34,34,0,0,0
372110,5,5,0,0,0
372116,353,353,0,0,0
372188,121,121,0,0,0
372212,353,353,0,0,0
372228,102,102,0,0,0
372232,402,402,0,0,0
372248,101,101,0,0,0
372281,102,102,0,0,0
372324,282,282,0,0,0
372330,74,74,0,0,0
372332,201,201,0,0,0
372342,101,101,0,0,0
372363,180,180,0,0,0
372365,282,282,0,0,0
372380,168,168,0,0,0
372400,30,30,0,0,0
372401,281,281,0,0,0
372421,9,9,0,0,0
372424,246,246,0,0,0
372429,70,70,0,0,0
372438,133,133,0,0,0
372440,359,359,0,0,0
372465,102,102,0,0,0
372471,353,353,0,0,0
372476,171,171,0,0,0
372488,306,306,0,0,0
372499,137,137,0,0,0
372504,3,3,0,0,0
372506,232,232,0,0,0
372509,313,313,0,0,0
372528,167,167,0,0,0
372550,282,282,0,0,0
372557,113,113,0,0,0
372580,313,313,0,0,0
372586,252,252,0,0,0
372587,67,67,0,0,0
372611,6,6,0,0,0
372644,359,359,0,0,0
372661,402,402,0,0,0
372676,180,180,0,0,0
372677,71,71,0,0,0
372686,353,353,0,0,0
372689,128,128,0,0,0
372706,259,259,0,0,0
372710,281,281,0,0,0
372722,131,131,0,0,0
372726,167,167,0,0,0
372741,193,193,0,0,0
372742,58,58,0,0,0
372744,246,246,0,0,0
372745,82,82,0,0,0
372748,103,103,0,0,0
372768,282,282,0,0,0
372770,282,282,0,0,0
372796,299,299,0,0,0
372821,77,77,0,0,0
372852,168,168,0,0,0
372857,193,193,0,0,0
372866,75,75,0,0,0
372869,82,82,0,0,0
372880,133,133,0,0,0
372908,77,77,0,0,0
372914,40,40,0,0,0
372924,56,56,0,0,0
372933,131,131,0,0,0
372936,158,158,0,0,0
372948,87,87,0,0,0
372962,15,15,0,0,0
372964,54,54,0,0,0
372967,113,113,0,0,0
372969,167,167,0,0,0
372976,310,310,0,0,0
372981,41,41,0,0,0
372984,359,359,0,0,0
373000,10,10,0,0,0
373006,55,55,0,0,0
373014,85,85,0,0,0
373029,167,167,0,0,0
373036,163,163,0,0,0
373046,137,137,0,0,0
373055,180,180,0,0,0
373066,151,151,0,0,0
373073,102,102,0,0,0
373100,3,3,0,0,0
373105,35,35,0,0,0
373116,137,137,0,0,0
373136,313,313,0,0,0
373148,133,133,0,0,0
373156,87,87,0,0,0
373177,71,71,0,0,0
373190,152,152,0,0,0
373193,151,151,0,0,0
373205,65,65,0,0,0
373208,34,34,0,0,0
373209,87,87,0,0,0
373215,359,359,0,0,0
373224,232,232,0,0,0
373234,193,193,0,0,0
373244,67,67,0,0,0
373247,259,259,0,0,0
373254,313,313,0,0,0
373272,114,114,0,0,0
373278,76,76,0,0,0
373279,54,54,0,0,0
373285,402,402,0,0,0
373301,9,9,0,0,0
373319,158,158,0,0,0
373333,114,114,0,0,0
373342,313,313,0,0,0
373354,359,359,0,0,0
373371,168,168,0,0,0
373380,69,69,0,0,0
373387,35,35,0,0,0
373391,7,7,0,0,0
373397,72,72,0,0,0
373420,168,168,0,0,0
373430,167,167,0,0,0
373437,82,82,0,0,0
373459,315,315,0,0,0
373471,232,232,0,0,0
373474,171,171,0,0,0
373514,251,251,0,0,0
373542,34,34,0,0,0
373550,32,32,0,0,0
373558,171,171,0,0,0
373561,359,359,0,0,0
373579,137,137,0,0,0
373607,71,71,0,0,0
373614,402,402,0,0,0
373616,29,29,0,0,0
373617,45,45,0,0,0
373646,359,359,0,0,0
373647,201,201,0,0,0
373656,359,359,0,0,0
373657,15,15,0,0,0
373675,54,54,0,0,0
373684,74,74,0,0,0
373694,102,102,0,0,0
373699,345,345,0,0,0
373713,83,83,0,0,0
373727,10,10,0,0,0
373749,158,158,0,0,0
373758,306,306,0,0,0
373768,15,15,0,0,0
373783,137,137,0,0,0
373812,193,193,0,0,0
373830,255,255,0,0,0
373832,359,359,0,0,0
373842,102,102,0,0,0
373855,76,76,0,0,0
373862,168,168,0,0,0
373871,15,15,0,0,0
373872,7,7,0,0,0
373899,168,168,0,0,0
373943,22,22,0,0,0
373963,120,120,0,0,0
373967,359,359,0,0,0
373984,306,306,0,0,0
373987,246,246,0,0,0
373991,193,193,0,0,0
374004,5,5,0,0,0
374012,3,3,0,0,0
374014,299,299,0,0,0
374024,345,345,0,0,0
374025,232,232,0,0,0
374030,180,180,0,0,0
374056,353,353,0,0,0
374067,12,12,0,0,0
374082,180,180,0,0,0
374105,6,6,0,0,0
374108,101,101,0,0,0
374123,232,232,0,0,0
374128,97,97,0,0,0
374132,15,15,0,0,0
374139,35,35,0,0,0
374148,306,306,0,0,0
374149,63,63,0,0,0
374153,246,246,0,0,0
374164,1,1,0,0,0
374166,114,114,0,0,0
374171,113,113,0,0,0
374174,313,313,0,0,0
374190,345,345,0,0,0
374197,102,102,0,0,0
374209,94,94,0,0,0
374213,359,359,0,0,0
374217,121,121,0,0,0
374222,201,201,0,0,0
374238,70,70,0,0,0
374260,313,313,0,0,0
374264,184,184,0,0,0
374272,35,35,0,0,0
374278,310,310,0,0,0
374325,65,65,0,0,0
374328,345,345,0,0,0
374330,201,201,0,0,0
374339,359,359,0,0,0
374343,144,144,0,0,0
374345,2,2,0,0,0
374359,252,252,0,0,0
374380,359,359,0,0,0
374392,310,310,0,0,0
374415,56,56,0,0,0
374416,251,251,0,0,0
374419,113,113,0,0,0
374423,56,56,0,0,0
374430,232,232,0,0,0
374433,102,102,0,0,0
374449,71,71,0,0,0
374459,121,121,0,0,0
374460,252,252,0,0,0
374487,50,50,0,0,0
374489,30,30,0,0,0
374527,27,27,0,0,0
374528,18,18,0,0,0
374538,97,97,0,0,0
374539,402,402,0,0,0
374540,12,12,0,0,0
374570,8,8,0,0,0
374577,5,5,0,0,0
374581,167,167,0,0,0
374586,152,152,0,0,0
374616,144,144,0,0,0
374622,66,66,0,0,0
374624,359,359,0,0,0
374629,152,152,0,0,0
374637,171,171,0,0,0
374656,184,184,0,0,0
374659,137,137,0,0,0
374666,56,56,0,0,0
374673,30,30,0,0,0
374676,27,27,0,0,0
374686,44,44,0,0,0
374706,71,71,0,0,0
374724,313,313,0,0,0
374732,114,114,0,0,0
374738,69,69,0,0,0
374748,353,353,0,0,0
374765,74,74,0,0,0
374766,102,102,0,0,0
374777,133,133,0,0,0
374779,58,58,0,0,0
374780,315,315,0,0,0
374782,128,128,0,0,0
374791,11,11,0,0,0
374814,131,131,0,0,0
374824,193,193,0,0,0
374834,87,87,0,0,0
374836,71,71,0,0,0
374838,171,171,0,0,0
374843,19,19,0,0,0
374850,251,251,0,0,0
374856,102,102,0,0,0
374863,184,184,0,0,0
374867,252,252,0,0,0
374874,54,54,0,0,0
374877,101,101,0,0,0
374888,299,299,0,0,0
374900,306,306,0,0,0
374906,353,353,0,0,0
374928,180,180,0,0,0
374948,252,252,0,0,0
374953,198,198,0,0,0
374955,193,193,0,0,0
374978,3,3,0,0,0
374998,310,310,0,0,0
375004,299,299,0,0,0
375006,299,299,0,0,0
375009,252,252,0,0,0
375033,299,299,0,0,0
375045,50,50,0,0,0
375049,143,143,0,0,0
375050,345,345,0,0,0
375056,359,359,0,0,0
375063,58,58,0,0,0
375064,45,45,0,0,0
375068,180,180,0,0,0
375069,25,25,0,0,0
375074,121,121,0,0,0
375075,255,255,0,0,0
375083,24,24,0,0,0
375087,252,252,0,0,0
375100,72,72,0,0,0
375101,353,353,0,0,0
375112,359,359,0,0,0
375118,251,251,0,0,0
375139,306,306,0,0,0
375149,158,158,0,0,0
375151,299,299,0,0,0
375160,114,114,0,0,0
375162,281,281,0,0,0
375173,36,36,0,0,0
375178,252,252,0,0,0
375187,259,259,0,0,0
375190,184,184,0,0,0
375192,114,114,0,0,0
375193,67,67,0,0,0
375194,82,82,0,0,0
375226,184,184,0,0,0
375233,193,193,0,0,0
375257,168,168,0,0,0
375265,359,359,0,0,0
375274,55,55,0,0,0
375279,17,17,0,0,0
375288,16,16,0,0,0
375296,171,171,0,0,0
375313,94,94,0,0,0
375332,193,193,0,0,0
375338,39,39,0,0,0
375339,69,69,0,0,0
375342,313,313,0,0,0
375350,23,23,0,0,0
375352,76,76,0,0,0
375365,313,313,0,0,0
375366,359,359,0,0,0
375379,306,306,0,0,0
375382,281,281,0,0,0
375408,24,24,0,0,0
375421,131,131,0,0,0
375427,310,310,0,0,0
375429,359,359,0,0,0
375491,144,144,0,0,0
375499,299,299,0,0,0
375510,75,75,0,0,0
375517,15,15,0,0,0
375519,252,252,0,0,0
375520,193,193,0,0,0
375522,3,3,0,0,0
375525,40,40,0,0,0
375526,144,144,0,0,0
375534,281,281,0,0,0
375553,74,74,0,0,0
375555,18,18,0,0,0
375556,306,306,0,0,0
375560,17,17,0,0,0
375567,36,36,0,0,0
375581,315,315,0,0,0
375590,83,83,0,0,0
375593,313,313,0,0,0
375594,310,310,0,0,0
375597,313,313,0,0,0
375625,246,246,0,0,0
375655,144,144,0,0,0
375663,193,193,0,0,0
375675,102,102,0,0,0
375683,76,76,0,0,0
375694,77,77,0,0,0
375698,281,281,0,0,0
375699,121,121,0,0,0
375712,10,10,0,0,0
375715,255,255,0,0,0
375729,14,14,0,0,0
375731,353,353,0,0,0
375732,94,94,0,0,0
375735,36,36,0,0,0
375740,27,27,0,0,0
375754,359,359,0,0,0
375761,56,56,0,0,0
375765,56,56,0,0,0
375767,359,359,0,0,0
375788,69,69,0,0,0
375811,402,402,0,0,0
375816,168,168,0,0,0
375820,201,201,0,0,0
375841,43,43,0,0,0
375846,57,57,0,0,0
375850,252,252,0,0,0
375852,83,83,0,0,0
375860,143,143,0,0,0
375868,63,63,0,0,0
375877,310,310,0,0,0
375878,306,306,0,0,0
375883,121,121,0,0,0
375894,255,255,0,0,0
375896,315,315,0,0,0
375912,313,313,0,0,0
375939,282,282,0,0,0
375940,184,184,0,0,0
375946,163,163,0,0,0
375951,65,65,0,0,0
375978,76,76,0,0,0
375988,251,251,0,0,0
375991,299,299,0,0,0
375993,144,144,0,0,0
375998,315,315,0,0,0
376000,143,143,0,0,0
376010,1,1,0,0,0
376032,12,12,0,0,0
376037,65,65,0,0,0
376048,180,180,0,0,0
376061,306,306,0,0,0
376064,65,65,0,0,0
376102,14,14,0,0,0
376159,74,74,0,0,0
376163,299,299,0,0,0
376168,345,345,0,0,0
376181,74,74,0,0,0
376200,9,9,0,0,0
376210,114,114,0,0,0
376219,13,13,0,0,0
376223,87,87,0,0,0
376228,8,8,0,0,0
376235,251,251,0,0,0
376238,82,82,0,0,0
376240,15,15,0,0,0
376245,4,4,0,0,0
376279,151,151,0,0,0
376288,102,102,0,0,0
376314,143,143,0,0,0
376326,143,143,0,0,0
376328,36,36,0,0,0
376330,402,402,0,0,0
376335,120,120,0,0,0
376344,158,158,0,0,0
376357,259,259,0,0,0
376360,315,315,0,0,0
376369,20,20,0,0,0
376390,143,143,0,0,0
376391,193,193,0,0,0
376399,315,315,0,0,0
376412,168,168,0,0,0
376416,121,121,0,0,0
376426,259,259,0,0,0
376444,72,72,0,0,0
376446,281,281,0,0,0
376460,180,180,0,0,0
376463,63,63,0,0,0
376470,39,39,0,0,0
376473,58,58,0,0,0
376479,246,246,0,0,0
376492,102,102,0,0,0
376494,255,255,0,0,0
376508,56,56,0,0,0
376512,281,281,0,0,0
376517,198,198,0,0,0
376526,251,251,0,0,0
376530,94,94,0,0,0
376542,121,121,0,0,0
376546,345,345,0,0,0
376560,359,359,0,0,0
376576,167,167,0,0,0
376607,345,345,0,0,0
376615,359,359,0,0,0
376628,50,50,0,0,0
376634,198,198,0,0,0
376636,282,282,0,0,0
376662,281,281,0,0,0
376698,66,66,0,0,0
376721,102,102,0,0,0
376725,402,402,0,0,0
376732,39,39,0,0,0
376737,306,306,0,0,0
376751,21,21,0,0,0
376762,14,14,0,0,0
376774,251,251,0,0,0
376776,255,255,0,0,0
376789,158,158,0,0,0
376799,130,130,0,0,0
376802,121,121,0,0,0
376818,114,114,0,0,0
376825,128,128,0,0,0
376828,193,193,0,0,0
376847,19,19,0,0,0
376852,151,151,0,0,0
376856,2,2,0,0,0
376874,15,15,0,0,0
376879,255,255,0,0,0
376893,114,114,0,0,0
376894,36,36,0,0,0
376918,17,17,0,0,0
376937,167,167,0,0,0
376980,282,282,0,0,0
376988,72,72,0,0,0
376993,143,143,0,0,0
376995,255,255,0,0,0
377011,15,15,0,0,0
377014,306,306,0,0,0
377019,74,74,0,0,0
377045,19,19,0,0,0
377046,152,152,0,0,0
377052,8,8,0,0,0
377055,201,201,0,0,0
377079,246,246,0,0,0
377083,144,144,0,0,0
377085,167,167,0,0,0
377092,315,315,0,0,0
377105,69,69,0,0,0
377109,85,85,0,0,0
377125,97,97,0,0,0
377128,198,198,0,0,0
377145,353,353,0,0,0
377154,114,114,0,0,0
377162,402,402,0,0,0
377167,306,306,0,0,0
377182,137,137,0,0,0
377187,63,63,0,0,0
377188,246,246,0,0,0
377209,167,167,0,0,0
377221,114,114,0,0,0
377234,102,102,0,0,0
377263,22,22,0,0,0
377267,6,6,0,0,0
377274,50,50,0,0,0
377280,201,201,0,0,0
377287,171,171,0,0,0
377289,103,103,0,0,0
377308,184,184,0,0,0
377331,82,82,0,0,0
377335,282,282,0,0,0
377342,133,133,0,0,0
377348,310,310,0,0,0
377351,120,120,0,0,0
377367,184,184,0,0,0
377386,114,114,0,0,0
377398,246,246,0,0,0
377413,15,15,0,0,0
377432,232,232,0,0,0
377442,306,306,0,0,0
377446,74,74,0,0,0
377479,232,232,0,0,0
377484,158,158,0,0,0
377487,143,143,0,0,0
377512,114,114,0,0,0
377513,315,315,0,0,0
377518,35,35,0,0,0
377519,345,345,0,0,0
377532,252,252,0,0,0
377542,201,201,0,0,0
377573,201,201,0,0,0
377577,58,58,0,0,0
377578,1,1,0,0,0
377590,282,282,0,0,0
377601,120,120,0,0,0
377603,315,315,0,0,0
377627,281,281,0,0,0
377634,103,103,0,0,0
377638,353,353,0,0,0
377640,251,251,0,0,0
377650,313,313,0,0,0
377651,45,45,0,0,0
377710,114,114,0,0,0
377712,310,310,0,0,0
377719,58,58,0,0,0
377721,133,133,0,0,0
377736,102,102,0,0,0
377754,34,34,0,0,0
377761,180,180,0,0,0
377764,102,102,0,0,0
377779,282,282,0,0,0
377811,246,246,0,0,0
377812,180,180,0,0,0
377824,120,120,0,0,0
377841,131,131,0,0,0
377852,201,201,0,0,0
377861,359,359,0,0,0
377868,259,259,0,0,0
377904,163,163,0,0,0
377906,121,121,0,0,0
377907,114,114,0,0,0
377908,310,310,0,0,0
377913,15,15,0,0,0
377926,167,167,0,0,0
377932,345,345,0,0,0
377962,6,6,0,0,0
377977,43,43,0,0,0
378003,17,17,0,0,0
378032,87,87,0,0,0
378039,17,17,0,0,0
378050,12,12,0,0,0
378058,353,353,0,0,0
378076,198,198,0,0,0
378080,120,120,0,0,0
378081,29,29,0,0,0
378156,71,71,0,0,0
378160,28,28,0,0,0
378176,7,7,0,0,0
378179,252,252,0,0,0
378206,168,168,0,0,0
378215,246,246,0,0,0
378223,137,137,0,0,0
378224,58,58,0,0,0
378229,137,137,0,0,0
378242,97,97,0,0,0
378250,137,137,0,0,0
378306,232,232,0,0,0
378325,232,232,0,0,0
378348,402,402,0,0,0
378357,102,102,0,0,0
378363,32,32,0,0,0
378364,114,114,0,0,0
378368,9,9,0,0,0
378403,345,345,0,0,0
378414,16,16,0,0,0
378437,22,22,0,0,0
378440,143,143,0,0,0
378451,102,102,0,0,0
378454,121,121,0,0,0
378458,18,18,0,0,0
378493,345,345,0,0,0
378496,158,158,0,0,0
378502,121,121,0,0,0
378509,184,184,0,0,0
378530,251,251,0,0,0
378577,69,69,0,0,0
378616,58,58,0,0,0
378619,306,306,0,0,0
378625,282,282,0,0,0
378655,353,353,0,0,0
378661,232,232,0,0,0
378668,87,87,0,0,0
378671,315,315,0,0,0
378674,345,345,0,0,0
378676,137,137,0,0,0
378679,171,171,0,0,0
378700,313,313,0,0,0
378706,121,121,0,0,0
378707,18,18,0,0,0
378708,28,28,0,0,0
378712,114,114,0,0,0
378719,3,3,0,0,0
378723,121,121,0,0,0
378727,22,22,0,0,0
378728,18,18,0,0,0
378734,50,50,0,0,0
378743,359,359,0,0,0
378747,83,83,0,0,0
378758,232,232,0,0,0
378760,87,87,0,0,0
378761,402,402,0,0,0
378766,259,259,0,0,0
378775,345,345,0,0,0
378780,94,94,0,0,0
378790,232,232,0,0,0
378807,353,353,0,0,0
378819,82,82,0,0,0
378846,167,167,0,0,0
378853,5,5,0,0,0
378856,315,315,0,0,0
378880,282,282,0,0,0
378881,19,19,0,0,0
378882,8,8,0,0,0
378893,402,402,0,0,0
378899,17,17,0,0,0
378900,128,128,0,0,0
378909,128,128,0,0,0
378912,345,345,0,0,0
378928,184,184,0,0,0
378931,143,143,0,0,0
378937,184,184,0,0,0
378955,151,151,0,0,0
378971,69,69,0,0,0
379018,137,137,0,0,0
379031,281,281,0,0,0
379045,299,299,0,0,0
379064,180,180,0,0,0
379069,67,67,0,0,0
379071,198,198,0,0,0
379079,180,180,0,0,0
379107,313,313,0,0,0
379122,14,14,0,0,0
379128,353,353,0,0,0
379140,94,94,0,0,0
379169,97,97,0,0,0
379180,180,180,0,0,0
379182,144,144,0,0,0
379189,353,353,0,0,0
379201,102,102,0,0,0
379216,259,259,0,0,0
379219,133,133,0,0,0
379246,402,402,0,0,0
379252,76,76,0,0,0
379271,25,25,0,0,0
379293,158,158,0,0,0
379295,16,16,0,0,0
379296,87,87,0,0,0
379317,313,313,0,0,0
379325,39,39,0,0,0
379342,12,12,0,0,0
379349,76,76,0,0,0
379350,167,167,0,0,0
379354,158,158,0,0,0
379356,56,56,0,0,0
379372,83,83,0,0,0
379373,353,353,0,0,0
379380,22,22,0,0,0
379382,313,313,0,0,0
379408,16,16,0,0,0
379431,97,97,0,0,0
379441,75,75,0,0,0
379446,11,11,0,0,0
379452,315,315,0,0,0
379464,345,345,0,0,0
379477,29,29,0,0,0
379485,83,83,0,0,0
379496,120,120,0,0,0
379499,113,113,0,0,0
379509,255,255,0,0,0
379512,201,201,0,0,0
379538,402,402,0,0,0
379547,120,120,0,0,0
379551,184,184,0,0,0
379557,299,299,0,0,0
379559,345,345,0,0,0
379563,76,76,0,0,0
379575,87,87,0,0,0
379577,74,74,0,0,0
379584,158,158,0,0,0
379603,74,74,0,0,0
379613,315,315,0,0,0
379622,76,76,0,0,0
379642,77,77,0,0,0
379654,71,71,0,0,0
379675,65,65,0,0,0
379708,16,16,0,0,0
379734,102,102,0,0,0
379746,11,11,0,0,0
379748,17,17,0,0,0
379772,15,15,0,0,0
379780,359,359,0,0,0
379787,281,281,0,0,0
379807,63,63,0,0,0
379821,306,306,0,0,0
379822,65,65,0,0,0
379830,201,201,0,0,0
379853,315,315,0,0,0
379857,130,130,0,0,0
379868,43,43,0,0,0
379874,163,163,0,0,0
379887,34,34,0,0,0
379889,131,131,0,0,0
379923,315,315,0,0,0
379945,113,113,0,0,0
379946,306,306,0,0,0
379961,114,114,0,0,0
379963,97,97,0,0,0
379976,35,35,0,0,0
379983,198,198,0,0,0
379985,102,102,0,0,0
379990,76,76,0,0,0
379993,201,201,0,0,0
380018,255,255,0,0,0
380063,137,137,0,0,0
380070,102,102,0,0,0
380079,282,282,0,0,0
380085,359,359,0,0,0
380091,315,315,0,0,0
380096,102,102,0,0,0
380099,180,180,0,0,0
380101,232,232,0,0,0
380106,27,27,0,0,0
380122,74,74,0,0,0
380135,158,158,0,0,0
380151,130,130,0,0,0
380156,65,65,0,0,0
380165,315,315,0,0,0
380193,359,359,0,0,0
380208,232,232,0,0,0
380220,1,1,0,0,0
380228,201,201,0,0,0
380239,45,45,0,0,0
380256,252,252,0,0,0
380268,255,255,0,0,0
380277,74,74,0,0,0
380300,359,359,0,0,0
380307,27,27,0,0,0
380313,402,402,0,0,0
380319,3,3,0,0,0
380322,345,345,0,0,0
380325,310,310,0,0,0
380336,345,345,0,0,0
380341,171,171,0,0,0
380346,137,137,0,0,0
380359,246,246,0,0,0
380365,259,259,0,0,0
380367,315,315,0,0,0
380372,171,171,0,0,0
380375,102,102,0,0,0
380377,8,8,0,0,0
380381,50,50,0,0,0
380387,13,13,0,0,0
380397,255,255,0,0,0
380398,313,313,0,0,0
380403,246,246,0,0,0
380406,10,10,0,0,0
380413,282,282,0,0,0
380426,353,353,0,0,0
380438,10,10,0,0,0
380443,152,152,0,0,0
380455,310,310,0,0,0
380467,353,353,0,0,0
380480,255,255,0,0,0
380517,3,3,0,0,0
380564,25,25,0,0,0
380580,251,251,0,0,0
380582,121,121,0,0,0
380594,359,359,0,0,0
380603,198,198,0,0,0
380621,113,113,0,0,0
380637,402,402,0,0,0
380659,255,255,0,0,0
380660,143,143,0,0,0
380670,102,102,0,0,0
380686,19,19,0,0,0
380689,345,345,0,0,0
380690,14,14,0,0,0
380693,299,299,0,0,0
380704,113,113,0,0,0
380710,313,313,0,0,0
380717,45,45,0,0,0
380742,306,306,0,0,0
380767,171,171,0,0,0
380795,85,85,0,0,0
380827,15,15,0,0,0
380833,74,74,0,0,0
380845,121,121,0,0,0
380848,345,345,0,0,0
380858,299,299,0,0,0
380861,10,10,0,0,0
380880,171,171,0,0,0
380886,282,282,0,0,0
380888,198,198,0,0,0
380899,359,359,0,0,0
380900,299,299,0,0,0
380905,56,56,0,0,0
380909,121,121,0,0,0
380923,255,255,0,0,0
380926,27,27,0,0,0
380928,121,121,0,0,0
380949,131,131,0,0,0
380963,97,97,0,0,0
380966,70,70,0,0,0
380976,143,143,0,0,0
380990,128,128,0,0,0
380996,144,144,0,0,0
381025,143,143,0,0,0
381045,43,43,0,0,0
381072,18,18,0,0,0
381075,76,76,0,0,0
381076,56,56,0,0,0
381097,74,74,0,0,0
381110,11,11,0,0,0
381115,259,259,0,0,0
381120,50,50,0,0,0
381133,198,198,0,0,0
381135,359,359,0,0,0
381149,232,232,0,0,0
381153,14,14,0,0,0
381157,17,17,0,0,0
381163,353,353,0,0,0
381169,4,4,0,0,0
381174,299,299,0,0,0
381182,69,69,0,0,0
381205,299,299,0,0,0
381226,82,82,0,0,0
381228,102,102,0,0,0
381233,71,71,0,0,0
381283,193,193,0,0,0
381286,120,120,0,0,0
381295,114,114,0,0,0
381304,20,20,0,0,0
381306,43,43,0,0,0
381307,345,345,0,0,0
381359,39,39,0,0,0
381361,72,72,0,0,0
381364,353,353,0,0,0
381367,102,102,0,0,0
381373,30,30,0,0,0
381385,313,313,0,0,0
381390,82,82,0,0,0
381398,103,103,0,0,0
381405,7,7,0,0,0
381412,56,56,0,0,0
381415,17,17,0,0,0
381418,313,313,0,0,0
381436,70,70,0,0,0
381457,144,144,0,0,0
381458,131,131,0,0,0
381466,76,76,0,0,0
381499,281,281,0,0,0
381517,29,29,0,0,0
381522,131,131,0,0,0
381542,251,251,0,0,0
381592,299,299,0,0,0
381604,144,144,0,0,0
381629,50,50,0,0,0
381636,10,10,0,0,0
381643,120,120,0,0,0
381645,158,158,0,0,0
381659,402,402,0,0,0
381675,94,94,0,0,0
381676,121,121,0,0,0
381691,34,34,0,0,0
381692,133,133,0,0,0
381696,121,121,0,0,0
381697,131,131,0,0,0
381700,102,102,0,0,0
381725,94,94,0,0,0
381726,315,315,0,0,0
381730,201,201,0,0,0
381742,313,313,0,0,0
381749,56,56,0,0,0
381773,299,299,0,0,0
381800,74,74,0,0,0
381812,137,137,0,0,0
381818,306,306,0,0,0
381820,232,232,0,0,0
381837,167,167,0,0,0
381842,44,44,0,0,0
381844,83,83,0,0,0
381858,151,151,0,0,0
381859,193,193,0,0,0
381866,77,77,0,0,0
381869,251,251,0,0,0
381880,184,184,0,0,0
381891,7,7,0,0,0
381894,15,15,0,0,0
381921,120,120,0,0,0
381924,198,198,0,0,0
381951,27,27,0,0,0
381982,313,313,0,0,0
381990,103,103,0,0,0
382014,69,69,0,0,0
382028,306,306,0,0,0
382035,143,143,0,0,0
382036,281,281,0,0,0
382043,281,281,0,0,0
382049,167,167,0,0,0
382050,75,75,0,0,0
382057,87,87,0,0,0
382079,402,402,0,0,0
382098,1,1,0,0,0
382105,12,12,0,0,0
382118,94,94,0,0,0
382119,83,83,0,0,0
382121,40,40,0,0,0
382133,2,2,0,0,0
382134,101,101,0,0,0
382141,30,30,0,0,0
382162,158,158,0,0,0
382163,7,7,0,0,0
382169,402,402,0,0,0
382200,113,113,0,0,0
382204,72,72,0,0,0
382207,70,70,0,0,0
382210,201,201,0,0,0
382235,144,144,0,0,0
382278,310,310,0,0,0
382280,255,255,0,0,0
382293,232,232,0,0,0
382299,251,251,0,0,0
382302,246,246,0,0,0
382304,345,345,0,0,0
382329,24,24,0,0,0
382332,82,82,0,0,0
382336,97,97,0,0,0
382341,24,24,0,0,0
382345,315,315,0,0,0
382348,282,282,0,0,0
382353,402,402,0,0,0
382360,252,252,0,0,0
382364,25,25,0,0,0
382405,315,315,0,0,0
382432,193,193,0,0,0
382434,137,137,0,0,0
382457,103,103,0,0,0
382459,94,94,0,0,0
382511,198,198,0,0,0
382522,130,130,0,0,0
382524,158,158,0,0,0
382530,8,8,0,0,0
382532,193,193,0,0,0
382535,402,402,0,0,0
382545,74,74,0,0,0
382548,56,56,0,0,0
382563,299,299,0,0,0
382564,171,171,0,0,0
382596,22,22,0,0,0
382604,103,103,0,0,0
382610,22,22,0,0,0
382620,132,132,0,0,0
382627,353,353,0,0,0
382633,103,103,0,0,0
382638,69,69,0,0,0
382643,39,39,0,0,0
382651,281,281,0,0,0
382652,137,137,0,0,0
382661,36,36,0,0,0
382708,353,353,0,0,0
382723,168,168,0,0,0
382726,252,252,0,0,0
382748,1,1,0,0,0
382755,24,24,0,0,0
382769,193,193,0,0,0
382776,281,281,0,0,0
382780,180,180,0,0,0
382795,143,143,0,0,0
382801,45,45,0,0,0
382804,315,315,0,0,0
382847,7,7,0,0,0
382848,299,299,0,0,0
382851,34,34,0,0,0
382853,144,144,0,0,0
382855,310,310,0,0,0
382873,24,24,0,0,0
382874,201,201,0,0,0
382886,72,72,0,0,0
382889,198,198,0,0,0
382890,72,72,0,0,0
382891,130,130,0,0,0
382897,306,306,0,0,0
382898,310,310,0,0,0
382908,76,76,0,0,0
382918,77,77,0,0,0
382928,168,168,0,0,0
382936,299,299,0,0,0
382951,353,353,0,0,0
382975,76,76,0,0,0
382993,167,167,0,0,0
382999,180,180,0,0,0
383007,353,353,0,0,0
383008,35,35,0,0,0
383009,14,14,0,0,0
383010,19,19,0,0,0
383016,402,402,0,0,0
383045,144,144,0,0,0
383047,310,310,0,0,0
383048,201,201,0,0,0
383074,251,251,0,0,0
383090,20,20,0,0,0
383098,198,198,0,0,0
383113,74,74,0,0,0
383156,353,353,0,0,0
383213,83,83,0,0,0
383232,102,102,0,0,0
383236,201,201,0,0,0
383259,103,103,0,0,0
383279,143,143,0,0,0
383283,57,57,0,0,0
383289,299,299,0,0,0
383306,315,315,0,0,0
383308,152,152,0,0,0
383334,40,40,0,0,0
383341,13,13,0,0,0
383352,114,114,0,0,0
383368,5,5,0,0,0
383370,34,34,0,0,0
383373,143,143,0,0,0
383418,43,43,0,0,0
383425,167,167,0,0,0
383434,63,63,0,0,0
383436,137,137,0,0,0
383445,255,255,0,0,0
383454,163,163,0,0,0
383456,315,315,0,0,0
383461,39,39,0,0,0
383465,198,198,0,0,0
383479,50,50,0,0,0
383482,74,74,0,0,0
383510,313,313,0,0,0
383513,232,232,0,0,0
383519,313,313,0,0,0
383520,76,76,0,0,0
383532,102,102,0,0,0
383539,22,22,0,0,0
383549,87,87,0,0,0
383563,102,102,0,0,0
383574,114,114,0,0,0
383583,102,102,0,0,0
383586,246,246,0,0,0
383588,167,167,0,0,0
383595,45,45,0,0,0
383600,313,313,0,0,0
383602,9,9,0,0,0
383609,299,299,0,0,0
383616,359,359,0,0,0
383618,114,114,0,0,0
383646,35,35,0,0,0
383667,180,180,0,0,0
383676,35,35,0,0,0
383679,94,94,0,0,0
383694,131,131,0,0,0
383715,232,232,0,0,0
383716,281,281,0,0,0
383732,39,39,0,0,0
383739,12,12,0,0,0
383754,10,10,0,0,0
383759,10,10,0,0,0
383764,158,158,0,0,0
383775,85,85,0,0,0
383781,103,103,0,0,0
383791,193,193,0,0,0
383795,22,22,0,0,0
383801,345,345,0,0,0
383809,102,102,0,0,0
383825,17,17,0,0,0
383839,353,353,0,0,0
383843,70,70,0,0,0
383844,121,121,0,0,0
383848,306,306,0,0,0
383849,198,198,0,0,0
383853,76,76,0,0,0
383862,158,158,0,0,0
383868,76,76,0,0,0
383900,69,69,0,0,0
383901,1,1,0,0,0
383946,198,198,0,0,0
383962,315,315,0,0,0
383991,19,19,0,0,0
384035,255,255,0,0,0
384036,315,315,0,0,0
384043,281,281,0,0,0
384045,20,20,0,0,0
384063,246,246,0,0,0
384066,66,66,0,0,0
384068,232,232,0,0,0
384079,94,94,0,0,0
384095,353,353,0,0,0
384111,201,201,0,0,0
384114,259,259,0,0,0
384118,144,144,0,0,0
384164,2,2,0,0,0
384165,10,10,0,0,0
384168,137,137,0,0,0
384170,130,130,0,0,0
384198,101,101,0,0,0
384213,50,50,0,0,0
384222,120,120,0,0,0
384229,168,168,0,0,0
384247,345,345,0,0,0
384261,8,8,0,0,0
384262,315,315,0,0,0
384263,19,19,0,0,0
384285,121,121,0,0,0
384324,4,4,0,0,0
384328,315,315,0,0,0
384337,353,353,0,0,0
384351,158,158,0,0,0
384356,201,201,0,0,0
384371,85,85,0,0,0
384372,306,306,0,0,0
384387,7,7,0,0,0
384392,310,310,0,0,0
384396,114,114,0,0,0
384422,345,345,0,0,0
384424,310,310,0,0,0
384425,15,15,0,0,0
384429,402,402,0,0,0
384443,232,232,0,0,0
384465,36,36,0,0,0
384467,56,56,0,0,0
384475,3,3,0,0,0
384492,232,232,0,0,0
384496,7,7,0,0,0
384499,114,114,0,0,0
384511,310,310,0,0,0
384529,232,232,0,0,0
384530,15,15,0,0,0
384532,163,163,0,0,0
384539,36,36,0,0,0
384543,103,103,0,0,0
384551,246,246,0,0,0
384558,313,313,0,0,0
384563,82,82,0,0,0
384564,193,193,0,0,0
384582,35,35,0,0,0
384598,6,6,0,0,0
384617,313,313,0,0,0
384642,345,345,0,0,0
384652,184,184,0,0,0
384676,2,2,0,0,0
384681,1,1,0,0,0
384729,201,201,0,0,0
384734,82,82,0,0,0
384741,259,259,0,0,0
384742,103,103,0,0,0
384768,313,313,0,0,0
384777,67,67,0,0,0
384803,5,5,0,0,0
384807,137,137,0,0,0
384815,198,198,0,0,0
384819,55,55,0,0,0
384824,353,353,0,0,0
384835,246,246,0,0,0
384837,259,259,0,0,0
384840,94,94,0,0,0
384855,163,163,0,0,0
384885,246,246,0,0,0
384888,345,345,0,0,0
384891,133,133,0,0,0
384899,35,35,0,0,0
384910,151,151,0,0,0
384921,345,345,0,0,0
384929,402,402,0,0,0
384935,259,259,0,0,0
384948,143,143,0,0,0
384965,72,72,0,0,0
384987,35,35,0,0,0
384990,252,252,0,0,0
384991,131,131,0,0,0
385003,353,353,0,0,0
385027,359,359,0,0,0
385042,168,168,0,0,0
385077,5,5,0,0,0
385102,282,282,0,0,0
385114,152,152,0,0,0
385124,113,113,0,0,0
385135,76,76,0,0,0
385154,151,151,0,0,0
385162,18,18,0,0,0
385178,97,97,0,0,0
385183,113,113,0,0,0
385187,17,17,0,0,0
385190,252,252,0,0,0
385194,282,282,0,0,0
385205,102,102,0,0,0
385223,193,193,0,0,0
385244,251,251,0,0,0
385245,310,310,0,0,0
385247,97,97,0,0,0
385250,74,74,0,0,0
385299,143,143,0,0,0
385320,103,103,0,0,0
385332,22,22,0,0,0
385349,359,359,0,0,0
385376,74,74,0,0,0
385383,128,128,0,0,0
385385,137,137,0,0,0
385408,114,114,0,0,0
385425,19,19,0,0,0
385431,5,5,0,0,0
385452,1,1,0,0,0
385462,201,201,0,0,0
385466,120,120,0,0,0
385476,252,252,0,0,0
385478,345,345,0,0,0
385479,402,402,0,0,0
385487,402,402,0,0,0
385495,193,193,0,0,0
385501,27,27,0,0,0
385528,101,101,0,0,0
385530,58,58,0,0,0
385539,69,69,0,0,0
385544,103,103,0,0,0
385572,259,259,0,0,0
385581,102,102,0,0,0
385596,3,3,0,0,0
385602,5,5,0,0,0
385604,77,77,0,0,0
385607,54,54,0,0,0
385613,359,359,0,0,0
385621,306,306,0,0,0
385635,4,4,0,0,0
385641,8,8,0,0,0
385662,114,114,0,0,0
385665,50,50,0,0,0
385670,56,56,0,0,0
385674,345,345,0,0,0
385696,345,345,0,0,0
385707,345,345,0,0,0
385708,20,20,0,0,0
385715,137,137,0,0,0
385717,71,71,0,0,0
385721,121,121,0,0,0
385731,167,167,0,0,0
385745,359,359,0,0,0
385757,24,24,0,0,0
385780,58,58,0,0,0
385784,171,171,0,0,0
385791,102,102,0,0,0
385792,137,137,0,0,0
385796,402,402,0,0,0
385799,113,113,0,0,0
385810,158,158,0,0,0
385826,255,255,0,0,0
385839,75,75,0,0,0
385859,180,180,0,0,0
385861,252,252,0,0,0
385863,246,246,0,0,0
385884,201,201,0,0,0
385890,3,3,0,0,0
385898,102,102,0,0,0
385899,232,232,0,0,0
385906,306,306,0,0,0
385908,184,184,0,0,0
385925,402,402,0,0,0
385931,359,359,0,0,0
385949,39,39,0,0,0
385956,87,87,0,0,0
385958,184,184,0,0,0
385977,282,282,0,0,0
385980,313,313,0,0,0
385994,94,94,0,0,0
385995,313,313,0,0,0
386001,74,74,0,0,0
386016,255,255,0,0,0
386019,198,198,0,0,0
386047,310,310,0,0,0
386058,76,76,0,0,0
386061,24,24,0,0,0
386069,252,252,0,0,0
386076,315,315,0,0,0
386100,69,69,0,0,0
386101,299,299,0,0,0
386103,35,35,0,0,0
386104,171,171,0,0,0
386108,85,85,0,0,0
386127,168,168,0,0,0
386155,313,313,0,0,0
386172,171,171,0,0,0
386179,14,14,0,0,0
386184,20,20,0,0,0
386195,102,102,0,0,0
386200,8,8,0,0,0
386201,56,56,0,0,0
386203,3,3,0,0,0
386215,72,72,0,0,0
386224,2,2,0,0,0
386246,57,57,0,0,0
386259,359,359,0,0,0
386267,12,12,0,0,0
386268,34,34,0,0,0
386274,232,232,0,0,0
386282,75,75,0,0,0
386289,8,8,0,0,0
386321,4,4,0,0,0
386331,102,102,0,0,0
386354,306,306,0,0,0
386358,163,163,0,0,0
386379,198,198,0,0,0
386400,184,184,0,0,0
386406,252,252,0,0,0
386408,75,75,0,0,0
386431,55,55,0,0,0
386442,22,22,0,0,0
386455,11,11,0,0,0
386466,102,102,0,0,0
386472,184,184,0,0,0
386495,359,359,0,0,0
386497,29,29,0,0,0
386509,50,50,0,0,0
386511,151,151,0,0,0
386528,41,41,0,0,0
386530,121,121,0,0,0
386551,74,74,0,0,0
386552,167,167,0,0,0
386559,251,251,0,0,0
386567,167,167,0,0,0
386570,69,69,0,0,0
386572,353,353,0,0,0
386586,359,359,0,0,0
386598,259,259,0,0,0
386603,345,345,0,0,0
386613,232,232,0,0,0
386616,313,313,0,0,0
386619,310,310,0,0,0
386648,345,345,0,0,0
386658,353,353,0,0,0
386663,345,345,0,0,0
386671,103,103,0,0,0
386682,101,101,0,0,0
386702,18,18,0,0,0
386726,171,171,0,0,0
386727,12,12,0,0,0
386756,83,83,0,0,0
386760,299,299,0,0,0
386782,113,113,0,0,0
386785,158,158,0,0,0
386792,103,103,0,0,0
386796,102,102,0,0,0
386807,131,131,0,0,0
386812,313,313,0,0,0
386814,10,10,0,0,0
386823,171,171,0,0,0
386834,35,35,0,0,0
386839,359,359,0,0,0
386842,310,310,0,0,0
386860,359,359,0,0,0
386865,54,54,0,0,0
386883,163,163,0,0,0
386900,251,251,0,0,0
386908,76,76,0,0,0
386918,315,315,0,0,0
386924,94,94,0,0,0
386929,281,281,0,0,0
386961,74,74,0,0,0
386967,345,345,0,0,0
386973,114,114,0,0,0
387001,5,5,0,0,0
387004,57,57,0,0,0
387007,158,158,0,0,0
387014,143,143,0,0,0
387023,251,251,0,0,0
387036,345,345,0,0,0
387046,251,251,0,0,0
387050,2,2,0,0,0
387068,255,255,0,0,0
387081,131,131,0,0,0
387091,281,281,0,0,0
387094,121,121,0,0,0
387110,25,25,0,0,0
387112,152,152,0,0,0
387119,255,255,0,0,0
387122,39,39,0,0,0
387126,167,167,0,0,0
387130,74,74,0,0,0
387132,232,232,0,0,0
387144,359,359,0,0,0
387216,232,232,0,0,0
387221,12,12,0,0,0
387227,35,35,0,0,0
387228,35,35,0,0,0
387234,299,299,0,0,0
387236,313,313,0,0,0
387247,201,201,0,0,0
387248,83,83,0,0,0
387253,50,50,0,0,0
387255,251,251,0,0,0
387274,22,22,0,0,0
387304,143,143,0,0,0
387326,167,167,0,0,0
387339,97,97,0,0,0
387357,8,8,0,0,0
387363,151,151,0,0,0
387381,76,76,0,0,0
387385,246,246,0,0,0
387389,167,167,0,0,0
387435,315,315,0,0,0
387439,55,55,0,0,0
387448,75,75,0,0,0
387451,28,28,0,0,0
387459,168,168,0,0,0
387467,76,76,0,0,0
387479,131,131,0,0,0
387481,282,282,0,0,0
387501,345,345,0,0,0
387520,36,36,0,0,0
387537,252,252,0,0,0
387538,56,56,0,0,0
387545,315,315,0,0,0
387546,345,345,0,0,0
387576,306,306,0,0,0
387577,56,56,0,0,0
387578,359,359,0,0,0
387632,345,345,0,0,0
387639,3,3,0,0,0
387646,16,16,0,0,0
387647,15,15,0,0,0
387650,113,113,0,0,0
387655,114,114,0,0,0
387667,299,299,0,0,0
387668,85,85,0,0,0
387715,15,15,0,0,0
387718,67,67,0,0,0
387726,201,201,0,0,0
387728,345,345,0,0,0
387729,313,313,0,0,0
387732,198,198,0,0,0
387740,3,3,0,0,0
387741,180,180,0,0,0
387752,345,345,0,0,0
387760,299,299,0,0,0
387770,85,85,0,0,0
387793,137,137,0,0,0
387822,184,184,0,0,0
387834,144,144,0,0,0
387835,252,252,0,0,0
387842,246,246,0,0,0
387855,72,72,0,0,0
387857,12,12,0,0,0
387878,402,402,0,0,0
387880,6,6,0,0,0
387890,184,184,0,0,0
387902,180,180,0,0,0
387933,345,345,0,0,0
387941,65,65,0,0,0
387949,168,168,0,0,0
387954,353,353,0,0,0
387961,74,74,0,0,0
387979,27,27,0,0,0
388007,201,201,0,0,0
388013,251,251,0,0,0
388021,315,315,0,0,0
388053,74,74,0,0,0
388057,45,45,0,0,0
388083,75,75,0,0,0
388099,193,193,0,0,0
388109,193,193,0,0,0
388128,15,15,0,0,0
388135,180,180,0,0,0
388139,193,193,0,0,0
388153,65,65,0,0,0
388156,198,198,0,0,0
388158,6,6,0,0,0
388180,198,198,0,0,0
388183,359,359,0,0,0
388190,67,67,0,0,0
388202,359,359,0,0,0
388209,402,402,0,0,0
388229,281,281,0,0,0
388234,4,4,0,0,0
388251,11,11,0,0,0
388256,102,102,0,0,0
388262,94,94,0,0,0
388268,6,6,0,0,0
388272,103,103,0,0,0
388273,29,29,0,0,0
388281,299,299,0,0,0
388285,63,63,0,0,0
388293,252,252,0,0,0
388302,71,71,0,0,0
388312,41,41,0,0,0
388323,69,69,0,0,0
388335,12,12,0,0,0
388337,39,39,0,0,0
388338,94,94,0,0,0
388360,56,56,0,0,0
388362,198,198,0,0,0
388367,114,114,0,0,0
388394,163,163,0,0,0
388402,255,255,0,0,0
388404,282,282,0,0,0
388405,6,6,0,0,0
388409,232,232,0,0,0
388413,5,5,0,0,0
388415,63,63,0,0,0
388420,310,310,0,0,0
388424,168,168,0,0,0
388438,282,282,0,0,0
388464,9,9,0,0,0
388531,121,121,0,0,0
388559,259,259,0,0,0
388560,3,3,0,0,0
388565,315,315,0,0,0
388566,131,131,0,0,0
388601,144,144,0,0,0
388602,56,56,0,0,0
388607,259,259,0,0,0
388612,198,198,0,0,0
388632,246,246,0,0,0
388640,152,152,0,0,0
388644,315,315,0,0,0
388649,17,17,0,0,0
388659,144,144,0,0,0
388660,14,14,0,0,0
388671,353,353,0,0,0
388678,12,12,0,0,0
388702,39,39,0,0,0
388705,13,13,0,0,0
388706,246,246,0,0,0
388720,97,97,0,0,0
388748,246,246,0,0,0
388774,21,21,0,0,0
388775,306,306,0,0,0
388783,158,158,0,0,0
388785,345,345,0,0,0
388792,70,70,0,0,0
388830,65,65,0,0,0
388851,198,198,0,0,0
388852,180,180,0,0,0
388860,252,252,0,0,0
388866,130,130,0,0,0
388874,14,14,0,0,0
388879,353,353,0,0,0
388919,299,299,0,0,0
388932,252,252,0,0,0
388935,25,25,0,0,0
388969,299,299,0,0,0
388978,15,15,0,0,0
389000,36,36,0,0,0
389014,3,3,0,0,0
389016,130,130,0,0,0
389036,132,132,0,0,0
389039,113,113,0,0,0
389086,167,167,0,0,0
389087,131,131,0,0,0
389100,184,184,0,0,0
389101,167,167,0,0,0
389129,5,5,0,0,0
389168,102,102,0,0,0
389177,359,359,0,0,0
389182,34,34,0,0,0
389192,306,306,0,0,0
389238,30,30,0,0,0
389247,282,282,0,0,0
389251,246,246,0,0,0
389252,246,246,0,0,0
389259,353,353,0,0,0
389262,94,94,0,0,0
389266,310,310,0,0,0
389287,76,76,0,0,0
389291,402,402,0,0,0
389299,310,310,0,0,0
389330,251,251,0,0,0
389340,74,74,0,0,0
389341,65,65,0,0,0
389351,282,282,0,0,0
389357,20,20,0,0,0
389413,24,24,0,0,0
389421,193,193,0,0,0
389433,259,259,0,0,0
389470,144,144,0,0,0
389472,282,282,0,0,0
389490,158,158,0,0,0
389503,4,4,0,0,0
389519,151,151,0,0,0
389525,353,353,0,0,0
389540,359,359,0,0,0
389554,299,299,0,0,0
389564,198,198,0,0,0
389570,82,82,0,0,0
389577,144,144,0,0,0
389586,281,281,0,0,0
389598,12,12,0,0,0
389600,306,306,0,0,0
389620,102,102,0,0,0
389625,282,282,0,0,0
389631,97,97,0,0,0
389632,8,8,0,0,0
389641,359,359,0,0,0
389657,71,71,0,0,0
389668,251,251,0,0,0
389671,97,97,0,0,0
389673,87,87,0,0,0
389676,313,313,0,0,0
389688,94,94,0,0,0
389711,7,7,0,0,0
389719,25,25,0,0,0
389736,345,345,0,0,0
389761,19,19,0,0,0
389762,299,299,0,0,0
389800,353,353,0,0,0
389814,255,255,0,0,0
389842,83,83,0,0,0
389849,255,255,0,0,0
389855,114,114,0,0,0
389856,120,120,0,0,0
389857,94,94,0,0,0
389862,17,17,0,0,0
389881,282,282,0,0,0
389889,74,74,0,0,0
389900,281,281,0,0,0
389916,143,143,0,0,0
389936,345,345,0,0,0
389939,232,232,0,0,0
389951,310,310,0,0,0
389977,67,67,0,0,0
389998,70,70,0,0,0
390040,128,128,0,0,0
390045,251,251,0,0,0
390063,36,36,0,0,0
390076,103,103,0,0,0
390085,29,29,0,0,0
390101,15,15,0,0,0
390107,345,345,0,0,0
390118,359,359,0,0,0
390125,315,315,0,0,0
390128,246,246,0,0,0
390171,103,103,0,0,0
390188,76,76,0,0,0
390202,74,74,0,0,0
390217,43,43,0,0,0
390240,168,168,0,0,0
390245,184,184,0,0,0
390261,353,353,0,0,0
390265,171,171,0,0,0
390270,34,34,0,0,0
390274,193,193,0,0,0
390324,144,144,0,0,0
390332,313,313,0,0,0
390341,18,18,0,0,0
390362,306,306,0,0,0
390363,34,34,0,0,0
390367,34,34,0,0,0
390371,152,152,0,0,0
390393,313,313,0,0,0
390398,130,130,0,0,0
390414,113,113,0,0,0
390447,255,255,0,0,0
390450,345,345,0,0,0
390458,201,201,0,0,0
390485,66,66,0,0,0
390488,353,353,0,0,0
390505,102,102,0,0,0
390518,171,171,0,0,0
390528,353,353,0,0,0
390565,121,121,0,0,0
390568,35,35,0,0,0
390572,87,87,0,0,0
390577,255,255,0,0,0
390581,75,75,0,0,0
390583,193,193,0,0,0
390595,402,402,0,0,0
390600,306,306,0,0,0
390614,69,69,0,0,0
390628,359,359,0,0,0
390642,255,255,0,0,0
390659,4,4,0,0,0
390683,171,171,0,0,0
390702,2,2,0,0,0
390719,114,114,0,0,0
390723,201,201,0,0,0
390729,246,246,0,0,0
390733,281,281,0,0,0
390743,198,198,0,0,0
390766,130,130,0,0,0
390771,16,16,0,0,0
390775,402,402,0,0,0
390800,82,82,0,0,0
390805,345,345,0,0,0
390814,359,359,0,0,0
390820,34,34,0,0,0
390839,120,120,0,0,0
390842,246,246,0,0,0
390865,251,251,0,0,0
390869,402,402,0,0,0
390872,85,85,0,0,0
390886,299,299,0,0,0
390889,198,198,0,0,0
390896,167,167,0,0,0
390903,55,55,0,0,0
390917,151,151,0,0,0
390937,259,259,0,0,0
390946,193,193,0,0,0
390950,85,85,0,0,0
390952,359,359,0,0,0
390972,184,184,0,0,0
390974,19,19,0,0,0
390979,128,128,0,0,0
390988,39,39,0,0,0
390993,63,63,0,0,0
390996,158,158,0,0,0
391001,310,310,0,0,0
391003,67,67,0,0,0
391008,69,69,0,0,0
391009,10,10,0,0,0
391014,246,246,0,0,0
391018,114,114,0,0,0
391024,168,168,0,0,0
391036,36,36,0,0,0
391043,168,168,0,0,0
391053,103,103,0,0,0
391071,201,201,0,0,0
391104,15,15,0,0,0
391109,5,5,0,0,0
391126,16,16,0,0,0
391130,168,168,0,0,0
391138,121,121,0,0,0
391156,83,83,0,0,0
391184,359,359,0,0,0
391202,310,310,0,0,0
391212,306,306,0,0,0
391213,19,19,0,0,0
391218,402,402,0,0,0
391238,171,171,0,0,0
391250,23,23,0,0,0
391254,259,259,0,0,0
391274,281,281,0,0,0
391277,282,282,0,0,0
391281,18,18,0,0,0
391294,83,83,0,0,0
391310,101,101,0,0,0
391316,12,12,0,0,0
391317,102,102,0,0,0
391322,144,144,0,0,0
391334,345,345,0,0,0
391350,114,114,0,0,0
391360,152,152,0,0,0
391370,255,255,0,0,0
391376,121,121,0,0,0
391383,102,102,0,0,0
391385,310,310,0,0,0
391388,16,16,0,0,0
391405,163,163,0,0,0
391423,101,101,0,0,0
391441,83,83,0,0,0
391454,87,87,0,0,0
391465,87,87,0,0,0
391485,246,246,0,0,0
391504,97,97,0,0,0
391506,345,345,0,0,0
391512,114,114,0,0,0
391525,144,144,0,0,0
391534,25,25,0,0,0
391562,17,17,0,0,0
391565,7,7,0,0,0
391587,121,121,0,0,0
391594,168,168,0,0,0
391610,193,193,0,0,0
391625,71,71,0,0,0
391639,102,102,0,0,0
391653,299,299,0,0,0
391672,353,353,0,0,0
391693,306,306,0,0,0
391713,77,77,0,0,0
391724,402,402,0,0,0
391727,252,252,0,0,0
391734,180,180,0,0,0
391738,246,246,0,0,0
391739,70,70,0,0,0
391748,299,299,0,0,0
391755,131,131,0,0,0
391756,121,121,0,0,0
391762,44,44,0,0,0
391763,18,18,0,0,0
391764,54,54,0,0,0
391778,55,55,0,0,0
391779,167,167,0,0,0
391787,102,102,0,0,0
391793,114,114,0,0,0
391810,36,36,0,0,0
391816,85,85,0,0,0
391820,66,66,0,0,0
391825,6,6,0,0,0
391826,151,151,0,0,0
391840,313,313,0,0,0
391846,171,171,0,0,0
391854,402,402,0,0,0
391861,353,353,0,0,0
391868,16,16,0,0,0
391875,121,121,0,0,0
391882,306,306,0,0,0
391883,14,14,0,0,0
391909,85,85,0,0,0
391913,180,180,0,0,0
391918,193,193,0,0,0
391944,168,168,0,0,0
391955,8,8,0,0,0
391960,345,345,0,0,0
391967,10,10,0,0,0
391978,66,66,0,0,0
391990,11,11,0,0,0
392016,201,201,0,0,0
392019,77,77,0,0,0
392044,252,252,0,0,0
392051,282,282,0,0,0
392061,180,180,0,0,0
392068,255,255,0,0,0
392075,35,35,0,0,0
392087,54,54,0,0,0
392095,310,310,0,0,0
392114,22,22,0,0,0
392115,13,13,0,0,0
392118,2,2,0,0,0
392124,76,76,0,0,0
392149,151,151,0,0,0
392154,246,246,0,0,0
392199,315,315,0,0,0
392214,184,184,0,0,0
392215,101,101,0,0,0
392218,97,97,0,0,0
392219,232,232,0,0,0
392230,402,402,0,0,0
392236,158,158,0,0,0
392260,74,74,0,0,0
392264,55,55,0,0,0
392266,252,252,0,0,0
392282,144,144,0,0,0
392301,132,132,0,0,0
392314,310,310,0,0,0
392315,2,2,0,0,0
392316,282,282,0,0,0
392319,13,13,0,0,0
392330,168,168,0,0,0
392355,193,193,0,0,0
392368,3,3,0,0,0
392374,114,114,0,0,0
392399,18,18,0,0,0
392401,359,359,0,0,0
392417,193,193,0,0,0
392440,131,131,0,0,0
392443,353,353,0,0,0
392453,94,94,0,0,0
392454,114,114,0,0,0
392461,9,9,0,0,0
392462,359,359,0,0,0
392482,120,120,0,0,0
392502,5,5,0,0,0
392528,101,101,0,0,0
392538,299,299,0,0,0
392544,315,315,0,0,0
392549,1,1,0,0,0
392554,94,94,0,0,0
392556,12,12,0,0,0
392569,310,310,0,0,0
392576,184,184,0,0,0
392578,184,184,0,0,0
392616,171,171,0,0,0
392623,282,282,0,0,0
392627,102,102,0,0,0
392629,252,252,0,0,0
392647,193,193,0,0,0
392654,97,97,0,0,0
392655,137,137,0,0,0
392659,359,359,0,0,0
392660,345,345,0,0,0
392675,201,201,0,0,0
392687,402,402,0,0,0
392702,198,198,0,0,0
392708,70,70,0,0,0
392716,315,315,0,0,0
392739,74,74,0,0,0
392745,152,152,0,0,0
392747,402,402,0,0,0
392748,102,102,0,0,0
392753,299,299,0,0,0
392756,54,54,0,0,0
392759,76,76,0,0,0
392768,137,137,0,0,0
392770,54,54,0,0,0
392771,151,151,0,0,0
392782,299,299,0,0,0
392786,34,34,0,0,0
392790,101,101,0,0,0
392808,310,310,0,0,0
392817,158,158,0,0,0
392832,130,130,0,0,0
392838,58,58,0,0,0
392843,43,43,0,0,0
392860,18,18,0,0,0
392863,255,255,0,0,0
392881,102,102,0,0,0
392886,121,121,0,0,0
392891,353,353,0,0,0
392900,152,152,0,0,0
392904,102,102,0,0,0
392911,34,34,0,0,0
392914,281,281,0,0,0
392922,4,4,0,0,0
392941,7,7,0,0,0
392956,94,94,0,0,0
392969,4,4,0,0,0
392992,251,251,0,0,0
393006,102,102,0,0,0
393011,35,35,0,0,0
393023,402,402,0,0,0
393057,77,77,0,0,0
393074,313,313,0,0,0
393083,76,76,0,0,0
393104,313,313,0,0,0
393106,171,171,0,0,0
393124,299,299,0,0,0
393135,5,5,0,0,0
393138,252,252,0,0,0
393178,198,198,0,0,0
393183,103,103,0,0,0
393204,74,74,0,0,0
393207,85,85,0,0,0
393210,101,101,0,0,0
393211,70,70,0,0,0
393225,19,19,0,0,0
393243,359,359,0,0,0
393248,18,18,0,0,0
393261,54,54,0,0,0
393286,359,359,0,0,0
393304,137,137,0,0,0
393315,77,77,0,0,0
393329,232,232,0,0,0
393368,102,102,0,0,0
393370,70,70,0,0,0
393382,252,252,0,0,0
393385,251,251,0,0,0
393394,17,17,0,0,0
393400,310,310,0,0,0
393429,158,158,0,0,0
393452,131,131,0,0,0
393472,94,94,0,0,0
393483,120,120,0,0,0
393487,6,6,0,0,0
393490,143,143,0,0,0
393494,8,8,0,0,0
393506,121,121,0,0,0
393523,10,10,0,0,0
393533,246,246,0,0,0
393547,251,251,0,0,0
393549,152,152,0,0,0
393555,3,3,0,0,0
393564,12,12,0,0,0
393578,103,103,0,0,0
393581,12,12,0,0,0
393587,97,97,0,0,0
393617,310,310,0,0,0
393629,87,87,0,0,0
393634,184,184,0,0,0
393649,345,345,0,0,0
393654,193,193,0,0,0
393673,120,120,0,0,0
393707,281,281,0,0,0
393717,121,121,0,0,0
393732,121,121,0,0,0
393739,171,171,0,0,0
393740,193,193,0,0,0
393750,120,120,0,0,0
393752,193,193,0,0,0
393766,163,163,0,0,0
393772,359,359,0,0,0
393787,163,163,0,0,0
393819,232,232,0,0,0
393835,315,315,0,0,0
393843,21,21,0,0,0
393850,299,299,0,0,0
393854,103,103,0,0,0
393857,281,281,0,0,0
393861,315,315,0,0,0
393871,23,23,0,0,0
393916,102,102,0,0,0
393924,152,152,0,0,0
393928,18,18,0,0,0
393931,299,299,0,0,0
393934,10,10,0,0,0
393950,21,21,0,0,0
393959,137,137,0,0,0
393974,132,132,0,0,0
393978,27,27,0,0,0
393994,101,101,0,0,0
394007,70,70,0,0,0
394021,27,27,0,0,0
394054,345,345,0,0,0
394057,120,120,0,0,0
394064,168,168,0,0,0
394066,315,315,0,0,0
394082,76,76,0,0,0
394103,184,184,0,0,0
394117,315,315,0,0,0
394123,198,198,0,0,0
394134,71,71,0,0,0
394138,65,65,0,0,0
394146,255,255,0,0,0
394166,75,75,0,0,0
394170,102,102,0,0,0
394175,193,193,0,0,0
394177,168,168,0,0,0
394185,313,313,0,0,0
394218,345,345,0,0,0
394220,25,25,0,0,0
394237,193,193,0,0,0
394252,87,87,0,0,0
394265,306,306,0,0,0
394290,402,402,0,0,0
394295,310,310,0,0,0
394299,97,97,0,0,0
394315,102,102,0,0,0
394324,259,259,0,0,0
394333,102,102,0,0,0
394334,18,18,0,0,0
394352,103,103,0,0,0
394354,282,282,0,0,0
394379,255,255,0,0,0
394388,282,282,0,0,0
394395,27,27,0,0,0
394399,113,113,0,0,0
394433,163,163,0,0,0
394450,143,143,0,0,0
394502,282,282,0,0,0
394505,65,65,0,0,0
394509,193,193,0,0,0
394512,20,20,0,0,0
394526,20,20,0,0,0
394535,24,24,0,0,0
394538,102,102,0,0,0
394544,315,315,0,0,0
394547,11,11,0,0,0
394572,310,310,0,0,0
394581,193,193,0,0,0
394596,282,282,0,0,0
394598,158,158,0,0,0
394606,56,56,0,0,0
394614,152,152,0,0,0
394629,252,252,0,0,0
394630,306,306,0,0,0
394631,12,12,0,0,0
394636,193,193,0,0,0
394644,35,35,0,0,0
394652,315,315,0,0,0
394658,70,70,0,0,0
394679,5,5,0,0,0
394686,310,310,0,0,0
394687,353,353,0,0,0
394698,36,36,0,0,0
394701,137,137,0,0,0
394704,151,151,0,0,0
394715,24,24,0,0,0
394727,10,10,0,0,0
394733,1,1,0,0,0
394757,163,163,0,0,0
394760,40,40,0,0,0
394772,27,27,0,0,0
394780,76,76,0,0,0
394824,3,3,0,0,0
394835,94,94,0,0,0
394846,255,255,0,0,0
394869,17,17,0,0,0
394875,120,120,0,0,0
394877,66,66,0,0,0
394888,121,121,0,0,0
394897,402,402,0,0,0
394898,72,72,0,0,0
394922,137,137,0,0,0
394924,193,193,0,0,0
394939,6,6,0,0,0
394945,19,19,0,0,0
394973,83,83,0,0,0
394983,306,306,0,0,0
394991,184,184,0,0,0
394992,251,251,0,0,0
395012,39,39,0,0,0
395037,137,137,0,0,0
395056,128,128,0,0,0
395063,259,259,0,0,0
395075,94,94,0,0,0
395080,402,402,0,0,0
395093,120,120,0,0,0
395100,132,132,0,0,0
395126,232,232,0,0,0
395134,259,259,0,0,0
395142,152,152,0,0,0
395143,56,56,0,0,0
395147,171,171,0,0,0
395153,315,315,0,0,0
395159,246,246,0,0,0
395161,2,2,0,0,0
395162,75,75,0,0,0
395169,74,74,0,0,0
395181,359,359,0,0,0
395192,5,5,0,0,0
395230,281,281,0,0,0
395232,63,63,0,0,0
395262,310,310,0,0,0
395275,345,345,0,0,0
395278,12,12,0,0,0
395291,13,13,0,0,0
395304,151,151,0,0,0
395311,35,35,0,0,0
395315,120,120,0,0,0
395331,143,143,0,0,0
395332,299,299,0,0,0
395343,65,65,0,0,0
395344,168,168,0,0,0
395349,87,87,0,0,0
395368,34,34,0,0,0
395384,101,101,0,0,0
395428,133,133,0,0,0
395432,76,76,0,0,0
395438,9,9,0,0,0
395446,345,345,0,0,0
395448,359,359,0,0,0
395452,102,102,0,0,0
395453,50,50,0,0,0
395467,168,168,0,0,0
395471,63,63,0,0,0
395515,94,94,0,0,0
395517,345,345,0,0,0
395535,131,131,0,0,0
395536,114,114,0,0,0
395542,56,56,0,0,0
395546,8,8,0,0,0
395566,28,28,0,0,0
395579,402,402,0,0,0
395603,353,353,0,0,0
395604,180,180,0,0,0
395616,198,198,0,0,0
395620,14,14,0,0,0
395624,143,143,0,0,0
395628,66,66,0,0,0
395629,132,132,0,0,0
395635,14,14,0,0,0
395663,313,313,0,0,0
395677,70,70,0,0,0
395683,402,402,0,0,0
395690,310,310,0,0,0
395705,246,246,0,0,0
395714,313,313,0,0,0
395737,15,15,0,0,0
395763,306,306,0,0,0
395764,87,87,0,0,0
395780,252,252,0,0,0
395793,65,65,0,0,0
395807,76,76,0,0,0
395816,20,20,0,0,0
395821,402,402,0,0,0
395823,12,12,0,0,0
395848,158,158,0,0,0
395857,70,70,0,0,0
395859,76,76,0,0,0
395860,41,41,0,0,0
395864,1,1,0,0,0
395871,7,7,0,0,0
395934,19,19,0,0,0
395945,232,232,0,0,0
395959,163,163,0,0,0
395969,306,306,0,0,0
395997,359,359,0,0,0
396014,315,315,0,0,0
396015,359,359,0,0,0
396020,8,8,0,0,0
396027,4,4,0,0,0
396035,17,17,0,0,0
396046,252,252,0,0,0
396050,4,4,0,0,0
396060,345,345,0,0,0
396065,5,5,0,0,0
396079,281,281,0,0,0
396108,168,168,0,0,0
396112,114,114,0,0,0
396113,121,121,0,0,0
396115,310,310,0,0,0
396116,15,15,0,0,0
396125,120,120,0,0,0
396137,310,310,0,0,0
396153,259,259,0,0,0
396168,69,69,0,0,0
396179,167,167,0,0,0
396183,94,94,0,0,0
396184,246,246,0,0,0
396192,67,67,0,0,0
396197,246,246,0,0,0
396215,114,114,0,0,0
396223,232,232,0,0,0
396236,281,281,0,0,0
396241,201,201,0,0,0
396251,131,131,0,0,0
396253,120,120,0,0,0
396260,15,15,0,0,0
396265,137,137,0,0,0
396278,198,198,0,0,0
396286,232,232,0,0,0
396287,97,97,0,0,0
396288,2,2,0,0,0
396291,66,66,0,0,0
396312,29,29,0,0,0
396327,54,54,0,0,0
396332,114,114,0,0,0
396353,83,83,0,0,0
396363,74,74,0,0,0
396367,29,29,0,0,0
396372,72,72,0,0,0
396383,56,56,0,0,0
396406,168,168,0,0,0
396417,252,252,0,0,0
396420,180,180,0,0,0
396430,232,232,0,0,0
396434,163,163,0,0,0
396438,71,71,0,0,0
396449,232,232,0,0,0
396461,3,3,0,0,0
396473,20,20,0,0,0
396480,252,252,0,0,0
396484,252,252,0,0,0
396485,5,5,0,0,0
396503,25,25,0,0,0
396512,306,306,0,0,0
396517,133,133,0,0,0
396523,55,55,0,0,0
396543,232,232,0,0,0
396548,137,137,0,0,0
396552,85,85,0,0,0
396581,16,16,0,0,0
396595,281,281,0,0,0
396608,163,163,0,0,0
396609,255,255,0,0,0
396624,306,306,0,0,0
396635,27,27,0,0,0
396643,345,345,0,0,0
396652,281,281,0,0,0
396654,353,353,0,0,0
396655,36,36,0,0,0
396658,74,74,0,0,0
396663,281,281,0,0,0
396665,144,144,0,0,0
396667,6,6,0,0,0
396676,71,71,0,0,0
396682,76,76,0,0,0
396684,56,56,0,0,0
396690,3,3,0,0,0
396702,43,43,0,0,0
396713,152,152,0,0,0
396731,184,184,0,0,0
396760,94,94,0,0,0
396763,345,345,0,0,0
396773,184,184,0,0,0
396794,143,143,0,0,0
396800,27,27,0,0,0
396836,158,158,0,0,0
396844,152,152,0,0,0
396859,10,10,0,0,0
396866,77,77,0,0,0
396871,402,402,0,0,0
396965,128,128,0,0,0
396967,50,50,0,0,0
396989,143,143,0,0,0
397000,50,50,0,0,0
397013,152,152,0,0,0
397016,85,85,0,0,0
397020,34,34,0,0,0
397039,143,143,0,0,0
397048,27,27,0,0,0
397052,259,259,0,0,0
397066,24,24,0,0,0
397077,193,193,0,0,0
397098,144,144,0,0,0
397115,345,345,0,0,0
397130,353,353,0,0,0
397150,77,77,0,0,0
397154,315,315,0,0,0
397155,12,12,0,0,0
397159,345,345,0,0,0
397160,255,255,0,0,0
397162,5,5,0,0,0
397176,34,34,0,0,0
397189,315,315,0,0,0
397194,35,35,0,0,0
397203,5,5,0,0,0
397220,246,246,0,0,0
397224,252,252,0,0,0
397237,402,402,0,0,0
397243,184,184,0,0,0
397251,353,353,0,0,0
397265,201,201,0,0,0
397283,24,24,0,0,0
397289,193,193,0,0,0
397303,101,101,0,0,0
397308,180,180,0,0,0
397392,313,313,0,0,0
397400,255,255,0,0,0
397402,18,18,0,0,0
397414,259,259,0,0,0
397420,345,345,0,0,0
397432,345,345,0,0,0
397456,281,281,0,0,0
397458,152,152,0,0,0
397464,158,158,0,0,0
397470,163,163,0,0,0
397474,55,55,0,0,0
397498,168,168,0,0,0
397500,345,345,0,0,0
397507,94,94,0,0,0
397509,299,299,0,0,0
397510,40,40,0,0,0
397513,121,121,0,0,0
397521,353,353,0,0,0
397527,20,20,0,0,0
397536,85,85,0,0,0
397540,193,193,0,0,0
397551,70,70,0,0,0
397556,315,315,0,0,0
397560,113,113,0,0,0
397587,152,152,0,0,0
397593,299,299,0,0,0
397597,198,198,0,0,0
397614,299,299,0,0,0
397642,76,76,0,0,0
397665,137,137,0,0,0
397671,402,402,0,0,0
397695,113,113,0,0,0
397696,3,3,0,0,0
397717,113,113,0,0,0
397721,114,114,0,0,0
397766,83,83,0,0,0
397768,103,103,0,0,0
397771,74,74,0,0,0
397819,22,22,0,0,0
397826,44,44,0,0,0
397841,251,251,0,0,0
397847,402,402,0,0,0
397866,299,299,0,0,0
397869,353,353,0,0,0
397876,39,39,0,0,0
397879,36,36,0,0,0
397901,201,201,0,0,0
397903,168,168,0,0,0
397921,315,315,0,0,0
397923,144,144,0,0,0
397925,282,282,0,0,0
397931,232,232,0,0,0
397941,306,306,0,0,0
397957,152,152,0,0,0
397962,151,151,0,0,0
397966,121,121,0,0,0
397969,359,359,0,0,0
397999,114,114,0,0,0
398035,74,74,0,0,0
398053,17,17,0,0,0
398058,36,36,0,0,0
398068,97,97,0,0,0
398077,251,251,0,0,0
398082,353,353,0,0,0
398086,137,137,0,0,0
398114,282,282,0,0,0
398117,25,25,0,0,0
398121,251,251,0,0,0
398131,128,128,0,0,0
398144,259,259,0,0,0
398151,70,70,0,0,0
398157,8,8,0,0,0
398168,198,198,0,0,0
398169,359,359,0,0,0
398177,75,75,0,0,0
398191,128,128,0,0,0
398194,359,359,0,0,0
398202,83,83,0,0,0
398212,299,299,0,0,0
398218,310,310,0,0,0
398225,299,299,0,0,0
398261,306,306,0,0,0
398264,44,44,0,0,0
398276,14,14,0,0,0
398280,43,43,0,0,0
398287,163,163,0,0,0
398292,128,128,0,0,0
398329,74,74,0,0,0
398334,402,402,0,0,0
398337,252,252,0,0,0
398348,22,22,0,0,0
398373,246,246,0,0,0
398386,359,359,0,0,0
398398,143,143,0,0,0
398405,69,69,0,0,0
398418,315,315,0,0,0
398424,94,94,0,0,0
398430,102,102,0,0,0
398434,345,345,0,0,0
398460,66,66,0,0,0
398491,246,246,0,0,0
398492,144,144,0,0,0
398516,76,76,0,0,0
398535,299,299,0,0,0
398550,251,251,0,0,0
398564,102,102,0,0,0
398565,359,359,0,0,0
398568,402,402,0,0,0
398578,45,45,0,0,0
398625,232,232,0,0,0
398628,4,4,0,0,0
398635,72,72,0,0,0
398647,345,345,0,0,0
398665,198,198,0,0,0
398666,251,251,0,0,0
398671,252,252,0,0,0
398673,30,30,0,0,0
398681,132,132,0,0,0
398701,18,18,0,0,0
398710,402,402,0,0,0
398714,144,144,0,0,0
398732,313,313,0,0,0
398738,101,101,0,0,0
398771,259,259,0,0,0
398782,184,184,0,0,0
398791,18,18,0,0,0
398796,315,315,0,0,0
398803,94,94,0,0,0
398818,69,69,0,0,0
398837,10,10,0,0,0
398848,71,71,0,0,0
398851,137,137,0,0,0
398854,345,345,0,0,0
398866,85,85,0,0,0
398871,39,39,0,0,0
398877,18,18,0,0,0
398881,359,359,0,0,0
398886,151,151,0,0,0
398887,16,16,0,0,0
398909,306,306,0,0,0
398915,198,198,0,0,0
398922,281,281,0,0,0
398969,137,137,0,0,0
398971,255,255,0,0,0
398977,13,13,0,0,0
398987,43,43,0,0,0
398999,246,246,0,0,0
399011,13,13,0,0,0
399013,167,167,0,0,0
399029,152,152,0,0,0
399043,359,359,0,0,0
399066,144,144,0,0,0
399069,402,402,0,0,0
399078,180,180,0,0,0
399080,11,11,0,0,0
399081,128,128,0,0,0
399098,72,72,0,0,0
399101,102,102,0,0,0
399109,34,34,0,0,0
399110,402,402,0,0,0
399144,12,12,0,0,0
399158,63,63,0,0,0
399164,201,201,0,0,0
399188,259,259,0,0,0
399203,359,359,0,0,0
399211,113,113,0,0,0
399231,144,144,0,0,0
399238,246,246,0,0,0
399243,151,151,0,0,0
399247,19,19,0,0,0
399256,4,4,0,0,0
399262,39,39,0,0,0
399269,353,353,0,0,0
399276,131,131,0,0,0
399281,13,13,0,0,0
399286,25,25,0,0,0
399293,310,310,0,0,0
399294,103,103,0,0,0
399302,158,158,0,0,0
399304,7,7,0,0,0
399305,128,128,0,0,0
399316,144,144,0,0,0
399317,85,85,0,0,0
399358,87,87,0,0,0
399365,281,281,0,0,0
399367,66,66,0,0,0
399375,306,306,0,0,0
399381,137,137,0,0,0
399384,71,71,0,0,0
399401,101,101,0,0,0
399405,313,313,0,0,0
399424,144,144,0,0,0
399425,359,359,0,0,0
399428,56,56,0,0,0
399438,24,24,0,0,0
399449,184,184,0,0,0
399453,114,114,0,0,0
399467,255,255,0,0,0
399481,144,144,0,0,0
399491,50,50,0,0,0
399501,72,72,0,0,0
399523,232,232,0,0,0
399544,144,144,0,0,0
399547,252,252,0,0,0
399557,255,255,0,0,0
399585,402,402,0,0,0
399590,306,306,0,0,0
399631,402,402,0,0,0
399639,17,17,0,0,0
399650,201,201,0,0,0
399661,315,315,0,0,0
399667,184,184,0,0,0
399668,121,121,0,0,0
399672,252,252,0,0,0
399676,74,74,0,0,0
399678,44,44,0,0,0
399683,281,281,0,0,0
399719,180,180,0,0,0
399726,306,306,0,0,0
399727,101,101,0,0,0
399729,2,2,0,0,0
399748,3,3,0,0,0
399751,130,130,0,0,0
399752,6,6,0,0,0
399789,8,8,0,0,0
399799,39,39,0,0,0
399849,180,180,0,0,0
399850,168,168,0,0,0
399870,102,102,0,0,0
399871,251,251,0,0,0
399872,232,232,0,0,0
399898,152,152,0,0,0
399904,10,10,0,0,0
399927,299,299,0,0,0
399945,151,151,0,0,0
399953,12,12,0,0,0
399956,32,32,0,0,0
399969,24,24,0,0,0
399976,299,299,0,0,0
399977,255,255,0,0,0
399981,25,25,0,0,0
399984,259,259,0,0,0
399988,131,131,0,0,0
399991,22,22,0,0,0
400017,66,66,0,0,0
400063,144,144,0,0,0
400068,402,402,0,0,0
400081,201,201,0,0,0
400112,131,131,0,0,0
400135,113,113,0,0,0
400153,128,128,0,0,0
400161,17,17,0,0,0
400168,310,310,0,0,0
400189,133,133,0,0,0
400192,35,35,0,0,0
400197,15,15,0,0,0
400215,128,128,0,0,0
400224,103,103,0,0,0
400227,306,306,0,0,0
400235,345,345,0,0,0
400238,402,402,0,0,0
400245,402,402,0,0,0
400246,121,121,0,0,0
400255,7,7,0,0,0
400296,32,32,0,0,0
400304,359,359,0,0,0
400314,299,299,0,0,0
400325,255,255,0,0,0
400327,180,180,0,0,0
400331,121,121,0,0,0
400345,310,310,0,0,0
400349,310,310,0,0,0
400375,137,137,0,0,0
400391,171,171,0,0,0
400395,359,359,0,0,0
400400,137,137,0,0,0
400403,151,151,0,0,0
400416,353,353,0,0,0
400424,6,6,0,0,0
400426,299,299,0,0,0
400440,69,69,0,0,0
400447,299,299,0,0,0
400477,43,43,0,0,0
400485,8,8,0,0,0
400498,163,163,0,0,0
400499,353,353,0,0,0
400510,281,281,0,0,0
400531,167,167,0,0,0
400539,23,23,0,0,0
400544,66,66,0,0,0
400558,315,315,0,0,0
400559,5,5,0,0,0
400572,29,29,0,0,0
400577,120,120,0,0,0
400580,32,32,0,0,0
400586,402,402,0,0,0
400599,30,30,0,0,0
400602,313,313,0,0,0
400603,102,102,0,0,0
400606,143,143,0,0,0
400639,114,114,0,0,0
400647,36,36,0,0,0
400671,54,54,0,0,0
400685,29,29,0,0,0
400690,184,184,0,0,0
400691,12,12,0,0,0
400701,70,70,0,0,0
400711,152,152,0,0,0
400717,44,44,0,0,0
400725,13,13,0,0,0
400738,345,345,0,0,0
400744,23,23,0,0,0
400747,114,114,0,0,0
400754,3,3,0,0,0
400758,281,281,0,0,0
400795,69,69,0,0,0
400796,259,259,0,0,0
400797,259,259,0,0,0
400807,74,74,0,0,0
400814,251,251,0,0,0
400823,306,306,0,0,0
400830,63,63,0,0,0
400834,359,359,0,0,0
400844,9,9,0,0,0
400874,19,19,0,0,0
400875,252,252,0,0,0
400883,29,29,0,0,0
400893,281,281,0,0,0
400904,171,171,0,0,0
400916,74,74,0,0,0
400922,137,137,0,0,0
400929,402,402,0,0,0
400945,29,29,0,0,0
400965,310,310,0,0,0
400968,27,27,0,0,0
400969,27,27,0,0,0
400986,158,158,0,0,0
401004,345,345,0,0,0
401006,76,76,0,0,0
401019,120,120,0,0,0
401021,22,22,0,0,0
401056,58,58,0,0,0
401065,137,137,0,0,0
401071,83,83,0,0,0
401078,131,131,0,0,0
401094,151,151,0,0,0
401098,12,12,0,0,0
401099,103,103,0,0,0
401103,345,345,0,0,0
401153,144,144,0,0,0
401160,120,120,0,0,0
401175,114,114,0,0,0
401179,74,74,0,0,0
401187,306,306,0,0,0
401193,16,16,0,0,0
401214,30,30,0,0,0
401219,184,184,0,0,0
401224,75,75,0,0,0
401231,281,281,0,0,0
401268,359,359,0,0,0
401269,151,151,0,0,0
401298,255,255,0,0,0
401342,72,72,0,0,0
401346,102,102,0,0,0
401368,74,74,0,0,0
401374,121,121,0,0,0
401377,345,345,0,0,0
401389,353,353,0,0,0
401418,168,168,0,0,0
401426,102,102,0,0,0
401462,158,158,0,0,0
401468,281,281,0,0,0
401505,184,184,0,0,0
401511,345,345,0,0,0
401524,251,251,0,0,0
401541,85,85,0,0,0
401583,114,114,0,0,0
401584,143,143,0,0,0
401593,259,259,0,0,0
401595,54,54,0,0,0
401596,120,120,0,0,0
401628,246,246,0,0,0
401643,114,114,0,0,0
401645,251,251,0,0,0
401656,299,299,0,0,0
401669,76,76,0,0,0
401670,315,315,0,0,0
401671,6,6,0,0,0
401675,282,282,0,0,0
401687,6,6,0,0,0
401688,167,167,0,0,0
401691,144,144,0,0,0
401693,50,50,0,0,0
401727,144,144,0,0,0
401737,353,353,0,0,0
401740,152,152,0,0,0
401742,65,65,0,0,0
401759,130,130,0,0,0
401760,299,299,0,0,0
401768,251,251,0,0,0
401772,36,36,0,0,0
401775,82,82,0,0,0
401777,44,44,0,0,0
401785,180,180,0,0,0
401794,1,1,0,0,0
401803,281,281,0,0,0
401821,353,353,0,0,0
401829,252,252,0,0,0
401832,163,163,0,0,0
401844,82,82,0,0,0
401859,168,168,0,0,0
401877,29,29,0,0,0
401883,353,353,0,0,0
401893,359,359,0,0,0
401928,232,232,0,0,0
401940,83,83,0,0,0
401941,282,282,0,0,0
401943,11,11,0,0,0
401944,121,121,0,0,0
401969,259,259,0,0,0
401980,113,113,0,0,0
401982,128,128,0,0,0
402004,198,198,0,0,0
402010,19,19,0,0,0
402038,113,113,0,0,0
402045,345,345,0,0,0
402061,255,255,0,0,0
402068,281,281,0,0,0
402070,50,50,0,0,0
402077,32,32,0,0,0
402097,184,184,0,0,0
402098,299,299,0,0,0
402105,128,128,0,0,0
402108,114,114,0,0,0
402111,353,353,0,0,0
402116,345,345,0,0,0
402130,281,281,0,0,0
402135,11,11,0,0,0
402139,345,345,0,0,0
402140,299,299,0,0,0
402173,345,345,0,0,0
402199,121,121,0,0,0
402200,353,353,0,0,0
402206,255,255,0,0,0
402216,232,232,0,0,0
402222,5,5,0,0,0
402240,29,29,0,0,0
402249,353,353,0,0,0
402257,246,246,0,0,0
402281,102,102,0,0,0
402293,3,3,0,0,0
402309,315,315,0,0,0
402334,128,128,0,0,0
402339,35,35,0,0,0
402360,246,246,0,0,0
402368,128,128,0,0,0
402373,310,310,0,0,0
402375,299,299,0,0,0
402395,198,198,0,0,0
402403,56,56,0,0,0
402415,114,114,0,0,0
402449,102,102,0,0,0
402492,353,353,0,0,0
402493,97,97,0,0,0
402525,34,34,0,0,0
402527,201,201,0,0,0
402528,315,315,0,0,0
402541,184,184,0,0,0
402553,18,18,0,0,0
402562,315,315,0,0,0
402570,193,193,0,0,0
402575,34,34,0,0,0
402580,114,114,0,0,0
402599,25,25,0,0,0
402606,130,130,0,0,0
402607,27,27,0,0,0
402608,306,306,0,0,0
402609,353,353,0,0,0
402614,34,34,0,0,0
402628,128,128,0,0,0
402629,11,11,0,0,0
402658,5,5,0,0,0
402662,14,14,0,0,0
402675,232,232,0,0,0
402678,201,201,0,0,0
402682,232,232,0,0,0
402688,71,71,0,0,0
402702,128,128,0,0,0
402704,184,184,0,0,0
402719,76,76,0,0,0
402722,55,55,0,0,0
402726,345,345,0,0,0
402731,29,29,0,0,0
402733,83,83,0,0,0
402734,133,133,0,0,0
402740,152,152,0,0,0
402747,66,66,0,0,0
402748,72,72,0,0,0
402756,121,121,0,0,0
402763,121,121,0,0,0
402779,121,121,0,0,0
402782,359,359,0,0,0
402791,198,198,0,0,0
402804,18,18,0,0,0
402809,131,131,0,0,0
402812,12,12,0,0,0
402813,310,310,0,0,0
402821,402,402,0,0,0
402824,171,171,0,0,0
402832,299,299,0,0,0
402877,56,56,0,0,0
402884,359,359,0,0,0
402885,131,131,0,0,0
402892,76,76,0,0,0
402896,306,306,0,0,0
402908,5,5,0,0,0
402916,29,29,0,0,0
402924,5,5,0,0,0
402929,359,359,0,0,0
402930,114,114,0,0,0
402936,184,184,0,0,0
402942,246,246,0,0,0
402974,345,345,0,0,0
402987,76,76,0,0,0
403011,50,50,0,0,0
403019,306,306,0,0,0
403023,76,76,0,0,0
403068,313,313,0,0,0
403080,310,310,0,0,0
403085,345,345,0,0,0
403123,72,72,0,0,0
403130,345,345,0,0,0
403143,128,128,0,0,0
403144,131,131,0,0,0
403153,299,299,0,0,0
403157,168,168,0,0,0
403164,201,201,0,0,0
403182,201,201,0,0,0
403183,198,198,0,0,0
403190,282,282,0,0,0
403191,69,69,0,0,0
403195,102,102,0,0,0
403196,310,310,0,0,0
403199,201,201,0,0,0
403202,359,359,0,0,0
403210,259,259,0,0,0
403214,103,103,0,0,0
403216,114,114,0,0,0
403221,353,353,0,0,0
403231,353,353,0,0,0
403251,252,252,0,0,0
403252,198,198,0,0,0
403271,345,345,0,0,0
403275,29,29,0,0,0
403285,313,313,0,0,0
403290,193,193,0,0,0
403291,152,152,0,0,0
403297,252,252,0,0,0
403300,251,251,0,0,0
403330,11,11,0,0,0
403331,74,74,0,0,0
403332,18,18,0,0,0
403336,167,167,0,0,0
403338,66,66,0,0,0
403354,69,69,0,0,0
403356,87,87,0,0,0
403369,313,313,0,0,0
403371,259,259,0,0,0
403383,345,345,0,0,0
403393,7,7,0,0,0
403398,201,201,0,0,0
403413,144,144,0,0,0
403421,171,171,0,0,0
403427,4,4,0,0,0
403429,103,103,0,0,0
403457,137,137,0,0,0
403478,246,246,0,0,0
403488,102,102,0,0,0
403492,345,345,0,0,0
403499,130,130,0,0,0
403504,246,246,0,0,0
403508,306,306,0,0,0
403516,55,55,0,0,0
403550,18,18,0,0,0
403551,75,75,0,0,0
403558,315,315,0,0,0
403560,114,114,0,0,0
403563,114,114,0,0,0
403599,114,114,0,0,0
403600,299,299,0,0,0
403611,55,55,0,0,0
403652,315,315,0,0,0
403665,131,131,0,0,0
403674,74,74,0,0,0
403686,102,102,0,0,0
403722,345,345,0,0,0
403731,30,30,0,0,0
403732,144,144,0,0,0
403733,281,281,0,0,0
403741,198,198,0,0,0
403780,121,121,0,0,0
403805,353,353,0,0,0
403806,281,281,0,0,0
403810,310,310,0,0,0
403813,120,120,0,0,0
403815,87,87,0,0,0
403817,315,315,0,0,0
403825,8,8,0,0,0
403829,246,246,0,0,0
403836,315,315,0,0,0
403852,121,121,0,0,0
403856,345,345,0,0,0
403863,402,402,0,0,0
403864,137,137,0,0,0
403881,137,137,0,0,0
403897,144,144,0,0,0
403903,17,17,0,0,0
403911,71,71,0,0,0
403913,252,252,0,0,0
403938,255,255,0,0,0
403951,70,70,0,0,0
403956,315,315,0,0,0
403980,193,193,0,0,0
403981,36,36,0,0,0
403993,299,299,0,0,0
404003,315,315,0,0,0
404008,163,163,0,0,0
404009,56,56,0,0,0
404010,17,17,0,0,0
404011,130,130,0,0,0
404039,359,359,0,0,0
404053,45,45,0,0,0
404060,18,18,0,0,0
404080,54,54,0,0,0
404084,163,163,0,0,0
404092,130,130,0,0,0
404102,345,345,0,0,0
404105,232,232,0,0,0
404108,313,313,0,0,0
404118,1,1,0,0,0
404149,82,82,0,0,0
404154,402,402,0,0,0
404157,201,201,0,0,0
404164,128,128,0,0,0
404207,15,15,0,0,0
404212,255,255,0,0,0
404219,128,128,0,0,0
404226,102,102,0,0,0
404227,251,251,0,0,0
404229,171,171,0,0,0
404239,132,132,0,0,0
404259,255,255,0,0,0
404274,282,282,0,0,0
404287,58,58,0,0,0
404344,130,130,0,0,0
404352,56,56,0,0,0
404365,137,137,0,0,0
404384,168,168,0,0,0
404400,201,201,0,0,0
404419,168,168,0,0,0
404441,232,232,0,0,0
404469,57,57,0,0,0
404482,94,94,0,0,0
404489,402,402,0,0,0
404509,57,57,0,0,0
404510,83,83,0,0,0
404516,4,4,0,0,0
404523,143,143,0,0,0
404524,359,359,0,0,0
404539,114,114,0,0,0
404565,313,313,0,0,0
404592,94,94,0,0,0
404594,315,315,0,0,0
404602,87,87,0,0,0
404655,255,255,0,0,0
404662,353,353,0,0,0
404667,255,255,0,0,0
404674,18,18,0,0,0
404675,282,282,0,0,0
404701,8,8,0,0,0
404712,71,71,0,0,0
404720,299,299,0,0,0
404729,282,282,0,0,0
404731,152,152,0,0,0
404742,306,306,0,0,0
404753,101,101,0,0,0
404784,25,25,0,0,0
404786,353,353,0,0,0
404799,102,102,0,0,0
404811,299,299,0,0,0
404835,7,7,0,0,0
404838,85,85,0,0,0
404845,251,251,0,0,0
404849,251,251,0,0,0
404852,32,32,0,0,0
404863,313,313,0,0,0
404892,359,359,0,0,0
404901,15,15,0,0,0
404914,282,282,0,0,0
404917,94,94,0,0,0
404919,171,171,0,0,0
404925,58,58,0,0,0
404949,74,74,0,0,0
404962,306,306,0,0,0
404972,72,72,0,0,0
404976,70,70,0,0,0
404995,255,255,0,0,0
404997,56,56,0,0,0
405045,102,102,0,0,0
405065,152,152,0,0,0
405067,315,315,0,0,0
405070,121,121,0,0,0
405074,152,152,0,0,0
405079,282,282,0,0,0
405108,259,259,0,0,0
405113,184,184,0,0,0
405129,24,24,0,0,0
405130,252,252,0,0,0
405138,4,4,0,0,0
405150,70,70,0,0,0
405160,255,255,0,0,0
405165,299,299,0,0,0
405186,259,259,0,0,0
405197,121,121,0,0,0
405204,102,102,0,0,0
405222,143,143,0,0,0
405237,103,103,0,0,0
405247,259,259,0,0,0
405250,193,193,0,0,0
405258,102,102,0,0,0
405267,167,167,0,0,0
405283,50,50,0,0,0
405290,65,65,0,0,0
405294,168,168,0,0,0
405299,143,143,0,0,0
405305,252,252,0,0,0
405308,87,87,0,0,0
405353,103,103,0,0,0
405363,359,359,0,0,0
405378,23,23,0,0,0
405385,36,36,0,0,0
405391,137,137,0,0,0
405392,130,130,0,0,0
405399,35,35,0,0,0
405403,359,359,0,0,0
405406,74,74,0,0,0
405412,21,21,0,0,0
405416,315,315,0,0,0
405432,13,13,0,0,0
405448,163,163,0,0,0
405451,56,56,0,0,0
405465,43,43,0,0,0
405473,56,56,0,0,0
405491,402,402,0,0,0
405506,246,246,0,0,0
405509,69,69,0,0,0
405514,102,102,0,0,0
405518,402,402,0,0,0
405534,251,251,0,0,0
405545,121,121,0,0,0
405549,50,50,0,0,0
405563,137,137,0,0,0
405575,359,359,0,0,0
405588,180,180,0,0,0
405596,27,27,0,0,0
405600,306,306,0,0,0
405602,198,198,0,0,0
405646,359,359,0,0,0
405648,152,152,0,0,0
405670,168,168,0,0,0
405679,30,30,0,0,0
405702,306,306,0,0,0
405718,201,201,0,0,0
405751,114,114,0,0,0
405795,34,34,0,0,0
405796,15,15,0,0,0
405815,171,171,0,0,0
405821,359,359,0,0,0
405847,252,252,0,0,0
405862,168,168,0,0,0
405865,41,41,0,0,0
405895,70,70,0,0,0
405899,102,102,0,0,0
405904,120,120,0,0,0
405906,315,315,0,0,0
405910,310,310,0,0,0
405925,193,193,0,0,0
405929,132,132,0,0,0
405932,198,198,0,0,0
405934,402,402,0,0,0
405935,120,120,0,0,0
405937,282,282,0,0,0
405947,40,40,0,0,0
405962,281,281,0,0,0
405983,144,144,0,0,0
405989,315,315,0,0,0
406000,151,151,0,0,0
406009,359,359,0,0,0
406050,232,232,0,0,0
406053,246,246,0,0,0
406067,121,121,0,0,0
406073,282,282,0,0,0
406077,1,1,0,0,0
406095,39,39,0,0,0
406097,137,137,0,0,0
406143,255,255,0,0,0
406153,359,359,0,0,0
406165,193,193,0,0,0
406175,137,137,0,0,0
406181,133,133,0,0,0
406184,71,71,0,0,0
406207,359,359,0,0,0
406235,137,137,0,0,0
406282,201,201,0,0,0
406296,315,315,0,0,0
406317,7,7,0,0,0
406319,50,50,0,0,0
406320,299,299,0,0,0
406328,94,94,0,0,0
406331,402,402,0,0,0
406354,94,94,0,0,0
406356,251,251,0,0,0
406357,359,359,0,0,0
406367,34,34,0,0,0
406370,18,18,0,0,0
406379,152,152,0,0,0
406384,252,252,0,0,0
406393,198,198,0,0,0
406395,232,232,0,0,0
406398,306,306,0,0,0
406401,306,306,0,0,0
406412,69,69,0,0,0
406422,168,168,0,0,0
406426,315,315,0,0,0
406443,13,13,0,0,0
406459,25,25,0,0,0
406462,313,313,0,0,0
406471,259,259,0,0,0
406480,120,120,0,0,0
406494,65,65,0,0,0
406504,102,102,0,0,0
406521,232,232,0,0,0
406530,255,255,0,0,0
406533,402,402,0,0,0
406538,41,41,0,0,0
406570,44,44,0,0,0
406574,114,114,0,0,0
406577,184,184,0,0,0
406609,65,65,0,0,0
406627,353,353,0,0,0
406631,13,13,0,0,0
406640,306,306,0,0,0
406650,359,359,0,0,0
406653,94,94,0,0,0
406660,25,25,0,0,0
406665,163,163,0,0,0
406671,74,74,0,0,0
406675,14,14,0,0,0
406679,180,180,0,0,0
406680,306,306,0,0,0
406702,55,55,0,0,0
406704,315,315,0,0,0
406713,201,201,0,0,0
406719,158,158,0,0,0
406721,158,158,0,0,0
406746,66,66,0,0,0
406747,85,85,0,0,0
406754,14,14,0,0,0
406764,16,16,0,0,0
406765,306,306,0,0,0
406769,137,137,0,0,0
406785,402,402,0,0,0
406795,103,103,0,0,0
406796,232,232,0,0,0
406803,121,121,0,0,0
406809,77,77,0,0,0
406811,345,345,0,0,0
406814,310,310,0,0,0
406830,151,151,0,0,0
406836,345,345,0,0,0
406839,29,29,0,0,0
406845,25,25,0,0,0
406865,27,27,0,0,0
406872,306,306,0,0,0
406875,281,281,0,0,0
406885,137,137,0,0,0
406886,121,121,0,0,0
406888,151,151,0,0,0
406908,163,163,0,0,0
406914,345,345,0,0,0
406918,143,143,0,0,0
406920,313,313,0,0,0
406940,113,113,0,0,0
406942,94,94,0,0,0
406945,102,102,0,0,0
406951,72,72,0,0,0
406955,65,65,0,0,0
406958,144,144,0,0,0
407010,259,259,0,0,0
407033,121,121,0,0,0
407040,15,15,0,0,0
407059,69,69,0,0,0
407072,39,39,0,0,0
407078,58,58,0,0,0
407092,76,76,0,0,0
407094,36,36,0,0,0
407107,5,5,0,0,0
407129,201,201,0,0,0
407130,113,113,0,0,0
407157,5,5,0,0,0
407162,128,128,0,0,0
407163,2,2,0,0,0
407165,251,251,0,0,0
407171,281,281,0,0,0
407179,75,75,0,0,0
407187,131,131,0,0,0
407203,14,14,0,0,0
407229,193,193,0,0,0
407234,259,259,0,0,0
407247,43,43,0,0,0
407256,102,102,0,0,0
407273,41,41,0,0,0
407285,282,282,0,0,0
407297,306,306,0,0,0
407307,39,39,0,0,0
407308,281,281,0,0,0
407334,306,306,0,0,0
407344,70,70,0,0,0
407356,184,184,0,0,0
407363,97,97,0,0,0
407369,143,143,0,0,0
407376,402,402,0,0,0
407385,255,255,0,0,0
407400,103,103,0,0,0
407402,353,353,0,0,0
407409,113,113,0,0,0
407469,44,44,0,0,0
407477,15,15,0,0,0
407488,15,15,0,0,0
407490,50,50,0,0,0
407499,251,251,0,0,0
407503,121,121,0,0,0
407509,113,113,0,0,0
407515,310,310,0,0,0
407547,353,353,0,0,0
407552,281,281,0,0,0
407556,4,4,0,0,0
407563,315,315,0,0,0
407572,315,315,0,0,0
407573,18,18,0,0,0
407596,113,113,0,0,0
407597,74,74,0,0,0
407619,97,97,0,0,0
407637,313,313,0,0,0
407652,130,130,0,0,0
407665,19,19,0,0,0
407707,251,251,0,0,0
407709,133,133,0,0,0
407710,246,246,0,0,0
407729,193,193,0,0,0
407732,313,313,0,0,0
407737,282,282,0,0,0
407748,11,11,0,0,0
407756,15,15,0,0,0
407759,27,27,0,0,0
407763,259,259,0,0,0
407769,402,402,0,0,0
407797,67,67,0,0,0
407810,345,345,0,0,0
407821,2,2,0,0,0
407825,299,299,0,0,0
407847,282,282,0,0,0
407873,128,128,0,0,0
407899,11,11,0,0,0
407931,120,120,0,0,0
407939,43,43,0,0,0
407950,43,43,0,0,0
407954,137,137,0,0,0
407961,353,353,0,0,0
407966,5,5,0,0,0
407999,137,137,0,0,0
408011,121,121,0,0,0
408013,168,168,0,0,0
408054,184,184,0,0,0
408067,232,232,0,0,0
408078,281,281,0,0,0
408093,359,359,0,0,0
408113,306,306,0,0,0
408115,180,180,0,0,0
408116,144,144,0,0,0
408133,55,55,0,0,0
408142,201,201,0,0,0
408144,201,201,0,0,0
408175,137,137,0,0,0
408179,193,193,0,0,0
408182,82,82,0,0,0
408190,315,315,0,0,0
408193,76,76,0,0,0
408217,97,97,0,0,0
408225,72,72,0,0,0
408231,168,168,0,0,0
408266,259,259,0,0,0
408315,76,76,0,0,0
408322,144,144,0,0,0
408325,8,8,0,0,0
408335,144,144,0,0,0
408337,345,345,0,0,0
408342,315,315,0,0,0
408345,35,35,0,0,0
408351,7,7,0,0,0
408368,299,299,0,0,0
408385,103,103,0,0,0
408386,76,76,0,0,0
408387,359,359,0,0,0
408416,137,137,0,0,0
408427,97,97,0,0,0
408436,63,63,0,0,0
408445,3,3,0,0,0
408448,27,27,0,0,0
408466,345,345,0,0,0
408492,50,50,0,0,0
408519,1,1,0,0,0
408521,359,359,0,0,0
408534,315,315,0,0,0
408547,255,255,0,0,0
408551,114,114,0,0,0
408552,22,22,0,0,0
408563,137,137,0,0,0
408570,152,152,0,0,0
408586,315,315,0,0,0
408589,143,143,0,0,0
408592,121,121,0,0,0
408600,103,103,0,0,0
408603,255,255,0,0,0
408607,128,128,0,0,0
408608,168,168,0,0,0
408617,193,193,0,0,0
408630,306,306,0,0,0
408632,75,75,0,0,0
408633,101,101,0,0,0
408645,255,255,0,0,0
408650,310,310,0,0,0
408660,168,168,0,0,0
408661,56,56,0,0,0
408678,152,152,0,0,0
408687,132,132,0,0,0
408701,246,246,0,0,0
408704,359,359,0,0,0
408715,74,74,0,0,0
408764,55,55,0,0,0
408773,133,133,0,0,0
408776,83,83,0,0,0
408783,103,103,0,0,0
408794,251,251,0,0,0
408819,201,201,0,0,0
408831,353,353,0,0,0
408849,171,171,0,0,0
408851,282,282,0,0,0
408860,184,184,0,0,0
408869,167,167,0,0,0
408871,55,55,0,0,0
408882,359,359,0,0,0
408911,313,313,0,0,0
408915,102,102,0,0,0
408919,128,128,0,0,0
408930,359,359,0,0,0
408932,158,158,0,0,0
408939,130,130,0,0,0
408965,306,306,0,0,0
408991,232,232,0,0,0
408992,76,76,0,0,0
408993,5,5,0,0,0
408996,71,71,0,0,0
409010,97,97,0,0,0
409014,19,19,0,0,0
409016,17,17,0,0,0
409031,282,282,0,0,0
409036,167,167,0,0,0
409049,158,158,0,0,0
409050,2,2,0,0,0
409058,21,21,0,0,0
409060,281,281,0,0,0
409089,11,11,0,0,0
409097,171,171,0,0,0
409114,281,281,0,0,0
409128,281,281,0,0,0
409145,114,114,0,0,0
409150,310,310,0,0,0
409159,232,232,0,0,0
409200,251,251,0,0,0
409206,36,36,0,0,0
409232,282,282,0,0,0
409233,299,299,0,0,0
409247,359,359,0,0,0
409252,24,24,0,0,0
409257,25,25,0,0,0
409262,72,72,0,0,0
409270,171,171,0,0,0
409279,402,402,0,0,0
409284,56,56,0,0,0
409285,232,232,0,0,0
409314,299,299,0,0,0
409325,56,56,0,0,0
409353,315,315,0,0,0
409358,353,353,0,0,0
409360,255,255,0,0,0
409372,252,252,0,0,0
409379,102,102,0,0,0
409385,251,251,0,0,0
409394,232,232,0,0,0
409410,255,255,0,0,0
409411,281,281,0,0,0
409414,259,259,0,0,0
409415,2,2,0,0,0
409416,299,299,0,0,0
409423,310,310,0,0,0
409434,113,113,0,0,0
409456,310,310,0,0,0
409476,246,246,0,0,0
409478,83,83,0,0,0
409485,41,41,0,0,0
409496,7,7,0,0,0
409519,158,158,0,0,0
409537,246,246,0,0,0
409564,143,143,0,0,0
409588,137,137,0,0,0
409658,5,5,0,0,0
409677,43,43,0,0,0
409734,151,151,0,0,0
409749,75,75,0,0,0
409757,299,299,0,0,0
409763,251,251,0,0,0
409766,282,282,0,0,0
409803,74,74,0,0,0
409819,359,359,0,0,0
409822,102,102,0,0,0
409828,56,56,0,0,0
409845,121,121,0,0,0
409853,315,315,0,0,0
409860,40,40,0,0,0
409862,41,41,0,0,0
409881,315,315,0,0,0
409892,102,102,0,0,0
409899,4,4,0,0,0
409911,36,36,0,0,0
409929,282,282,0,0,0
409942,151,151,0,0,0
409954,345,345,0,0,0
409956,82,82,0,0,0
409959,15,15,0,0,0
409972,102,102,0,0,0
410011,402,402,0,0,0
410018,306,306,0,0,0
410043,63,63,0,0,0
410046,184,184,0,0,0
410049,45,45,0,0,0
410071,281,281,0,0,0
410076,345,345,0,0,0
410081,5,5,0,0,0
410087,402,402,0,0,0
410088,103,103,0,0,0
410101,144,144,0,0,0
410109,359,359,0,0,0
410110,232,232,0,0,0
410148,158,158,0,0,0
410157,151,151,0,0,0
410160,255,255,0,0,0
410167,114,114,0,0,0
410171,306,306,0,0,0
410194,9,9,0,0,0
410207,144,144,0,0,0
410210,36,36,0,0,0
410244,232,232,0,0,0
410260,143,143,0,0,0
410269,168,168,0,0,0
410275,359,359,0,0,0
410298,255,255,0,0,0
410321,313,313,0,0,0
410328,56,56,0,0,0
410338,310,310,0,0,0
410341,168,168,0,0,0
410355,4,4,0,0,0
410369,168,168,0,0,0
410378,201,201,0,0,0
410387,158,158,0,0,0
410397,34,34,0,0,0
410406,359,359,0,0,0
410407,255,255,0,0,0
410422,306,306,0,0,0
410428,22,22,0,0,0
410460,75,75,0,0,0
410467,359,359,0,0,0
410479,171,171,0,0,0
410497,359,359,0,0,0
410502,121,121,0,0,0
410513,299,299,0,0,0
410516,17,17,0,0,0
410521,359,359,0,0,0
410528,70,70,0,0,0
410530,255,255,0,0,0
410540,313,313,0,0,0
410577,167,167,0,0,0
410587,30,30,0,0,0
410595,315,315,0,0,0
410607,353,353,0,0,0
410627,345,345,0,0,0
410645,55,55,0,0,0
410646,313,313,0,0,0
410654,20,20,0,0,0
410671,310,310,0,0,0
410674,345,345,0,0,0
410678,281,281,0,0,0
410684,32,32,0,0,0
410692,282,282,0,0,0
410716,5,5,0,0,0
410726,71,71,0,0,0
410729,198,198,0,0,0
410732,198,198,0,0,0
410748,198,198,0,0,0
410753,44,44,0,0,0
410756,168,168,0,0,0
410763,23,23,0,0,0
410789,282,282,0,0,0
410800,152,152,0,0,0
410802,27,27,0,0,0
410820,87,87,0,0,0
410827,310,310,0,0,0
410835,193,193,0,0,0
410842,83,83,0,0,0
410854,18,18,0,0,0
410859,282,282,0,0,0
410876,54,54,0,0,0
410879,120,120,0,0,0
410886,143,143,0,0,0
410893,69,69,0,0,0
410898,101,101,0,0,0
410911,143,143,0,0,0
410912,128,128,0,0,0
410927,17,17,0,0,0
410933,255,255,0,0,0
410943,201,201,0,0,0
410945,114,114,0,0,0
410980,158,158,0,0,0
411001,114,114,0,0,0
411005,41,41,0,0,0
411011,56,56,0,0,0
411019,6,6,0,0,0
411020,281,281,0,0,0
411025,184,184,0,0,0
411030,102,102,0,0,0
411044,133,133,0,0,0
411046,57,57,0,0,0
411052,193,193,0,0,0
411082,44,44,0,0,0
411094,121,121,0,0,0
411099,66,66,0,0,0
411107,315,315,0,0,0
411114,359,359,0,0,0
411134,143,143,0,0,0
411144,97,97,0,0,0
411160,69,69,0,0,0
411163,72,72,0,0,0
411216,103,103,0,0,0
411217,14,14,0,0,0
411222,313,313,0,0,0
411242,198,198,0,0,0
411282,313,313,0,0,0
411285,359,359,0,0,0
411292,152,152,0,0,0
411307,315,315,0,0,0
411312,75,75,0,0,0
411339,282,282,0,0,0
411346,121,121,0,0,0
411386,7,7,0,0,0
411392,144,144,0,0,0
411413,184,184,0,0,0
411417,128,128,0,0,0
411454,151,151,0,0,0
411455,41,41,0,0,0
411469,151,151,0,0,0
411471,252,252,0,0,0
411489,54,54,0,0,0
411511,402,402,0,0,0
411527,102,102,0,0,0
411541,306,306,0,0,0
411542,353,353,0,0,0
411544,281,281,0,0,0
411546,44,44,0,0,0
411564,103,103,0,0,0
411580,315,315,0,0,0
411587,310,310,0,0,0
411590,144,144,0,0,0
411597,281,281,0,0,0
411605,151,151,0,0,0
411612,252,252,0,0,0
411635,251,251,0,0,0
411636,306,306,0,0,0
411643,8,8,0,0,0
411651,114,114,0,0,0
411667,198,198,0,0,0
411685,7,7,0,0,0
411690,282,282,0,0,0
411693,43,43,0,0,0
411728,310,310,0,0,0
411730,281,281,0,0,0
411744,25,25,0,0,0
411757,313,313,0,0,0
411759,128,128,0,0,0
411765,32,32,0,0,0
411769,66,66,0,0,0
411770,306,306,0,0,0
411780,402,402,0,0,0
411787,75,75,0,0,0
411791,54,54,0,0,0
411802,97,97,0,0,0
411809,345,345,0,0,0
411816,121,121,0,0,0
411831,18,18,0,0,0
411837,198,198,0,0,0
411842,359,359,0,0,0
411890,12,12,0,0,0
411903,402,402,0,0,0
411911,310,310,0,0,0
411937,353,353,0,0,0
411940,30,30,0,0,0
411951,281,281,0,0,0
411952,7,7,0,0,0
411959,251,251,0,0,0
411978,34,34,0,0,0
411982,76,76,0,0,0
411985,246,246,0,0,0
412008,14,14,0,0,0
412012,121,121,0,0,0
412016,10,10,0,0,0
412026,255,255,0,0,0
412031,113,113,0,0,0
412033,259,259,0,0,0
412034,313,313,0,0,0
412041,163,163,0,0,0
412051,255,255,0,0,0
412063,299,299,0,0,0
412065,101,101,0,0,0
412072,19,19,0,0,0
412075,171,171,0,0,0
412084,144,144,0,0,0
412086,167,167,0,0,0
412094,94,94,0,0,0
412103,2,2,0,0,0
412115,75,75,0,0,0
412129,76,76,0,0,0
412135,69,69,0,0,0
412146,65,65,0,0,0
412154,171,171,0,0,0
412166,282,282,0,0,0
412173,158,158,0,0,0
412185,310,310,0,0,0
412186,168,168,0,0,0
412197,120,120,0,0,0
412204,402,402,0,0,0
412209,20,20,0,0,0
412232,152,152,0,0,0
412242,151,151,0,0,0
412252,310,310,0,0,0
412253,184,184,0,0,0
412254,259,259,0,0,0
412260,13,13,0,0,0
412261,20,20,0,0,0
412275,255,255,0,0,0
412286,167,167,0,0,0
412315,251,251,0,0,0
412319,25,25,0,0,0
412338,180,180,0,0,0
412339,299,299,0,0,0
412355,74,74,0,0,0
412362,14,14,0,0,0
412371,151,151,0,0,0
412378,82,82,0,0,0
412389,36,36,0,0,0
412391,54,54,0,0,0
412392,22,22,0,0,0
412397,151,151,0,0,0
412399,76,76,0,0,0
412413,359,359,0,0,0
412421,168,168,0,0,0
412424,102,102,0,0,0
412453,76,76,0,0,0
412455,193,193,0,0,0
412464,76,76,0,0,0
412472,353,353,0,0,0
412480,15,15,0,0,0
412481,36,36,0,0,0
412486,167,167,0,0,0
412492,69,69,0,0,0
412506,130,130,0,0,0
412511,171,171,0,0,0
412514,132,132,0,0,0
412529,69,69,0,0,0
412535,43,43,0,0,0
412538,299,299,0,0,0
412553,345,345,0,0,0
412572,44,44,0,0,0
412575,313,313,0,0,0
412589,36,36,0,0,0
412599,167,167,0,0,0
412619,252,252,0,0,0
412623,345,345,0,0,0
412649,299,299,0,0,0
412654,87,87,0,0,0
412663,50,50,0,0,0
412666,313,313,0,0,0
412675,7,7,0,0,0
412692,359,359,0,0,0
412700,102,102,0,0,0
412722,44,44,0,0,0
412728,74,74,0,0,0
412736,315,315,0,0,0
412762,313,313,0,0,0
412774,144,144,0,0,0
412783,131,131,0,0,0
412795,1,1,0,0,0
412819,1,1,0,0,0
412851,313,313,0,0,0
412861,102,102,0,0,0
412869,102,102,0,0,0
412873,114,114,0,0,0
412889,101,101,0,0,0
412900,259,259,0,0,0
412933,32,32,0,0,0
412946,65,65,0,0,0
412955,345,345,0,0,0
412957,313,313,0,0,0
412961,55,55,0,0,0
412971,128,128,0,0,0
412974,168,168,0,0,0
412979,67,67,0,0,0
412980,40,40,0,0,0
412989,345,345,0,0,0
412995,306,306,0,0,0
413004,259,259,0,0,0
413011,163,163,0,0,0
413013,29,29,0,0,0
413033,39,39,0,0,0
413053,167,167,0,0,0
413060,353,353,0,0,0
413070,313,313,0,0,0
413075,6,6,0,0,0
413096,9,9,0,0,0
413097,66,66,0,0,0
413115,75,75,0,0,0
413122,30,30,0,0,0
413143,113,113,0,0,0
413144,13,13,0,0,0
413153,87,87,0,0,0
413207,10,10,0,0,0
413215,345,345,0,0,0
413217,306,306,0,0,0
413221,167,167,0,0,0
413236,252,252,0,0,0
413255,35,35,0,0,0
413267,103,103,0,0,0
413268,151,151,0,0,0
413288,345,345,0,0,0
413315,102,102,0,0,0
413327,10,10,0,0,0
413374,34,34,0,0,0
413379,85,85,0,0,0
413382,259,259,0,0,0
413389,21,21,0,0,0
413392,8,8,0,0,0
413393,65,65,0,0,0
413396,22,22,0,0,0
413398,8,8,0,0,0
413402,310,310,0,0,0
413429,70,70,0,0,0
413443,359,359,0,0,0
413445,132,132,0,0,0
413459,54,54,0,0,0
413470,315,315,0,0,0
413484,282,282,0,0,0
413488,72,72,0,0,0
413495,353,353,0,0,0
413496,6,6,0,0,0
413502,18,18,0,0,0
413505,85,85,0,0,0
413515,402,402,0,0,0
413543,113,113,0,0,0
413558,402,402,0,0,0
413587,15,15,0,0,0
413603,402,402,0,0,0
413621,193,193,0,0,0
413632,10,10,0,0,0
413640,120,120,0,0,0
413643,69,69,0,0,0
413645,82,82,0,0,0
413651,114,114,0,0,0
413665,35,35,0,0,0
413717,168,168,0,0,0
413724,282,282,0,0,0
413738,171,171,0,0,0
413751,345,345,0,0,0
413776,72,72,0,0,0
413793,74,74,0,0,0
413799,201,201,0,0,0
413827,29,29,0,0,0
413830,65,65,0,0,0
413836,45,45,0,0,0
413844,345,345,0,0,0
413847,8,8,0,0,0
413861,75,75,0,0,0
413868,34,34,0,0,0
413870,25,25,0,0,0
413886,71,71,0,0,0
413887,252,252,0,0,0
413895,313,313,0,0,0
413900,8,8,0,0,0
413922,19,19,0,0,0
413923,184,184,0,0,0
413924,184,184,0,0,0
413925,259,259,0,0,0
413943,30,30,0,0,0
413966,113,113,0,0,0
413970,133,133,0,0,0
413984,246,246,0,0,0
413987,114,114,0,0,0
413988,345,345,0,0,0
414001,359,359,0,0,0
414006,70,70,0,0,0
414010,299,299,0,0,0
414021,44,44,0,0,0
414023,255,255,0,0,0
414024,66,66,0,0,0
414027,252,252,0,0,0
414056,50,50,0,0,0
414059,359,359,0,0,0
414061,71,71,0,0,0
414064,77,77,0,0,0
414071,163,163,0,0,0
414075,151,151,0,0,0
414093,152,152,0,0,0
414104,313,313,0,0,0
414109,29,29,0,0,0
414120,232,232,0,0,0
414126,345,345,0,0,0
414136,201,201,0,0,0
414137,402,402,0,0,0
414140,306,306,0,0,0
414157,345,345,0,0,0
414179,402,402,0,0,0
414207,29,29,0,0,0
414219,402,402,0,0,0
414220,184,184,0,0,0
414243,130,130,0,0,0
414244,252,252,0,0,0
414256,345,345,0,0,0
414274,137,137,0,0,0
414276,201,201,0,0,0
414285,19,19,0,0,0
414303,35,35,0,0,0
414305,353,353,0,0,0
414308,13,13,0,0,0
414312,345,345,0,0,0
414318,315,315,0,0,0
414333,299,299,0,0,0
414350,359,359,0,0,0
414352,359,359,0,0,0
414370,21,21,0,0,0
414377,171,171,0,0,0
414381,402,402,0,0,0
414438,345,345,0,0,0
414470,32,32,0,0,0
414485,22,22,0,0,0
414501,70,70,0,0,0
414511,168,168,0,0,0
414512,282,282,0,0,0
414533,259,259,0,0,0
414540,128,128,0,0,0
414543,102,102,0,0,0
414546,120,120,0,0,0
414551,255,255,0,0,0
414553,201,201,0,0,0
414570,151,151,0,0,0
414572,22,22,0,0,0
414578,131,131,0,0,0
414614,144,144,0,0,0
414616,299,299,0,0,0
414624,201,201,0,0,0
414627,121,121,0,0,0
414628,313,313,0,0,0
414640,70,70,0,0,0
414660,306,306,0,0,0
414678,137,137,0,0,0
414688,315,315,0,0,0
414707,152,152,0,0,0
414714,1,1,0,0,0
414729,76,76,0,0,0
414743,57,57,0,0,0
414758,315,315,0,0,0
414767,193,193,0,0,0
414770,310,310,0,0,0
414772,128,128,0,0,0
414774,246,246,0,0,0
414786,168,168,0,0,0
414805,54,54,0,0,0
414810,315,315,0,0,0
414822,25,25,0,0,0
414840,121,121,0,0,0
414849,152,152,0,0,0
414863,282,282,0,0,0
414868,281,281,0,0,0
414899,246,246,0,0,0
414902,25,25,0,0,0
414905,128,128,0,0,0
414908,180,180,0,0,0
414915,184,184,0,0,0
414957,345,345,0,0,0
414959,4,4,0,0,0
414978,74,74,0,0,0
414992,282,282,0,0,0
415009,128,128,0,0,0
415035,97,97,0,0,0
415046,85,85,0,0,0
415052,19,19,0,0,0
415055,20,20,0,0,0
415113,168,168,0,0,0
415137,184,184,0,0,0
415144,1,1,0,0,0
415154,14,14,0,0,0
415173,315,315,0,0,0
415195,198,198,0,0,0
415216,58,58,0,0,0
415229,306,306,0,0,0
415234,246,246,0,0,0
415259,66,66,0,0,0
415271,121,121,0,0,0
415277,167,167,0,0,0
415284,252,252,0,0,0
415293,180,180,0,0,0
415295,72,72,0,0,0
415298,353,353,0,0,0
415299,5,5,0,0,0
415322,246,246,0,0,0
415330,131,131,0,0,0
415352,259,259,0,0,0
415363,10,10,0,0,0
415375,70,70,0,0,0
415383,71,71,0,0,0
415384,251,251,0,0,0
415385,85,85,0,0,0
415389,151,151,0,0,0
415396,198,198,0,0,0
415401,359,359,0,0,0
415410,24,24,0,0,0
415411,315,315,0,0,0
415424,65,65,0,0,0
415426,255,255,0,0,0
415434,94,94,0,0,0
415443,345,345,0,0,0
415450,252,252,0,0,0
415473,12,12,0,0,0
415485,103,103,0,0,0
415495,5,5,0,0,0
415516,102,102,0,0,0
415530,315,315,0,0,0
415564,39,39,0,0,0
415565,310,310,0,0,0
415567,198,198,0,0,0
415569,130,130,0,0,0
415573,137,137,0,0,0
415579,184,184,0,0,0
415607,171,171,0,0,0
415656,36,36,0,0,0
415671,121,121,0,0,0
415687,402,402,0,0,0
415690,353,353,0,0,0
415739,103,103,0,0,0
415762,130,130,0,0,0
415772,252,252,0,0,0
415777,128,128,0,0,0
415783,71,71,0,0,0
415789,45,45,0,0,0
415792,35,35,0,0,0
415793,259,259,0,0,0
415797,121,121,0,0,0
415842,10,10,0,0,0
415844,85,85,0,0,0
415850,24,24,0,0,0
415853,76,76,0,0,0
415870,101,101,0,0,0
415874,402,402,0,0,0
415881,17,17,0,0,0
415914,353,353,0,0,0
415916,121,121,0,0,0
415923,353,353,0,0,0
415930,353,353,0,0,0
415931,299,299,0,0,0
415976,9,9,0,0,0
415987,315,315,0,0,0
415993,87,87,0,0,0
416000,144,144,0,0,0
416011,97,97,0,0,0
416023,282,282,0,0,0
416046,353,353,0,0,0
416053,306,306,0,0,0
416110,184,184,0,0,0
416112,282,282,0,0,0
416127,131,131,0,0,0
416131,114,114,0,0,0
416141,168,168,0,0,0
416156,310,310,0,0,0
416165,315,315,0,0,0
416173,255,255,0,0,0
416174,144,144,0,0,0
416177,17,17,0,0,0
416190,102,102,0,0,0
416200,251,251,0,0,0
416221,259,259,0,0,0
416225,299,299,0,0,0
416254,313,313,0,0,0
416258,259,259,0,0,0
416267,103,103,0,0,0
416284,29,29,0,0,0
416298,198,198,0,0,0
416344,17,17,0,0,0
416351,158,158,0,0,0
416380,232,232,0,0,0
416399,152,152,0,0,0
416403,10,10,0,0,0
416413,310,310,0,0,0
416422,281,281,0,0,0
416444,74,74,0,0,0
416467,315,315,0,0,0
416473,43,43,0,0,0
416480,353,353,0,0,0
416490,359,359,0,0,0
416498,168,168,0,0,0
416499,252,252,0,0,0
416500,101,101,0,0,0
416504,27,27,0,0,0
416517,57,57,0,0,0
416518,3,3,0,0,0
416519,402,402,0,0,0
416545,158,158,0,0,0
416554,25,25,0,0,0
416560,315,315,0,0,0
416570,402,402,0,0,0
416577,39,39,0,0,0
416593,198,198,0,0,0
416611,246,246,0,0,0
416623,5,5,0,0,0
416642,32,32,0,0,0
416653,13,13,0,0,0
416709,63,63,0,0,0
416712,114,114,0,0,0
416719,306,306,0,0,0
416723,82,82,0,0,0
416726,402,402,0,0,0
416732,345,345,0,0,0
416751,184,184,0,0,0
416759,137,137,0,0,0
416768,232,232,0,0,0
416784,130,130,0,0,0
416786,180,180,0,0,0
416804,85,85,0,0,0
416813,77,77,0,0,0
416819,345,345,0,0,0
416857,29,29,0,0,0
416861,306,306,0,0,0
416867,20,20,0,0,0
416869,246,246,0,0,0
416878,180,180,0,0,0
416879,65,65,0,0,0
416914,353,353,0,0,0
416958,87,87,0,0,0
416966,313,313,0,0,0
417010,76,76,0,0,0
417013,83,83,0,0,0
417015,131,131,0,0,0
417032,69,69,0,0,0
417051,35,35,0,0,0
417057,232,232,0,0,0
417073,310,310,0,0,0
417077,101,101,0,0,0
417097,97,97,0,0,0
417099,32,32,0,0,0
417103,345,345,0,0,0
417120,255,255,0,0,0
417126,101,101,0,0,0
417157,255,255,0,0,0
417162,151,151,0,0,0
417165,19,19,0,0,0
417170,20,20,0,0,0
417175,246,246,0,0,0
417179,299,299,0,0,0
417180,281,281,0,0,0
417186,11,11,0,0,0
417195,137,137,0,0,0
417202,282,282,0,0,0
417205,198,198,0,0,0
417209,36,36,0,0,0
417222,7,7,0,0,0
417232,246,246,0,0,0
417249,9,9,0,0,0
417269,306,306,0,0,0
417275,45,45,0,0,0
417281,259,259,0,0,0
417284,151,151,0,0,0
417299,255,255,0,0,0
417314,402,402,0,0,0
417323,6,6,0,0,0
417329,313,313,0,0,0
417344,193,193,0,0,0
417356,251,251,0,0,0
417358,345,345,0,0,0
417381,251,251,0,0,0
417411,2,2,0,0,0
417426,50,50,0,0,0
417434,6,6,0,0,0
417443,313,313,0,0,0
417473,345,345,0,0,0
417481,232,232,0,0,0
417485,56,56,0,0,0
417501,158,158,0,0,0
417508,27,27,0,0,0
417521,232,232,0,0,0
417532,184,184,0,0,0
417541,35,35,0,0,0
417552,137,137,0,0,0
417554,137,137,0,0,0
417575,251,251,0,0,0
417577,57,57,0,0,0
417585,232,232,0,0,0
417591,137,137,0,0,0
417599,7,7,0,0,0
417603,232,232,0,0,0
417615,313,313,0,0,0
417619,121,121,0,0,0
417622,34,34,0,0,0
417629,103,103,0,0,0
417634,101,101,0,0,0
417638,54,54,0,0,0
417644,27,27,0,0,0
417675,113,113,0,0,0
417686,282,282,0,0,0
417688,353,353,0,0,0
417691,232,232,0,0,0
417698,201,201,0,0,0
417709,143,143,0,0,0
417722,310,310,0,0,0
417752,25,25,0,0,0
417753,67,67,0,0,0
417776,137,137,0,0,0
417815,281,281,0,0,0
417816,97,97,0,0,0
417817,63,63,0,0,0
417819,102,102,0,0,0
417821,255,255,0,0,0
417839,246,246,0,0,0
417840,97,97,0,0,0
417841,113,113,0,0,0
417847,232,232,0,0,0
417848,17,17,0,0,0
417851,4,4,0,0,0
417865,102,102,0,0,0
417867,113,113,0,0,0
417868,83,83,0,0,0
417878,259,259,0,0,0
417880,87,87,0,0,0
417885,75,75,0,0,0
417894,137,137,0,0,0
417908,251,251,0,0,0
417913,50,50,0,0,0
417950,345,345,0,0,0
417961,345,345,0,0,0
418010,22,22,0,0,0
418011,198,198,0,0,0
418021,128,128,0,0,0
418023,131,131,0,0,0
418047,76,76,0,0,0
418060,246,246,0,0,0
418068,66,66,0,0,0
418087,353,353,0,0,0
418088,130,130,0,0,0
418093,168,168,0,0,0
418104,232,232,0,0,0
418109,310,310,0,0,0
418114,144,144,0,0,0
418117,310,310,0,0,0
418132,152,152,0,0,0
418143,82,82,0,0,0
418156,103,103,0,0,0
418161,27,27,0,0,0
418175,252,252,0,0,0
418185,255,255,0,0,0
418188,313,313,0,0,0
418198,45,45,0,0,0
418203,252,252,0,0,0
418215,76,76,0,0,0
418240,20,20,0,0,0
418241,184,184,0,0,0
418266,282,282,0,0,0
418273,130,130,0,0,0
418274,131,131,0,0,0
418295,353,353,0,0,0
418306,246,246,0,0,0
418310,184,184,0,0,0
418324,11,11,0,0,0
418326,201,201,0,0,0
418353,34,34,0,0,0
418370,34,34,0,0,0
418372,69,69,0,0,0
418374,70,70,0,0,0
418395,282,282,0,0,0
418398,184,184,0,0,0
418403,281,281,0,0,0
418405,282,282,0,0,0
418409,41,41,0,0,0
418417,201,201,0,0,0
418463,101,101,0,0,0
418464,232,232,0,0,0
418465,121,121,0,0,0
418466,310,310,0,0,0
418467,151,151,0,0,0
418468,171,171,0,0,0
418469,25,25,0,0,0
418470,282,282,0,0,0
418490,120,120,0,0,0
418492,171,171,0,0,0
418512,137,137,0,0,0
418531,306,306,0,0,0
418542,310,310,0,0,0
418549,306,306,0,0,0
418556,252,252,0,0,0
418560,315,315,0,0,0
418570,35,35,0,0,0
418578,69,69,0,0,0
418619,152,152,0,0,0
418626,130,130,0,0,0
418637,43,43,0,0,0
418639,137,137,0,0,0
418642,359,359,0,0,0
418663,77,77,0,0,0
418664,121,121,0,0,0
418667,158,158,0,0,0
418689,315,315,0,0,0
418700,28,28,0,0,0
418701,246,246,0,0,0
418703,306,306,0,0,0
418711,198,198,0,0,0
418734,8,8,0,0,0
418739,255,255,0,0,0
418759,313,313,0,0,0
418764,246,246,0,0,0
418774,113,113,0,0,0
418778,163,163,0,0,0
418788,315,315,0,0,0
418802,255,255,0,0,0
418804,56,56,0,0,0
418811,25,25,0,0,0
418818,69,69,0,0,0
418830,143,143,0,0,0
418835,232,232,0,0,0
418836,83,83,0,0,0
418856,299,299,0,0,0
418857,299,299,0,0,0
418871,310,310,0,0,0
418890,101,101,0,0,0
418891,50,50,0,0,0
418897,255,255,0,0,0
418898,143,143,0,0,0
418901,299,299,0,0,0
418908,359,359,0,0,0
418944,143,143,0,0,0
418946,180,180,0,0,0
418947,82,82,0,0,0
418951,152,152,0,0,0
418961,34,34,0,0,0
418963,252,252,0,0,0
418967,56,56,0,0,0
418979,345,345,0,0,0
418995,359,359,0,0,0
418996,168,168,0,0,0
419002,114,114,0,0,0
419015,71,71,0,0,0
419019,17,17,0,0,0
419021,180,180,0,0,0
419023,77,77,0,0,0
419029,36,36,0,0,0
419036,180,180,0,0,0
419045,67,67,0,0,0
419066,6,6,0,0,0
419067,18,18,0,0,0
419068,25,25,0,0,0
419099,15,15,0,0,0
419110,359,359,0,0,0
419127,15,15,0,0,0
419132,54,54,0,0,0
419137,163,163,0,0,0
419140,12,12,0,0,0
419142,15,15,0,0,0
419155,121,121,0,0,0
419164,246,246,0,0,0
419191,232,232,0,0,0
419212,44,44,0,0,0
419224,85,85,0,0,0
419235,102,102,0,0,0
419241,102,102,0,0,0
419247,131,131,0,0,0
419293,345,345,0,0,0
419295,18,18,0,0,0
419296,252,252,0,0,0
419307,76,76,0,0,0
419315,193,193,0,0,0
419316,50,50,0,0,0
419328,144,144,0,0,0
419330,251,251,0,0,0
419351,299,299,0,0,0
419364,74,74,0,0,0
419374,36,36,0,0,0
419428,120,120,0,0,0
419430,198,198,0,0,0
419440,313,313,0,0,0
419449,167,167,0,0,0
419459,131,131,0,0,0
419467,102,102,0,0,0
419472,114,114,0,0,0
419485,313,313,0,0,0
419519,113,113,0,0,0
419523,359,359,0,0,0
419536,152,152,0,0,0
419549,128,128,0,0,0
419551,310,310,0,0,0
419560,133,133,0,0,0
419589,74,74,0,0,0
419592,158,158,0,0,0
419593,143,143,0,0,0
419599,184,184,0,0,0
419600,5,5,0,0,0
419601,345,345,0,0,0
419602,34,34,0,0,0
419608,70,70,0,0,0
419614,3,3,0,0,0
419618,121,121,0,0,0
419640,252,252,0,0,0
419676,255,255,0,0,0
419697,310,310,0,0,0
419700,167,167,0,0,0
419708,246,246,0,0,0
419712,353,353,0,0,0
419714,5,5,0,0,0
419732,282,282,0,0,0
419734,76,76,0,0,0
419738,54,54,0,0,0
419739,310,310,0,0,0
419743,70,70,0,0,0
419754,87,87,0,0,0
419783,43,43,0,0,0
419789,353,353,0,0,0
419820,198,198,0,0,0
419823,246,246,0,0,0
419835,63,63,0,0,0
419844,137,137,0,0,0
419860,35,35,0,0,0
419881,163,163,0,0,0
419885,281,281,0,0,0
419904,56,56,0,0,0
419907,30,30,0,0,0
419926,137,137,0,0,0
419934,143,143,0,0,0
419954,132,132,0,0,0
419966,198,198,0,0,0
419973,180,180,0,0,0
420030,251,251,0,0,0
420048,87,87,0,0,0
420055,74,74,0,0,0
420070,306,306,0,0,0
420071,315,315,0,0,0
420077,74,74,0,0,0
420079,353,353,0,0,0
420097,6,6,0,0,0
420127,29,29,0,0,0
420144,11,11,0,0,0
420168,39,39,0,0,0
420174,56,56,0,0,0
420175,30,30,0,0,0
420177,152,152,0,0,0
420198,3,3,0,0,0
420199,5,5,0,0,0
420208,8,8,0,0,0
420248,315,315,0,0,0
420249,359,359,0,0,0
420256,168,168,0,0,0
420267,144,144,0,0,0
420281,152,152,0,0,0
420291,76,76,0,0,0
420309,201,201,0,0,0
420326,6,6,0,0,0
420334,168,168,0,0,0
420336,2,2,0,0,0
420356,299,299,0,0,0
420371,71,71,0,0,0
420386,121,121,0,0,0
420388,144,144,0,0,0
420429,359,359,0,0,0
420435,193,193,0,0,0
420442,17,17,0,0,0
420445,281,281,0,0,0
420449,180,180,0,0,0
420457,25,25,0,0,0
420467,5,5,0,0,0
420473,133,133,0,0,0
420477,353,353,0,0,0
420493,2,2,0,0,0
420511,121,121,0,0,0
420522,251,251,0,0,0
420534,313,313,0,0,0
420552,128,128,0,0,0
420555,167,167,0,0,0
420556,70,70,0,0,0
420565,17,17,0,0,0
420575,201,201,0,0,0
420579,193,193,0,0,0
420584,152,152,0,0,0
420590,232,232,0,0,0
420598,158,158,0,0,0
420612,152,152,0,0,0
420618,252,252,0,0,0
420619,281,281,0,0,0
420639,67,67,0,0,0
420678,201,201,0,0,0
420691,67,67,0,0,0
420737,313,313,0,0,0
420738,163,163,0,0,0
420751,198,198,0,0,0
420758,255,255,0,0,0
420786,255,255,0,0,0
420792,25,25,0,0,0
420809,353,353,0,0,0
420828,120,120,0,0,0
420846,76,76,0,0,0
420867,97,97,0,0,0
420871,246,246,0,0,0
420878,137,137,0,0,0
420882,6,6,0,0,0
420981,306,306,0,0,0
420993,83,83,0,0,0
420994,120,120,0,0,0
421010,29,29,0,0,0
421017,281,281,0,0,0
421020,76,76,0,0,0
421033,313,313,0,0,0
421037,9,9,0,0,0
421048,402,402,0,0,0
421056,74,74,0,0,0
421069,158,158,0,0,0
421078,180,180,0,0,0
421081,353,353,0,0,0
421087,163,163,0,0,0
421089,198,198,0,0,0
421101,103,103,0,0,0
421113,82,82,0,0,0
421128,281,281,0,0,0
421149,97,97,0,0,0
421158,120,120,0,0,0
421185,168,168,0,0,0
421187,6,6,0,0,0
421193,158,158,0,0,0
421210,232,232,0,0,0
421227,56,56,0,0,0
421253,353,353,0,0,0
421262,171,171,0,0,0
421268,137,137,0,0,0
421270,6,6,0,0,0
421274,45,45,0,0,0
421282,158,158,0,0,0
421293,345,345,0,0,0
421326,14,14,0,0,0
421327,359,359,0,0,0
421328,281,281,0,0,0
421339,82,82,0,0,0
421354,167,167,0,0,0
421362,101,101,0,0,0
421363,184,184,0,0,0
421379,30,30,0,0,0
421384,163,163,0,0,0
421387,15,15,0,0,0
421388,152,152,0,0,0
421400,345,345,0,0,0
421420,167,167,0,0,0
421421,246,246,0,0,0
421441,353,353,0,0,0
421442,16,16,0,0,0
421446,137,137,0,0,0
421461,44,44,0,0,0
421463,29,29,0,0,0
421476,57,57,0,0,0
421480,402,402,0,0,0
421505,359,359,0,0,0
421523,402,402,0,0,0
421526,65,65,0,0,0
421541,184,184,0,0,0
421546,353,353,0,0,0
421549,158,158,0,0,0
421569,8,8,0,0,0
421583,315,315,0,0,0
421596,87,87,0,0,0
421616,77,77,0,0,0
421635,313,313,0,0,0
421641,70,70,0,0,0
421647,83,83,0,0,0
421655,315,315,0,0,0
421684,66,66,0,0,0
421700,55,55,0,0,0
421719,29,29,0,0,0
421757,310,310,0,0,0
421769,21,21,0,0,0
421775,44,44,0,0,0
421785,143,143,0,0,0
421792,137,137,0,0,0
421794,306,306,0,0,0
421805,299,299,0,0,0
421835,281,281,0,0,0
421841,259,259,0,0,0
421845,359,359,0,0,0
421863,193,193,0,0,0
421870,359,359,0,0,0
421871,259,259,0,0,0
421880,168,168,0,0,0
421883,152,152,0,0,0
421893,3,3,0,0,0
421895,113,113,0,0,0
421903,76,76,0,0,0
421908,345,345,0,0,0
421913,69,69,0,0,0
421923,21,21,0,0,0
421924,74,74,0,0,0
421927,55,55,0,0,0
421929,131,131,0,0,0
421937,113,113,0,0,0
421958,114,114,0,0,0
421966,144,144,0,0,0
421980,6,6,0,0,0
421988,121,121,0,0,0
421998,313,313,0,0,0
422001,83,83,0,0,0
422022,54,54,0,0,0
422025,114,114,0,0,0
422041,102,102,0,0,0
422062,198,198,0,0,0
422072,16,16,0,0,0
422078,198,198,0,0,0
422097,27,27,0,0,0
422098,15,15,0,0,0
422124,359,359,0,0,0
422136,85,85,0,0,0
422155,97,97,0,0,0
422174,137,137,0,0,0
422183,131,131,0,0,0
422192,158,158,0,0,0
422198,232,232,0,0,0
422208,282,282,0,0,0
422228,131,131,0,0,0
422231,184,184,0,0,0
422238,143,143,0,0,0
422251,103,103,0,0,0
422253,121,121,0,0,0
422281,6,6,0,0,0
422292,25,25,0,0,0
422294,24,24,0,0,0
422306,36,36,0,0,0
422307,40,40,0,0,0
422311,22,22,0,0,0
422324,17,17,0,0,0
422329,113,113,0,0,0
422342,4,4,0,0,0
422344,246,246,0,0,0
422358,54,54,0,0,0
422362,306,306,0,0,0
422365,359,359,0,0,0
422370,130,130,0,0,0
422374,402,402,0,0,0
422385,2,2,0,0,0
422389,345,345,0,0,0
422394,113,113,0,0,0
422415,23,23,0,0,0
422416,82,82,0,0,0
422418,359,359,0,0,0
422429,76,76,0,0,0
422440,130,130,0,0,0
422442,353,353,0,0,0
422446,102,102,0,0,0
422454,359,359,0,0,0
422460,353,353,0,0,0
422490,5,5,0,0,0
422517,251,251,0,0,0
422548,144,144,0,0,0
422588,359,359,0,0,0
422592,353,353,0,0,0
422642,359,359,0,0,0
422645,310,310,0,0,0
422655,259,259,0,0,0
422660,39,39,0,0,0
422663,102,102,0,0,0
422693,144,144,0,0,0
422707,163,163,0,0,0
422725,7,7,0,0,0
422730,251,251,0,0,0
422746,232,232,0,0,0
422748,87,87,0,0,0
422762,345,345,0,0,0
422773,137,137,0,0,0
422777,36,36,0,0,0
422789,281,281,0,0,0
422791,251,251,0,0,0
422794,137,137,0,0,0
422814,2,2,0,0,0
422831,36,36,0,0,0
422839,313,313,0,0,0
422855,14,14,0,0,0
422862,87,87,0,0,0
422904,252,252,0,0,0
422907,315,315,0,0,0
422913,168,168,0,0,0
422948,313,313,0,0,0
422949,103,103,0,0,0
422954,120,120,0,0,0
422956,168,168,0,0,0
422968,87,87,0,0,0
422974,36,36,0,0,0
422980,345,345,0,0,0
422985,282,282,0,0,0
422988,201,201,0,0,0
422992,184,184,0,0,0
422993,359,359,0,0,0
423004,310,310,0,0,0
423006,76,76,0,0,0
423030,9,9,0,0,0
423042,151,151,0,0,0
423051,232,232,0,0,0
423056,130,130,0,0,0
423059,14,14,0,0,0
423090,69,69,0,0,0
423106,83,83,0,0,0
423109,402,402,0,0,0
423113,310,310,0,0,0
423116,252,252,0,0,0
423117,151,151,0,0,0
423120,281,281,0,0,0
423135,402,402,0,0,0
423142,402,402,0,0,0
423150,158,158,0,0,0
423168,75,75,0,0,0
423193,180,180,0,0,0
423215,306,306,0,0,0
423249,21,21,0,0,0
423254,353,353,0,0,0
423255,113,113,0,0,0
423263,12,12,0,0,0
423266,251,251,0,0,0
423277,17,17,0,0,0
423283,4,4,0,0,0
423290,137,137,0,0,0
423335,252,252,0,0,0
423342,184,184,0,0,0
423343,359,359,0,0,0
423352,184,184,0,0,0
423376,232,232,0,0,0
423392,82,82,0,0,0
423415,198,198,0,0,0
423429,137,137,0,0,0
423430,281,281,0,0,0
423431,14,14,0,0,0
423434,402,402,0,0,0
423457,232,232,0,0,0
423463,313,313,0,0,0
423464,72,72,0,0,0
423470,29,29,0,0,0
423483,198,198,0,0,0
423488,114,114,0,0,0
423526,36,36,0,0,0
423541,259,259,0,0,0
423547,201,201,0,0,0
423566,281,281,0,0,0
423579,313,313,0,0,0
423580,299,299,0,0,0
423620,255,255,0,0,0
423621,41,41,0,0,0
423629,151,151,0,0,0
423702,94,94,0,0,0
423707,114,114,0,0,0
423709,313,313,0,0,0
423714,402,402,0,0,0
423725,143,143,0,0,0
423782,12,12,0,0,0
423800,402,402,0,0,0
423806,143,143,0,0,0
423817,133,133,0,0,0
423828,70,70,0,0,0
423844,144,144,0,0,0
423864,255,255,0,0,0
423867,353,353,0,0,0
423875,246,246,0,0,0
423877,167,167,0,0,0
423896,353,353,0,0,0
423955,70,70,0,0,0
423991,35,35,0,0,0
423993,83,83,0,0,0
423998,63,63,0,0,0
424036,50,50,0,0,0
424046,359,359,0,0,0
424059,359,359,0,0,0
424062,103,103,0,0,0
424064,94,94,0,0,0
424073,282,282,0,0,0
424074,259,259,0,0,0
424075,282,282,0,0,0
424085,76,76,0,0,0
424096,359,359,0,0,0
424097,281,281,0,0,0
424108,2,2,0,0,0
424125,39,39,0,0,0
424133,25,25,0,0,0
424140,180,180,0,0,0
424148,9,9,0,0,0
424163,184,184,0,0,0
424165,246,246,0,0,0
424168,184,184,0,0,0
424179,281,281,0,0,0
424182,201,201,0,0,0
424205,193,193,0,0,0
424224,402,402,0,0,0
424242,143,143,0,0,0
424253,282,282,0,0,0
424265,359,359,0,0,0
424298,252,252,0,0,0
424313,3,3,0,0,0
424328,45,45,0,0,0
424358,171,171,0,0,0
424366,299,299,0,0,0
424376,310,310,0,0,0
424382,8,8,0,0,0
424387,121,121,0,0,0
424404,310,310,0,0,0
424429,3,3,0,0,0
424433,232,232,0,0,0
424435,151,151,0,0,0
424445,281,281,0,0,0
424458,18,18,0,0,0
424472,8,8,0,0,0
424475,85,85,0,0,0
424476,180,180,0,0,0
424481,29,29,0,0,0
424511,66,66,0,0,0
424518,168,168,0,0,0
424519,131,131,0,0,0
424530,3,3,0,0,0
424535,313,313,0,0,0
424545,315,315,0,0,0
424552,56,56,0,0,0
424555,198,198,0,0,0
424556,246,246,0,0,0
424560,402,402,0,0,0
424564,299,299,0,0,0
424565,114,114,0,0,0
424571,252,252,0,0,0
424572,158,158,0,0,0
424578,252,252,0,0,0
424579,143,143,0,0,0
424593,137,137,0,0,0
424611,4,4,0,0,0
424627,315,315,0,0,0
424630,17,17,0,0,0
424638,102,102,0,0,0
424639,299,299,0,0,0
424644,359,359,0,0,0
424666,345,345,0,0,0
424675,36,36,0,0,0
424689,29,29,0,0,0
424701,65,65,0,0,0
424710,29,29,0,0,0
424714,313,313,0,0,0
424716,83,83,0,0,0
424729,402,402,0,0,0
424735,151,151,0,0,0
424742,259,259,0,0,0
424750,143,143,0,0,0
424767,103,103,0,0,0
424776,114,114,0,0,0
424815,171,171,0,0,0
424831,17,17,0,0,0
424847,5,5,0,0,0
424859,5,5,0,0,0
424880,359,359,0,0,0
424882,102,102,0,0,0
424907,7,7,0,0,0
424918,313,313,0,0,0
424919,306,306,0,0,0
424924,353,353,0,0,0
424933,201,201,0,0,0
424938,402,402,0,0,0
424960,255,255,0,0,0
424962,143,143,0,0,0
424966,75,75,0,0,0
424969,75,75,0,0,0
424981,282,282,0,0,0
424997,137,137,0,0,0
425020,74,74,0,0,0
425028,83,83,0,0,0
425036,251,251,0,0,0
425052,102,102,0,0,0
425056,252,252,0,0,0
425058,70,70,0,0,0
425088,27,27,0,0,0
425097,25,25,0,0,0
425119,72,72,0,0,0
425126,353,353,0,0,0
425128,12,12,0,0,0
425142,282,282,0,0,0
425149,167,167,0,0,0
425160,315,315,0,0,0
425161,121,121,0,0,0
425163,102,102,0,0,0
425170,282,282,0,0,0
425173,70,70,0,0,0
425176,313,313,0,0,0
425199,315,315,0,0,0
425206,353,353,0,0,0
425207,10,10,0,0,0
425211,299,299,0,0,0
425216,313,313,0,0,0
425217,3,3,0,0,0
425224,82,82,0,0,0
425234,3,3,0,0,0
425235,114,114,0,0,0
425253,353,353,0,0,0
425265,313,313,0,0,0
425274,114,114,0,0,0
425276,255,255,0,0,0
425277,131,131,0,0,0
425283,102,102,0,0,0
425287,282,282,0,0,0
425289,143,143,0,0,0
425294,151,151,0,0,0
425298,2,2,0,0,0
425300,102,102,0,0,0
425330,259,259,0,0,0
425334,359,359,0,0,0
425356,281,281,0,0,0
425389,74,74,0,0,0
425397,83,83,0,0,0
425413,201,201,0,0,0
425421,282,282,0,0,0
425441,246,246,0,0,0
425457,9,9,0,0,0
425472,315,315,0,0,0
425478,315,315,0,0,0
425486,310,310,0,0,0
425499,353,353,0,0,0
425508,34,34,0,0,0
425514,130,130,0,0,0
425525,158,158,0,0,0
425538,132,132,0,0,0
425541,34,34,0,0,0
425545,132,132,0,0,0
425547,69,69,0,0,0
425553,114,114,0,0,0
425560,7,7,0,0,0
425565,359,359,0,0,0
425573,193,193,0,0,0
425579,313,313,0,0,0
425592,299,299,0,0,0
425595,22,22,0,0,0
425605,12,12,0,0,0
425613,66,66,0,0,0
425622,25,25,0,0,0
425640,255,255,0,0,0
425653,281,281,0,0,0
425657,313,313,0,0,0
425674,402,402,0,0,0
425693,167,167,0,0,0
425703,66,66,0,0,0
425711,310,310,0,0,0
425717,252,252,0,0,0
425721,259,259,0,0,0
425722,313,313,0,0,0
425727,121,121,0,0,0
425733,57,57,0,0,0
425754,201,201,0,0,0
425789,282,282,0,0,0
425799,246,246,0,0,0
425823,198,198,0,0,0
425829,193,193,0,0,0
425835,5,5,0,0,0
425862,252,252,0,0,0
425873,345,345,0,0,0
425892,255,255,0,0,0
425899,114,114,0,0,0
425913,56,56,0,0,0
425921,43,43,0,0,0
425923,198,198,0,0,0
425942,282,282,0,0,0
425949,143,143,0,0,0
425961,345,345,0,0,0
425967,87,87,0,0,0
425976,4,4,0,0,0
425983,310,310,0,0,0
425988,65,65,0,0,0
425998,67,67,0,0,0
426018,70,70,0,0,0
426035,184,184,0,0,0
426041,128,128,0,0,0
426060,167,167,0,0,0
426061,306,306,0,0,0
426067,310,310,0,0,0
426080,315,315,0,0,0
426086,30,30,0,0,0
426095,184,184,0,0,0
426148,82,82,0,0,0
426176,114,114,0,0,0
426178,282,282,0,0,0
426206,8,8,0,0,0
426208,252,252,0,0,0
426221,55,55,0,0,0
426235,152,152,0,0,0
426248,143,143,0,0,0
426258,299,299,0,0,0
426264,17,17,0,0,0
426267,281,281,0,0,0
426274,282,282,0,0,0
426279,25,25,0,0,0
426280,13,13,0,0,0
426291,34,34,0,0,0
426301,359,359,0,0,0
426337,281,281,0,0,0
426346,25,25,0,0,0
426361,402,402,0,0,0
426370,353,353,0,0,0
426375,114,114,0,0,0
426380,281,281,0,0,0
426383,137,137,0,0,0
426418,22,22,0,0,0
426436,158,158,0,0,0
426448,27,27,0,0,0
426458,13,13,0,0,0
426460,198,198,0,0,0
426485,313,313,0,0,0
426489,306,306,0,0,0
426504,137,137,0,0,0
426516,131,131,0,0,0
426528,15,15,0,0,0
426537,306,306,0,0,0
426557,101,101,0,0,0
426558,58,58,0,0,0
426563,25,25,0,0,0
426642,6,6,0,0,0
426648,345,345,0,0,0
426673,32,32,0,0,0
426675,184,184,0,0,0
426683,3,3,0,0,0
426687,313,313,0,0,0
426691,402,402,0,0,0
426715,114,114,0,0,0
426728,121,121,0,0,0
426741,310,310,0,0,0
426747,353,353,0,0,0
426763,259,259,0,0,0
426784,201,201,0,0,0
426821,120,120,0,0,0
426827,27,27,0,0,0
426829,193,193,0,0,0
426831,252,252,0,0,0
426838,163,163,0,0,0
426840,76,76,0,0,0
426847,22,22,0,0,0
426858,353,353,0,0,0
426863,133,133,0,0,0
426888,137,137,0,0,0
426900,75,75,0,0,0
426904,128,128,0,0,0
426919,22,22,0,0,0
426933,120,120,0,0,0
426941,252,252,0,0,0
426961,315,315,0,0,0
426974,132,132,0,0,0
426983,345,345,0,0,0
426984,10,10,0,0,0
426992,193,193,0,0,0
426999,102,102,0,0,0
427004,259,259,0,0,0
427017,6,6,0,0,0
427020,180,180,0,0,0
427021,8,8,0,0,0
427050,76,76,0,0,0
427055,12,12,0,0,0
427063,69,69,0,0,0
427076,299,299,0,0,0
427087,76,76,0,0,0
427104,315,315,0,0,0
427111,87,87,0,0,0
427117,94,94,0,0,0
427119,11,11,0,0,0
427127,71,71,0,0,0
427129,43,43,0,0,0
427155,36,36,0,0,0
427159,353,353,0,0,0
427160,74,74,0,0,0
427161,353,353,0,0,0
427162,315,315,0,0,0
427173,201,201,0,0,0
427175,113,113,0,0,0
427178,201,201,0,0,0
427180,402,402,0,0,0
427203,137,137,0,0,0
427205,180,180,0,0,0
427235,50,50,0,0,0
427244,310,310,0,0,0
427255,69,69,0,0,0
427261,74,74,0,0,0
427307,193,193,0,0,0
427311,13,13,0,0,0
427325,39,39,0,0,0
427351,184,184,0,0,0
427360,180,180,0,0,0
427363,35,35,0,0,0
427377,128,128,0,0,0
427398,306,306,0,0,0
427406,252,252,0,0,0
427407,12,12,0,0,0
427415,168,168,0,0,0
427423,255,255,0,0,0
427426,97,97,0,0,0
427430,36,36,0,0,0
427444,315,315,0,0,0
427448,299,299,0,0,0
427449,7,7,0,0,0
427457,345,345,0,0,0
427462,353,353,0,0,0
427479,299,299,0,0,0
427491,193,193,0,0,0
427498,83,83,0,0,0
427499,22,22,0,0,0
427510,299,299,0,0,0
427518,315,315,0,0,0
427535,50,50,0,0,0
427536,30,30,0,0,0
427552,402,402,0,0,0
427558,4,4,0,0,0
427560,306,306,0,0,0
427567,232,232,0,0,0
427574,120,120,0,0,0
427579,281,281,0,0,0
427586,137,137,0,0,0
427587,94,94,0,0,0
427591,232,232,0,0,0
427592,97,97,0,0,0
427595,345,345,0,0,0
427604,151,151,0,0,0
427612,14,14,0,0,0
427615,35,35,0,0,0
427620,359,359,0,0,0
427622,70,70,0,0,0
427624,359,359,0,0,0
427663,7,7,0,0,0
427664,193,193,0,0,0
427676,282,282,0,0,0
427679,353,353,0,0,0
427680,163,163,0,0,0
427687,69,69,0,0,0
427696,18,18,0,0,0
427701,353,353,0,0,0
427707,151,151,0,0,0
427718,246,246,0,0,0
427729,24,24,0,0,0
427750,23,23,0,0,0
427751,101,101,0,0,0
427764,252,252,0,0,0
427770,114,114,0,0,0
427774,17,17,0,0,0
427775,22,22,0,0,0
427788,315,315,0,0,0
427791,15,15,0,0,0
427803,167,167,0,0,0
427824,313,313,0,0,0
427826,15,15,0,0,0
427832,252,252,0,0,0
427856,246,246,0,0,0
427858,19,19,0,0,0
427865,281,281,0,0,0
427896,32,32,0,0,0
427916,18,18,0,0,0
427919,353,353,0,0,0
427946,259,259,0,0,0
427948,184,184,0,0,0
427951,345,345,0,0,0
427959,282,282,0,0,0
427961,310,310,0,0,0
427967,137,137,0,0,0
427972,232,232,0,0,0
427981,171,171,0,0,0
427986,102,102,0,0,0
427990,45,45,0,0,0
427997,282,282,0,0,0
428023,255,255,0,0,0
428027,16,16,0,0,0
428036,102,102,0,0,0
428037,402,402,0,0,0
428046,345,345,0,0,0
428049,299,299,0,0,0
428074,75,75,0,0,0
428075,7,7,0,0,0
428079,85,85,0,0,0
428081,315,315,0,0,0
428083,5,5,0,0,0
428086,34,34,0,0,0
428101,19,19,0,0,0
428108,121,121,0,0,0
428121,114,114,0,0,0
428133,255,255,0,0,0
428134,72,72,0,0,0
428136,246,246,0,0,0
428144,121,121,0,0,0
428147,310,310,0,0,0
428160,82,82,0,0,0
428197,281,281,0,0,0
428200,113,113,0,0,0
428210,402,402,0,0,0
428215,252,252,0,0,0
428221,131,131,0,0,0
428223,232,232,0,0,0
428235,315,315,0,0,0
428254,87,87,0,0,0
428259,306,306,0,0,0
428262,151,151,0,0,0
428266,85,85,0,0,0
428269,167,167,0,0,0
428276,306,306,0,0,0
428284,39,39,0,0,0
428287,143,143,0,0,0
428289,76,76,0,0,0
428298,184,184,0,0,0
428307,15,15,0,0,0
428308,255,255,0,0,0
428314,8,8,0,0,0
428315,121,121,0,0,0
428329,315,315,0,0,0
428331,315,315,0,0,0
428343,133,133,0,0,0
428345,246,246,0,0,0
428375,184,184,0,0,0
428393,353,353,0,0,0
428398,21,21,0,0,0
428413,7,7,0,0,0
428427,281,281,0,0,0
428468,113,113,0,0,0
428475,232,232,0,0,0
428481,121,121,0,0,0
428494,232,232,0,0,0
428500,44,44,0,0,0
428507,359,359,0,0,0
428517,306,306,0,0,0
428527,70,70,0,0,0
428539,310,310,0,0,0
428554,193,193,0,0,0
428555,282,282,0,0,0
428580,246,246,0,0,0
428590,137,137,0,0,0
428604,345,345,0,0,0
428618,17,17,0,0,0
428635,102,102,0,0,0
428637,17,17,0,0,0
428648,315,315,0,0,0
428652,255,255,0,0,0
428655,17,17,0,0,0
428679,282,282,0,0,0
428710,137,137,0,0,0
428727,18,18,0,0,0
428732,163,163,0,0,0
428742,255,255,0,0,0
428769,158,158,0,0,0
428770,282,282,0,0,0
428780,281,281,0,0,0
428802,402,402,0,0,0
428807,163,163,0,0,0
428814,281,281,0,0,0
428819,137,137,0,0,0
428827,359,359,0,0,0
428835,353,353,0,0,0
428844,255,255,0,0,0
428852,35,35,0,0,0
428856,56,56,0,0,0
428863,120,120,0,0,0
428864,171,171,0,0,0
428866,70,70,0,0,0
428913,94,94,0,0,0
428939,255,255,0,0,0
428944,313,313,0,0,0
428964,232,232,0,0,0
429002,50,50,0,0,0
429003,121,121,0,0,0
429007,246,246,0,0,0
429029,76,76,0,0,0
429038,313,313,0,0,0
429050,359,359,0,0,0
429063,315,315,0,0,0
429083,315,315,0,0,0
429104,23,23,0,0,0
429107,315,315,0,0,0
429114,259,259,0,0,0
429117,13,13,0,0,0
429119,11,11,0,0,0
429136,259,259,0,0,0
429141,167,167,0,0,0
429142,128,128,0,0,0
429176,345,345,0,0,0
429188,25,25,0,0,0
429205,57,57,0,0,0
429216,113,113,0,0,0
429217,22,22,0,0,0
429229,282,282,0,0,0
429230,281,281,0,0,0
429248,345,345,0,0,0
429256,143,143,0,0,0
429266,29,29,0,0,0
429283,39,39,0,0,0
429284,102,102,0,0,0
429292,143,143,0,0,0
429309,313,313,0,0,0
429324,144,144,0,0,0
429339,315,315,0,0,0
429360,74,74,0,0,0
429374,282,282,0,0,0
429384,198,198,0,0,0
429390,144,144,0,0,0
429426,4,4,0,0,0
429428,163,163,0,0,0
429434,24,24,0,0,0
429443,198,198,0,0,0
429445,306,306,0,0,0
429457,137,137,0,0,0
429475,102,102,0,0,0
429482,137,137,0,0,0
429492,353,353,0,0,0
429510,69,69,0,0,0
429533,151,151,0,0,0
429547,171,171,0,0,0
429559,359,359,0,0,0
429569,70,70,0,0,0
429571,22,22,0,0,0
429610,198,198,0,0,0
429625,20,20,0,0,0
429632,345,345,0,0,0
429635,83,83,0,0,0
429652,72,72,0,0,0
429670,82,82,0,0,0
429672,36,36,0,0,0
429685,3,3,0,0,0
429744,315,315,0,0,0
429749,103,103,0,0,0
429757,168,168,0,0,0
429760,114,114,0,0,0
429768,201,201,0,0,0
429775,315,315,0,0,0
429781,315,315,0,0,0
429786,131,131,0,0,0
429788,281,281,0,0,0
429794,306,306,0,0,0
429797,72,72,0,0,0
429799,11,11,0,0,0
429802,137,137,0,0,0
429827,255,255,0,0,0
429828,201,201,0,0,0
429847,12,12,0,0,0
429848,128,128,0,0,0
429855,251,251,0,0,0
429858,113,113,0,0,0
429869,151,151,0,0,0
429906,306,306,0,0,0
429909,313,313,0,0,0
429915,201,201,0,0,0
429922,306,306,0,0,0
429923,72,72,0,0,0
429949,171,171,0,0,0
429956,198,198,0,0,0
429976,281,281,0,0,0
429978,114,114,0,0,0
430000,55,55,0,0,0
430007,102,102,0,0,0
430012,57,57,0,0,0
430022,251,251,0,0,0
430026,255,255,0,0,0
430031,114,114,0,0,0
430033,232,232,0,0,0
430038,353,353,0,0,0
430052,25,25,0,0,0
430065,56,56,0,0,0
430077,22,22,0,0,0
430084,102,102,0,0,0
430086,306,306,0,0,0
430103,151,151,0,0,0
430127,128,128,0,0,0
430144,82,82,0,0,0
430157,232,232,0,0,0
430165,315,315,0,0,0
430180,21,21,0,0,0
430182,246,246,0,0,0
430184,281,281,0,0,0
430229,2,2,0,0,0
430237,67,67,0,0,0
430246,20,20,0,0,0
430249,251,251,0,0,0
430254,58,58,0,0,0
430268,402,402,0,0,0
430272,17,17,0,0,0
430291,102,102,0,0,0
430306,167,167,0,0,0
430354,251,251,0,0,0
430370,102,102,0,0,0
430371,113,113,0,0,0
430374,113,113,0,0,0
430383,201,201,0,0,0
430385,41,41,0,0,0
430387,137,137,0,0,0
430396,102,102,0,0,0
430405,201,201,0,0,0
430406,152,152,0,0,0
430416,201,201,0,0,0
430421,151,151,0,0,0
430427,103,103,0,0,0
430429,310,310,0,0,0
430437,158,158,0,0,0
430453,144,144,0,0,0
430454,120,120,0,0,0
430455,50,50,0,0,0
430459,163,163,0,0,0
430476,402,402,0,0,0
430479,76,76,0,0,0
430485,6,6,0,0,0
430486,10,10,0,0,0
430501,353,353,0,0,0
430502,102,102,0,0,0
430517,171,171,0,0,0
430536,56,56,0,0,0
430545,144,144,0,0,0
430556,252,252,0,0,0
430591,310,310,0,0,0
430601,131,131,0,0,0
430611,282,282,0,0,0
430612,359,359,0,0,0
430618,15,15,0,0,0
430637,121,121,0,0,0
430646,193,193,0,0,0
430656,16,16,0,0,0
430663,131,131,0,0,0
430672,299,299,0,0,0
430674,16,16,0,0,0
430676,251,251,0,0,0
430687,402,402,0,0,0
430689,133,133,0,0,0
430696,77,77,0,0,0
430720,72,72,0,0,0
430723,353,353,0,0,0
430738,114,114,0,0,0
430739,32,32,0,0,0
430755,252,252,0,0,0
430756,19,19,0,0,0
430784,353,353,0,0,0
430792,198,198,0,0,0
430818,57,57,0,0,0
430833,72,72,0,0,0
430837,310,310,0,0,0
430849,353,353,0,0,0
430850,6,6,0,0,0
430866,87,87,0,0,0
430874,184,184,0,0,0
430890,345,345,0,0,0
430900,281,281,0,0,0
430920,35,35,0,0,0
430960,131,131,0,0,0
430966,102,102,0,0,0
430967,56,56,0,0,0
430972,131,131,0,0,0
430990,24,24,0,0,0
430992,6,6,0,0,0
431005,163,163,0,0,0
431010,299,299,0,0,0
431013,20,20,0,0,0
431016,184,184,0,0,0
431020,103,103,0,0,0
431032,313,313,0,0,0
431034,345,345,0,0,0
431036,28,28,0,0,0
431050,252,252,0,0,0
431052,120,120,0,0,0
431054,402,402,0,0,0
431055,9,9,0,0,0
431058,259,259,0,0,0
431059,12,12,0,0,0
431061,5,5,0,0,0
431064,70,70,0,0,0
431065,232,232,0,0,0
431093,402,402,0,0,0
431109,299,299,0,0,0
431111,43,43,0,0,0
431114,259,259,0,0,0
431137,85,85,0,0,0
431141,102,102,0,0,0
431149,120,120,0,0,0
431152,15,15,0,0,0
431160,69,69,0,0,0
431184,282,282,0,0,0
431189,252,252,0,0,0
431198,75,75,0,0,0
431216,251,251,0,0,0
431222,402,402,0,0,0
431228,167,167,0,0,0
431242,75,75,0,0,0
431243,299,299,0,0,0
431246,44,44,0,0,0
431249,15,15,0,0,0
431256,402,402,0,0,0
431273,259,259,0,0,0
431276,20,20,0,0,0
431310,36,36,0,0,0
431321,15,15,0,0,0
431328,353,353,0,0,0
431345,315,315,0,0,0
431356,171,171,0,0,0
431357,34,34,0,0,0
431393,114,114,0,0,0
431394,29,29,0,0,0
431404,306,306,0,0,0
431406,35,35,0,0,0
431437,77,77,0,0,0
431476,75,75,0,0,0
431481,121,121,0,0,0
431485,3,3,0,0,0
431493,353,353,0,0,0
431498,402,402,0,0,0
431500,281,281,0,0,0
431511,306,306,0,0,0
431515,315,315,0,0,0
431529,310,310,0,0,0
431578,402,402,0,0,0
431582,313,313,0,0,0
431588,232,232,0,0,0
431610,306,306,0,0,0
431615,158,158,0,0,0
431618,144,144,0,0,0
431625,167,167,0,0,0
431628,255,255,0,0,0
431631,158,158,0,0,0
431638,152,152,0,0,0
431642,70,70,0,0,0
431649,103,103,0,0,0
431655,232,232,0,0,0
431666,66,66,0,0,0
431671,252,252,0,0,0
431705,72,72,0,0,0
431736,168,168,0,0,0
431751,74,74,0,0,0
431753,251,251,0,0,0
431757,5,5,0,0,0
431809,259,259,0,0,0
431812,114,114,0,0,0
431828,63,63,0,0,0
431829,281,281,0,0,0
431834,281,281,0,0,0
431838,402,402,0,0,0
431842,359,359,0,0,0
431846,143,143,0,0,0
431850,143,143,0,0,0
431878,128,128,0,0,0
431879,101,101,0,0,0
431891,133,133,0,0,0
431895,15,15,0,0,0
431926,306,306,0,0,0
431936,359,359,0,0,0
431938,76,76,0,0,0
431968,255,255,0,0,0
431983,76,76,0,0,0
432007,180,180,0,0,0
432024,17,17,0,0,0
432025,25,25,0,0,0
432029,198,198,0,0,0
432036,20,20,0,0,0
432042,353,353,0,0,0
432047,30,30,0,0,0
432052,252,252,0,0,0
432057,44,44,0,0,0
432078,359,359,0,0,0
432080,131,131,0,0,0
432083,20,20,0,0,0
432086,2,2,0,0,0
432111,39,39,0,0,0
432145,74,74,0,0,0
432147,56,56,0,0,0
432166,137,137,0,0,0
432177,131,131,0,0,0
432192,281,281,0,0,0
432194,6,6,0,0,0
432217,10,10,0,0,0
432221,402,402,0,0,0
432226,77,77,0,0,0
432235,77,77,0,0,0
432237,102,102,0,0,0
432245,184,184,0,0,0
432250,16,16,0,0,0
432254,45,45,0,0,0
432260,131,131,0,0,0
432294,131,131,0,0,0
432297,114,114,0,0,0
432301,252,252,0,0,0
432309,32,32,0,0,0
432310,11,11,0,0,0
432312,167,167,0,0,0
432316,353,353,0,0,0
432326,299,299,0,0,0
432332,35,35,0,0,0
432333,193,193,0,0,0
432355,10,10,0,0,0
432356,137,137,0,0,0
432360,143,143,0,0,0
432369,168,168,0,0,0
432379,359,359,0,0,0
432385,16,16,0,0,0
432399,310,310,0,0,0
432401,4,4,0,0,0
432412,113,113,0,0,0
432421,313,313,0,0,0
432427,1,1,0,0,0
432429,168,168,0,0,0
432446,2,2,0,0,0
432457,74,74,0,0,0
432466,315,315,0,0,0
432473,252,252,0,0,0
432478,21,21,0,0,0
432490,14,14,0,0,0
432510,18,18,0,0,0
432527,120,120,0,0,0
432528,345,345,0,0,0
432529,310,310,0,0,0
432533,151,151,0,0,0
432534,299,299,0,0,0
432554,281,281,0,0,0
432562,281,281,0,0,0
432578,6,6,0,0,0
432589,163,163,0,0,0
432615,151,151,0,0,0
432619,315,315,0,0,0
432621,246,246,0,0,0
432630,184,184,0,0,0
432634,313,313,0,0,0
432635,102,102,0,0,0
432662,201,201,0,0,0
432675,22,22,0,0,0
432676,151,151,0,0,0
432687,163,163,0,0,0
432704,82,82,0,0,0
432715,63,63,0,0,0
432731,306,306,0,0,0
432744,310,310,0,0,0
432783,201,201,0,0,0
432786,70,70,0,0,0
432804,103,103,0,0,0
432810,13,13,0,0,0
432812,11,11,0,0,0
432826,70,70,0,0,0
432843,58,58,0,0,0
432878,4,4,0,0,0
432888,63,63,0,0,0
432892,152,152,0,0,0
432901,251,251,0,0,0
432909,310,310,0,0,0
432912,13,13,0,0,0
432921,133,133,0,0,0
432935,184,184,0,0,0
432940,6,6,0,0,0
432951,313,313,0,0,0
432954,345,345,0,0,0
432957,184,184,0,0,0
432963,28,28,0,0,0
432964,70,70,0,0,0
432982,120,120,0,0,0
433016,168,168,0,0,0
433021,137,137,0,0,0
433027,184,184,0,0,0
433035,232,232,0,0,0
433042,315,315,0,0,0
433045,121,121,0,0,0
433046,121,121,0,0,0
433048,282,282,0,0,0
433059,41,41,0,0,0
433063,281,281,0,0,0
433069,180,180,0,0,0
433083,54,54,0,0,0
433098,282,282,0,0,0
433108,251,251,0,0,0
433111,184,184,0,0,0
433119,76,76,0,0,0
433149,50,50,0,0,0
433151,259,259,0,0,0
433152,114,114,0,0,0
433158,65,65,0,0,0
433162,402,402,0,0,0
433164,102,102,0,0,0
433183,83,83,0,0,0
433190,63,63,0,0,0
433198,56,56,0,0,0
433199,18,18,0,0,0
433202,201,201,0,0,0
433212,402,402,0,0,0
433251,359,359,0,0,0
433267,101,101,0,0,0
433279,57,57,0,0,0
433290,144,144,0,0,0
433298,282,282,0,0,0
433301,251,251,0,0,0
433315,14,14,0,0,0
433326,5,5,0,0,0
433327,167,167,0,0,0
433334,193,193,0,0,0
433337,402,402,0,0,0
433338,252,252,0,0,0
433407,255,255,0,0,0
433408,232,232,0,0,0
433411,184,184,0,0,0
433427,167,167,0,0,0
433434,299,299,0,0,0
433443,246,246,0,0,0
433453,306,306,0,0,0
433459,34,34,0,0,0
433467,137,137,0,0,0
433483,193,193,0,0,0
433494,72,72,0,0,0
433509,114,114,0,0,0
433518,121,121,0,0,0
433536,353,353,0,0,0
433551,102,102,0,0,0
433569,28,28,0,0,0
433592,353,353,0,0,0
433593,299,299,0,0,0
433603,34,34,0,0,0
433618,44,44,0,0,0
433631,251,251,0,0,0
433632,4,4,0,0,0
433635,353,353,0,0,0
433641,315,315,0,0,0
433654,310,310,0,0,0
433672,299,299,0,0,0
433681,19,19,0,0,0
433682,163,163,0,0,0
433689,252,252,0,0,0
433693,18,18,0,0,0
433700,114,114,0,0,0
433701,310,310,0,0,0
433705,251,251,0,0,0
433712,345,345,0,0,0
433741,87,87,0,0,0
433746,102,102,0,0,0
433748,72,72,0,0,0
433752,359,359,0,0,0
433772,75,75,0,0,0
433791,3,3,0,0,0
433828,83,83,0,0,0
433839,252,252,0,0,0
433852,120,120,0,0,0
433866,10,10,0,0,0
433913,299,299,0,0,0
433923,167,167,0,0,0
433930,299,299,0,0,0
433940,171,171,0,0,0
433954,402,402,0,0,0
433960,310,310,0,0,0
433972,18,18,0,0,0
433975,259,259,0,0,0
433979,315,315,0,0,0
433989,201,201,0,0,0
433990,137,137,0,0,0
433991,11,11,0,0,0
434000,281,281,0,0,0
434002,130,130,0,0,0
434003,65,65,0,0,0
434022,252,252,0,0,0
434027,133,133,0,0,0
434053,35,35,0,0,0
434058,345,345,0,0,0
434061,345,345,0,0,0
434065,171,171,0,0,0
434069,151,151,0,0,0
434078,18,18,0,0,0
434079,69,69,0,0,0
434083,158,158,0,0,0
434087,402,402,0,0,0
434096,58,58,0,0,0
434108,56,56,0,0,0
434116,102,102,0,0,0
434120,54,54,0,0,0
434126,71,71,0,0,0
434127,113,113,0,0,0
434136,313,313,0,0,0
434145,20,20,0,0,0
434146,167,167,0,0,0
434177,315,315,0,0,0
434190,43,43,0,0,0
434201,151,151,0,0,0
434206,133,133,0,0,0
434209,232,232,0,0,0
434212,163,163,0,0,0
434229,44,44,0,0,0
434246,87,87,0,0,0
434249,315,315,0,0,0
434262,345,345,0,0,0
434268,103,103,0,0,0
434276,102,102,0,0,0
434280,152,152,0,0,0
434296,345,345,0,0,0
434298,359,359,0,0,0
434302,282,282,0,0,0
434329,71,71,0,0,0
434337,16,16,0,0,0
434341,252,252,0,0,0
434355,345,345,0,0,0
434361,94,94,0,0,0
434389,345,345,0,0,0
434394,14,14,0,0,0
434399,345,345,0,0,0
434456,69,69,0,0,0
434458,50,50,0,0,0
434463,22,22,0,0,0
434464,55,55,0,0,0
434469,7,7,0,0,0
434489,83,83,0,0,0
434499,114,114,0,0,0
434509,56,56,0,0,0
434518,353,353,0,0,0
434519,167,167,0,0,0
434527,282,282,0,0,0
434538,171,171,0,0,0
434542,315,315,0,0,0
434550,7,7,0,0,0
434551,168,168,0,0,0
434557,158,158,0,0,0
434567,184,184,0,0,0
434572,201,201,0,0,0
434574,315,315,0,0,0
434577,35,35,0,0,0
434579,7,7,0,0,0
434584,11,11,0,0,0
434597,75,75,0,0,0
434603,315,315,0,0,0
434604,121,121,0,0,0
434625,8,8,0,0,0
434640,14,14,0,0,0
434648,39,39,0,0,0
434682,184,184,0,0,0
434683,402,402,0,0,0
434689,114,114,0,0,0
434702,282,282,0,0,0
434705,299,299,0,0,0
434713,7,7,0,0,0
434717,18,18,0,0,0
434737,44,44,0,0,0
434739,168,168,0,0,0
434751,255,255,0,0,0
434754,120,120,0,0,0
434758,402,402,0,0,0
434759,120,120,0,0,0
434762,20,20,0,0,0
434766,120,120,0,0,0
434767,67,67,0,0,0
434771,1,1,0,0,0
434787,7,7,0,0,0
434789,353,353,0,0,0
434831,34,34,0,0,0
434832,402,402,0,0,0
434840,74,74,0,0,0
434843,25,25,0,0,0
434844,345,345,0,0,0
434848,144,144,0,0,0
434860,63,63,0,0,0
434894,114,114,0,0,0
434895,310,310,0,0,0
434935,24,24,0,0,0
434939,114,114,0,0,0
434953,102,102,0,0,0
434956,151,151,0,0,0
434957,252,252,0,0,0
434963,281,281,0,0,0
434977,103,103,0,0,0
434983,128,128,0,0,0
434988,82,82,0,0,0
434997,252,252,0,0,0
435016,87,87,0,0,0
435018,345,345,0,0,0
435021,121,121,0,0,0
435029,299,299,0,0,0
435043,315,315,0,0,0
435052,76,76,0,0,0
435061,251,251,0,0,0
435073,50,50,0,0,0
435081,17,17,0,0,0
435093,310,310,0,0,0
435095,74,74,0,0,0
435096,158,158,0,0,0
435123,171,171,0,0,0
435140,313,313,0,0,0
435143,23,23,0,0,0
435161,27,27,0,0,0
435163,282,282,0,0,0
435164,75,75,0,0,0
435171,345,345,0,0,0
435192,251,251,0,0,0
435206,193,193,0,0,0
435210,15,15,0,0,0
435213,7,7,0,0,0
435233,193,193,0,0,0
435243,71,71,0,0,0
435244,132,132,0,0,0
435249,65,65,0,0,0
435254,402,402,0,0,0
435282,20,20,0,0,0
435289,151,151,0,0,0
435308,193,193,0,0,0
435338,128,128,0,0,0
435342,171,171,0,0,0
435350,299,299,0,0,0
435356,22,22,0,0,0
435382,76,76,0,0,0
435395,252,252,0,0,0
435396,255,255,0,0,0
435398,353,353,0,0,0
435402,102,102,0,0,0
435418,43,43,0,0,0
435422,76,76,0,0,0
435444,151,151,0,0,0
435447,167,167,0,0,0
435450,184,184,0,0,0
435454,353,353,0,0,0
435456,101,101,0,0,0
435465,20,20,0,0,0
435467,353,353,0,0,0
435491,315,315,0,0,0
435498,259,259,0,0,0
435503,3,3,0,0,0
435504,76,76,0,0,0
435509,251,251,0,0,0
435510,259,259,0,0,0
435513,167,167,0,0,0
435514,102,102,0,0,0
435516,402,402,0,0,0
435520,55,55,0,0,0
435525,144,144,0,0,0
435551,255,255,0,0,0
435568,255,255,0,0,0
435573,345,345,0,0,0
435578,259,259,0,0,0
435600,167,167,0,0,0
435606,10,10,0,0,0
435617,259,259,0,0,0
435641,76,76,0,0,0
435655,97,97,0,0,0
435689,259,259,0,0,0
435690,74,74,0,0,0
435692,198,198,0,0,0
435696,137,137,0,0,0
435697,102,102,0,0,0
435709,137,137,0,0,0
435730,315,315,0,0,0
435734,102,102,0,0,0
435745,8,8,0,0,0
435761,20,20,0,0,0
435768,114,114,0,0,0
435770,193,193,0,0,0
435783,252,252,0,0,0
435788,402,402,0,0,0
435806,198,198,0,0,0
435807,259,259,0,0,0
435811,34,34,0,0,0
435826,259,259,0,0,0
435832,76,76,0,0,0
435840,232,232,0,0,0
435857,76,76,0,0,0
435875,171,171,0,0,0
435884,310,310,0,0,0
435896,353,353,0,0,0
435899,23,23,0,0,0
435901,281,281,0,0,0
435908,315,315,0,0,0
435912,232,232,0,0,0
435945,71,71,0,0,0
435949,83,83,0,0,0
435952,345,345,0,0,0
435953,3,3,0,0,0
435956,251,251,0,0,0
435965,313,313,0,0,0
435972,255,255,0,0,0
435997,35,35,0,0,0
436007,152,152,0,0,0
436020,359,359,0,0,0
436038,402,402,0,0,0
436050,246,246,0,0,0
436069,193,193,0,0,0
436100,25,25,0,0,0
436118,359,359,0,0,0
436125,402,402,0,0,0
436148,101,101,0,0,0
436190,3,3,0,0,0
436194,128,128,0,0,0
436214,259,259,0,0,0
436219,121,121,0,0,0
436234,137,137,0,0,0
436241,133,133,0,0,0
436246,184,184,0,0,0
436250,252,252,0,0,0
436253,167,167,0,0,0
436281,72,72,0,0,0
436309,402,402,0,0,0
436318,143,143,0,0,0
436330,171,171,0,0,0
436339,232,232,0,0,0
436352,131,131,0,0,0
436355,281,281,0,0,0
436358,3,3,0,0,0
436372,44,44,0,0,0
436374,345,345,0,0,0
436377,22,22,0,0,0
436383,259,259,0,0,0
436391,259,259,0,0,0
436395,232,232,0,0,0
436404,101,101,0,0,0
436406,35,35,0,0,0
436407,315,315,0,0,0
436420,315,315,0,0,0
436428,353,353,0,0,0
436435,163,163,0,0,0
436451,101,101,0,0,0
436465,85,85,0,0,0
436473,315,315,0,0,0
436485,144,144,0,0,0
436495,167,167,0,0,0
436502,198,198,0,0,0
436506,15,15,0,0,0
436512,359,359,0,0,0
436518,255,255,0,0,0
436522,345,345,0,0,0
436571,299,299,0,0,0
436582,152,152,0,0,0
436588,402,402,0,0,0
436612,83,83,0,0,0
436613,10,10,0,0,0
436615,76,76,0,0,0
436639,345,345,0,0,0
436658,82,82,0,0,0
436659,18,18,0,0,0
436662,6,6,0,0,0
436672,114,114,0,0,0
436679,282,282,0,0,0
436690,144,144,0,0,0
436696,246,246,0,0,0
436698,72,72,0,0,0
436701,353,353,0,0,0
436702,137,137,0,0,0
436725,299,299,0,0,0
436727,132,132,0,0,0
436749,201,201,0,0,0
436773,313,313,0,0,0
436779,163,163,0,0,0
436786,2,2,0,0,0
436788,198,198,0,0,0
436792,75,75,0,0,0
436813,43,43,0,0,0
436818,82,82,0,0,0
436823,143,143,0,0,0
436832,152,152,0,0,0
436836,66,66,0,0,0
436845,19,19,0,0,0
436846,158,158,0,0,0
436849,306,306,0,0,0
436851,402,402,0,0,0
436855,2,2,0,0,0
436858,171,171,0,0,0
436859,6,6,0,0,0
436865,281,281,0,0,0
436870,402,402,0,0,0
436892,402,402,0,0,0
436894,167,167,0,0,0
436900,353,353,0,0,0
436905,137,137,0,0,0
436914,232,232,0,0,0
436921,144,144,0,0,0
436931,56,56,0,0,0
436938,180,180,0,0,0
436943,137,137,0,0,0
436953,259,259,0,0,0
436993,193,193,0,0,0
436994,151,151,0,0,0
436999,144,144,0,0,0
437013,402,402,0,0,0
437018,255,255,0,0,0
437043,97,97,0,0,0
437055,299,299,0,0,0
437061,102,102,0,0,0
437065,74,74,0,0,0
437069,1,1,0,0,0
437072,168,168,0,0,0
437103,87,87,0,0,0
437136,131,131,0,0,0
437145,252,252,0,0,0
437159,255,255,0,0,0
437174,167,167,0,0,0
437207,168,168,0,0,0
437225,313,313,0,0,0
437227,121,121,0,0,0
437243,152,152,0,0,0
437246,180,180,0,0,0
437252,313,313,0,0,0
437259,353,353,0,0,0
437275,16,16,0,0,0
437292,184,184,0,0,0
437297,184,184,0,0,0
437301,8,8,0,0,0
437304,232,232,0,0,0
437341,67,67,0,0,0
437356,198,198,0,0,0
437370,151,151,0,0,0
437380,121,121,0,0,0
437383,6,6,0,0,0
437389,353,353,0,0,0
437395,18,18,0,0,0
437396,281,281,0,0,0
437406,359,359,0,0,0
437411,30,30,0,0,0
437444,281,281,0,0,0
437460,133,133,0,0,0
437473,359,359,0,0,0
437494,313,313,0,0,0
437501,255,255,0,0,0
437502,315,315,0,0,0
437509,41,41,0,0,0
437525,15,15,0,0,0
437528,77,77,0,0,0
437531,313,313,0,0,0
437532,76,76,0,0,0
437551,130,130,0,0,0
437559,345,345,0,0,0
437562,102,102,0,0,0
437594,143,143,0,0,0
437613,14,14,0,0,0
437615,131,131,0,0,0
437631,35,35,0,0,0
437645,163,163,0,0,0
437649,6,6,0,0,0
437652,36,36,0,0,0
437664,168,168,0,0,0
437667,82,82,0,0,0
437672,137,137,0,0,0
437689,299,299,0,0,0
437691,19,19,0,0,0
437693,353,353,0,0,0
437714,313,313,0,0,0
437718,28,28,0,0,0
437763,133,133,0,0,0
437774,137,137,0,0,0
437795,120,120,0,0,0
437800,5,5,0,0,0
437809,102,102,0,0,0
437812,40,40,0,0,0
437813,402,402,0,0,0
437821,67,67,0,0,0
437825,6,6,0,0,0
437834,20,20,0,0,0
437859,152,152,0,0,0
437867,310,310,0,0,0
437873,58,58,0,0,0
437884,22,22,0,0,0
437903,184,184,0,0,0
437915,281,281,0,0,0
437936,83,83,0,0,0
437947,251,251,0,0,0
437961,66,66,0,0,0
437976,11,11,0,0,0
437991,77,77,0,0,0
437996,102,102,0,0,0
438010,359,359,0,0,0
438017,252,252,0,0,0
438036,402,402,0,0,0
438038,131,131,0,0,0
438039,281,281,0,0,0
438049,121,121,0,0,0
438073,402,402,0,0,0
438084,121,121,0,0,0
438111,252,252,0,0,0
438134,232,232,0,0,0
438143,246,246,0,0,0
438152,27,27,0,0,0
438156,152,152,0,0,0
438164,282,282,0,0,0
438167,101,101,0,0,0
438175,359,359,0,0,0
438179,130,130,0,0,0
438186,11,11,0,0,0
438189,282,282,0,0,0
438211,29,29,0,0,0
438238,14,14,0,0,0
438241,114,114,0,0,0
438248,94,94,0,0,0
438260,74,74,0,0,0
438276,252,252,0,0,0
438286,353,353,0,0,0
438288,113,113,0,0,0
438337,137,137,0,0,0
438345,34,34,0,0,0
438352,36,36,0,0,0
438357,315,315,0,0,0
438358,180,180,0,0,0
438369,35,35,0,0,0
438377,158,158,0,0,0
438381,94,94,0,0,0
438396,353,353,0,0,0
438407,137,137,0,0,0
438439,144,144,0,0,0
438442,24,24,0,0,0
438459,75,75,0,0,0
438463,82,82,0,0,0
438473,184,184,0,0,0
438495,345,345,0,0,0
438502,345,345,0,0,0
438514,7,7,0,0,0
438517,137,137,0,0,0
438522,25,25,0,0,0
438523,7,7,0,0,0
438536,232,232,0,0,0
438540,36,36,0,0,0
438545,71,71,0,0,0
438565,198,198,0,0,0
438566,128,128,0,0,0
438569,251,251,0,0,0
438578,94,94,0,0,0
438597,14,14,0,0,0
438601,120,120,0,0,0
438634,299,299,0,0,0
438636,45,45,0,0,0
438649,151,151,0,0,0
438660,12,12,0,0,0
438687,259,259,0,0,0
438690,12,12,0,0,0
438693,128,128,0,0,0
438697,171,171,0,0,0
438716,402,402,0,0,0
438726,17,17,0,0,0
438730,168,168,0,0,0
438739,114,114,0,0,0
438747,76,76,0,0,0
438759,353,353,0,0,0
438762,54,54,0,0,0
438775,69,69,0,0,0
438803,232,232,0,0,0
438809,18,18,0,0,0
438818,18,18,0,0,0
438819,313,313,0,0,0
438822,10,10,0,0,0
438823,167,167,0,0,0
438838,75,75,0,0,0
438844,252,252,0,0,0
438862,114,114,0,0,0
438920,29,29,0,0,0
438933,315,315,0,0,0
438957,299,299,0,0,0
438958,94,94,0,0,0
438959,315,315,0,0,0
438970,359,359,0,0,0
438977,402,402,0,0,0
438983,151,151,0,0,0
438985,13,13,0,0,0
438986,121,121,0,0,0
438993,201,201,0,0,0
439003,12,12,0,0,0
439008,6,6,0,0,0
439010,255,255,0,0,0
439014,143,143,0,0,0
439016,94,94,0,0,0
439029,252,252,0,0,0
439037,65,65,0,0,0
439068,310,310,0,0,0
439098,20,20,0,0,0
439139,402,402,0,0,0
439175,54,54,0,0,0
439188,184,184,0,0,0
439191,36,36,0,0,0
439209,72,72,0,0,0
439210,163,163,0,0,0
439211,76,76,0,0,0
439217,133,133,0,0,0
439218,128,128,0,0,0
439223,251,251,0,0,0
439229,171,171,0,0,0
439235,158,158,0,0,0
439249,402,402,0,0,0
439253,315,315,0,0,0
439255,198,198,0,0,0
439260,29,29,0,0,0
439272,144,144,0,0,0
439273,55,55,0,0,0
439290,102,102,0,0,0
439292,151,151,0,0,0
439316,306,306,0,0,0
439319,20,20,0,0,0
439321,306,306,0,0,0
439327,353,353,0,0,0
439339,102,102,0,0,0
439341,43,43,0,0,0
439345,251,251,0,0,0
439354,32,32,0,0,0
439359,158,158,0,0,0
439367,15,15,0,0,0
439372,29,29,0,0,0
439374,144,144,0,0,0
439384,246,246,0,0,0
439390,13,13,0,0,0
439400,144,144,0,0,0
439403,7,7,0,0,0
439414,75,75,0,0,0
439415,359,359,0,0,0
439419,310,310,0,0,0
439430,113,113,0,0,0
439436,54,54,0,0,0
439442,17,17,0,0,0
439450,67,67,0,0,0
439485,121,121,0,0,0
439493,76,76,0,0,0
439498,18,18,0,0,0
439513,201,201,0,0,0
439528,151,151,0,0,0
439532,168,168,0,0,0
439540,281,281,0,0,0
439541,43,43,0,0,0
439543,35,35,0,0,0
439548,34,34,0,0,0
439560,359,359,0,0,0
439603,345,345,0,0,0
439607,29,29,0,0,0
439619,25,25,0,0,0
439620,120,120,0,0,0
439624,114,114,0,0,0
439633,55,55,0,0,0
439635,18,18,0,0,0
439637,55,55,0,0,0
439638,21,21,0,0,0
439639,85,85,0,0,0
439642,65,65,0,0,0
439645,198,198,0,0,0
439660,163,163,0,0,0
439665,193,193,0,0,0
439674,306,306,0,0,0
439698,18,18,0,0,0
439702,121,121,0,0,0
439706,128,128,0,0,0
439755,8,8,0,0,0
439769,251,251,0,0,0
439779,102,102,0,0,0
439789,201,201,0,0,0
439795,252,252,0,0,0
439819,306,306,0,0,0
439824,7,7,0,0,0
439831,282,282,0,0,0
439870,63,63,0,0,0
439883,299,299,0,0,0
439895,167,167,0,0,0
439915,246,246,0,0,0
439931,40,40,0,0,0
439933,201,201,0,0,0
439947,12,12,0,0,0
439960,168,168,0,0,0
439980,252,252,0,0,0
439990,82,82,0,0,0
439993,102,102,0,0,0
439995,25,25,0,0,0
440002,34,34,0,0,0
440023,137,137,0,0,0
440024,35,35,0,0,0
440040,201,201,0,0,0
440043,180,180,0,0,0
440053,152,152,0,0,0
440066,193,193,0,0,0
440074,180,180,0,0,0
440076,353,353,0,0,0
440084,137,137,0,0,0
440094,16,16,0,0,0
440100,137,137,0,0,0
440114,102,102,0,0,0
440117,402,402,0,0,0
440119,299,299,0,0,0
440122,137,137,0,0,0
440141,402,402,0,0,0
440205,313,313,0,0,0
440210,70,70,0,0,0
440220,23,23,0,0,0
440221,299,299,0,0,0
440227,255,255,0,0,0
440241,21,21,0,0,0
440245,193,193,0,0,0
440246,167,167,0,0,0
440252,180,180,0,0,0
440273,345,345,0,0,0
440274,72,72,0,0,0
440282,299,299,0,0,0
440313,359,359,0,0,0
440317,17,17,0,0,0
440328,299,299,0,0,0
440339,201,201,0,0,0
440340,184,184,0,0,0
440349,137,137,0,0,0
440351,144,144,0,0,0
440359,163,163,0,0,0
440375,83,83,0,0,0
440378,313,313,0,0,0
440397,10,10,0,0,0
440411,315,315,0,0,0
440433,310,310,0,0,0
440434,32,32,0,0,0
440450,232,232,0,0,0
440457,70,70,0,0,0
440458,2,2,0,0,0
440464,180,180,0,0,0
440468,353,353,0,0,0
440488,345,345,0,0,0
440503,255,255,0,0,0
440517,198,198,0,0,0
440557,94,94,0,0,0
440596,34,34,0,0,0
440598,315,315,0,0,0
440602,313,313,0,0,0
440626,152,152,0,0,0
440627,282,282,0,0,0
440634,259,259,0,0,0
440647,75,75,0,0,0
440649,39,39,0,0,0
440674,102,102,0,0,0
440684,101,101,0,0,0
440686,54,54,0,0,0
440728,306,306,0,0,0
440732,18,18,0,0,0
440743,2,2,0,0,0
440761,306,306,0,0,0
440773,310,310,0,0,0
440777,345,345,0,0,0
440820,74,74,0,0,0
440821,131,131,0,0,0
440822,151,151,0,0,0
440852,8,8,0,0,0
440858,201,201,0,0,0
440860,130,130,0,0,0
440865,143,143,0,0,0
440880,281,281,0,0,0
440881,137,137,0,0,0
440883,232,232,0,0,0
440887,144,144,0,0,0
440904,198,198,0,0,0
440914,152,152,0,0,0
440920,67,67,0,0,0
440948,8,8,0,0,0
440959,201,201,0,0,0
440983,143,143,0,0,0
440993,402,402,0,0,0
440994,152,152,0,0,0
441010,54,54,0,0,0
441025,133,133,0,0,0
441027,252,252,0,0,0
441031,246,246,0,0,0
441033,402,402,0,0,0
441070,24,24,0,0,0
441071,1,1,0,0,0
441072,74,74,0,0,0
441081,76,76,0,0,0
441082,144,144,0,0,0
441100,55,55,0,0,0
441103,163,163,0,0,0
441130,255,255,0,0,0
441137,402,402,0,0,0
441139,3,3,0,0,0
441146,131,131,0,0,0
441154,114,114,0,0,0
441163,193,193,0,0,0
441164,180,180,0,0,0
441196,281,281,0,0,0
441217,3,3,0,0,0
441222,255,255,0,0,0
441223,133,133,0,0,0
441248,55,55,0,0,0
441255,82,82,0,0,0
441271,66,66,0,0,0
441272,102,102,0,0,0
441281,168,168,0,0,0
441293,101,101,0,0,0
441307,6,6,0,0,0
441318,13,13,0,0,0
441322,184,184,0,0,0
441369,67,67,0,0,0
441374,133,133,0,0,0
441384,5,5,0,0,0
441385,281,281,0,0,0
441395,168,168,0,0,0
441401,168,168,0,0,0
441405,198,198,0,0,0
441417,101,101,0,0,0
441426,137,137,0,0,0
441432,97,97,0,0,0
441434,152,152,0,0,0
441446,168,168,0,0,0
441468,201,201,0,0,0
441485,152,152,0,0,0
441501,56,56,0,0,0
441509,299,299,0,0,0
441512,198,198,0,0,0
441515,201,201,0,0,0
441538,246,246,0,0,0
441552,310,310,0,0,0
441557,310,310,0,0,0
441558,402,402,0,0,0
441569,281,281,0,0,0
441593,184,184,0,0,0
441598,180,180,0,0,0
441603,21,21,0,0,0
441604,402,402,0,0,0
441608,402,402,0,0,0
441614,353,353,0,0,0
441627,168,168,0,0,0
441646,171,171,0,0,0
441663,121,121,0,0,0
441667,24,24,0,0,0
441669,94,94,0,0,0
441670,19,19,0,0,0
441688,306,306,0,0,0
441695,77,77,0,0,0
441710,158,158,0,0,0
441720,168,168,0,0,0
441726,18,18,0,0,0
441730,255,255,0,0,0
441759,10,10,0,0,0
441779,36,36,0,0,0
441794,6,6,0,0,0
441806,9,9,0,0,0
441808,44,44,0,0,0
441840,259,259,0,0,0
441846,101,101,0,0,0
441848,306,306,0,0,0
441851,281,281,0,0,0
441852,16,16,0,0,0
441860,43,43,0,0,0
441869,168,168,0,0,0
441908,158,158,0,0,0
441910,24,24,0,0,0
441918,143,143,0,0,0
441924,313,313,0,0,0
441932,152,152,0,0,0
441937,4,4,0,0,0
441943,359,359,0,0,0
441951,353,353,0,0,0
441952,130,130,0,0,0
441958,353,353,0,0,0
441959,255,255,0,0,0
441966,74,74,0,0,0
441967,15,15,0,0,0
441981,6,6,0,0,0
442005,281,281,0,0,0
442019,259,259,0,0,0
442025,131,131,0,0,0
442030,359,359,0,0,0
442032,121,121,0,0,0
442034,65,65,0,0,0
442054,5,5,0,0,0
442107,151,151,0,0,0
442108,71,71,0,0,0
442109,144,144,0,0,0
442120,30,30,0,0,0
442124,171,171,0,0,0
442132,259,259,0,0,0
442145,15,15,0,0,0
442148,83,83,0,0,0
442152,101,101,0,0,0
442157,299,299,0,0,0
442173,144,144,0,0,0
442187,75,75,0,0,0
442204,232,232,0,0,0
442215,193,193,0,0,0
442226,353,353,0,0,0
442255,353,353,0,0,0
442284,251,251,0,0,0
442292,180,180,0,0,0
442293,198,198,0,0,0
442294,24,24,0,0,0
442304,402,402,0,0,0
442307,114,114,0,0,0
442355,94,94,0,0,0
442376,246,246,0,0,0
442382,402,402,0,0,0
442386,313,313,0,0,0
442392,102,102,0,0,0
442431,2,2,0,0,0
442439,359,359,0,0,0
442451,65,65,0,0,0
442463,259,259,0,0,0
442483,82,82,0,0,0
442485,310,310,0,0,0
442495,65,65,0,0,0
442496,74,74,0,0,0
442503,310,310,0,0,0
442511,114,114,0,0,0
442520,137,137,0,0,0
442526,97,97,0,0,0
442541,137,137,0,0,0
442542,121,121,0,0,0
442546,69,69,0,0,0
442556,19,19,0,0,0
442563,133,133,0,0,0
442564,67,67,0,0,0
442572,282,282,0,0,0
442581,102,102,0,0,0
442582,345,345,0,0,0
442583,40,40,0,0,0
442610,299,299,0,0,0
442624,168,168,0,0,0
442655,144,144,0,0,0
442675,345,345,0,0,0
442676,310,310,0,0,0
442683,76,76,0,0,0
442690,12,12,0,0,0
442700,143,143,0,0,0
442715,251,251,0,0,0
442719,82,82,0,0,0
442734,201,201,0,0,0
442738,29,29,0,0,0
442750,87,87,0,0,0
442757,152,152,0,0,0
442760,299,299,0,0,0
442774,151,151,0,0,0
442779,315,315,0,0,0
442789,345,345,0,0,0
442795,29,29,0,0,0
442800,50,50,0,0,0
442815,246,246,0,0,0
442821,76,76,0,0,0
442847,313,313,0,0,0
442851,5,5,0,0,0
442856,55,55,0,0,0
442863,345,345,0,0,0
442865,171,171,0,0,0
442866,252,252,0,0,0
442898,282,282,0,0,0
442908,6,6,0,0,0
442911,58,58,0,0,0
442916,193,193,0,0,0
442945,151,151,0,0,0
442956,345,345,0,0,0
442967,313,313,0,0,0
442994,359,359,0,0,0
443005,114,114,0,0,0
443006,83,83,0,0,0
443007,246,246,0,0,0
443019,24,24,0,0,0
443056,306,306,0,0,0
443057,17,17,0,0,0
443072,87,87,0,0,0
443078,74,74,0,0,0
443085,246,246,0,0,0
443110,201,201,0,0,0
443113,143,143,0,0,0
443151,144,144,0,0,0
443168,121,121,0,0,0
443227,345,345,0,0,0
443237,14,14,0,0,0
443257,345,345,0,0,0
443258,12,12,0,0,0
443264,299,299,0,0,0
443265,17,17,0,0,0
443277,184,184,0,0,0
443296,171,171,0,0,0
443309,11,11,0,0,0
443335,315,315,0,0,0
443339,3,3,0,0,0
443342,353,353,0,0,0
443345,137,137,0,0,0
443364,282,282,0,0,0
443381,345,345,0,0,0
443389,72,72,0,0,0
443391,345,345,0,0,0
443393,137,137,0,0,0
443425,251,251,0,0,0
443427,74,74,0,0,0
443443,198,198,0,0,0
443444,251,251,0,0,0
443461,184,184,0,0,0
443463,299,299,0,0,0
443466,259,259,0,0,0
443468,259,259,0,0,0
443502,259,259,0,0,0
443503,36,36,0,0,0
443507,13,13,0,0,0
443518,252,252,0,0,0
443557,345,345,0,0,0
443598,121,121,0,0,0
443616,281,281,0,0,0
443633,55,55,0,0,0
443635,282,282,0,0,0
443640,15,15,0,0,0
443653,359,359,0,0,0
443660,132,132,0,0,0
443667,151,151,0,0,0
443669,313,313,0,0,0
443673,34,34,0,0,0
443681,76,76,0,0,0
443686,120,120,0,0,0
443698,353,353,0,0,0
443700,252,252,0,0,0
443713,299,299,0,0,0
443728,315,315,0,0,0
443777,353,353,0,0,0
443778,66,66,0,0,0
443784,353,353,0,0,0
443790,5,5,0,0,0
443794,25,25,0,0,0
443803,5,5,0,0,0
443824,193,193,0,0,0
443827,76,76,0,0,0
443832,144,144,0,0,0
443833,306,306,0,0,0
443835,359,359,0,0,0
443836,34,34,0,0,0
443843,77,77,0,0,0
443866,353,353,0,0,0
443894,87,87,0,0,0
443897,310,310,0,0,0
443900,55,55,0,0,0
443914,180,180,0,0,0
443915,259,259,0,0,0
443947,114,114,0,0,0
443954,24,24,0,0,0
443957,4,4,0,0,0
443963,201,201,0,0,0
443972,39,39,0,0,0
443973,152,152,0,0,0
444019,184,184,0,0,0
444026,313,313,0,0,0
444039,114,114,0,0,0
444045,144,144,0,0,0
444099,20,20,0,0,0
444111,152,152,0,0,0
444166,20,20,0,0,0
444171,121,121,0,0,0
444175,315,315,0,0,0
444177,359,359,0,0,0
444191,101,101,0,0,0
444199,11,11,0,0,0
444203,168,168,0,0,0
444213,255,255,0,0,0
444220,310,310,0,0,0
444246,402,402,0,0,0
444267,120,120,0,0,0
444272,130,130,0,0,0
444273,184,184,0,0,0
444274,359,359,0,0,0
444290,29,29,0,0,0
444301,34,34,0,0,0
444310,56,56,0,0,0
444317,71,71,0,0,0
444324,66,66,0,0,0
444326,102,102,0,0,0
444330,69,69,0,0,0
444357,180,180,0,0,0
444359,6,6,0,0,0
444386,313,313,0,0,0
444396,102,102,0,0,0
444398,120,120,0,0,0
444409,353,353,0,0,0
444411,82,82,0,0,0
444420,259,259,0,0,0
444421,171,171,0,0,0
444436,103,103,0,0,0
444450,20,20,0,0,0
444458,29,29,0,0,0
444464,151,151,0,0,0
444466,56,56,0,0,0
444488,151,151,0,0,0
444496,180,180,0,0,0
444501,102,102,0,0,0
444522,193,193,0,0,0
444525,313,313,0,0,0
444566,133,133,0,0,0
444574,315,315,0,0,0
444581,167,167,0,0,0
444583,198,198,0,0,0
444593,180,180,0,0,0
444604,251,251,0,0,0
444615,16,16,0,0,0
444636,193,193,0,0,0
444638,171,171,0,0,0
444646,6,6,0,0,0
444679,7,7,0,0,0
444681,232,232,0,0,0
444709,167,167,0,0,0
444710,359,359,0,0,0
444729,180,180,0,0,0
444740,71,71,0,0,0
444749,23,23,0,0,0
444752,20,20,0,0,0
444754,151,151,0,0,0
444759,315,315,0,0,0
444770,152,152,0,0,0
444773,402,402,0,0,0
444798,121,121,0,0,0
444803,44,44,0,0,0
444804,158,158,0,0,0
444839,353,353,0,0,0
444841,282,282,0,0,0
444842,315,315,0,0,0
444867,10,10,0,0,0
444868,10,10,0,0,0
444877,359,359,0,0,0
444919,85,85,0,0,0
444922,193,193,0,0,0
444924,151,151,0,0,0
444929,34,34,0,0,0
444959,299,299,0,0,0
444960,201,201,0,0,0
444972,345,345,0,0,0
444974,167,167,0,0,0
445003,168,168,0,0,0
445009,310,310,0,0,0
445015,137,137,0,0,0
445030,57,57,0,0,0
445038,11,11,0,0,0
445041,17,17,0,0,0
445060,29,29,0,0,0
445063,2,2,0,0,0
445073,3,3,0,0,0
445074,281,281,0,0,0
445091,168,168,0,0,0
445107,1,1,0,0,0
445119,45,45,0,0,0
445136,121,121,0,0,0
445141,97,97,0,0,0
445146,41,41,0,0,0
445154,313,313,0,0,0
445165,310,310,0,0,0
445168,359,359,0,0,0
445169,10,10,0,0,0
445172,70,70,0,0,0
445175,97,97,0,0,0
445206,8,8,0,0,0
445219,255,255,0,0,0
445228,16,16,0,0,0
445230,10,10,0,0,0
445237,152,152,0,0,0
445247,282,282,0,0,0
445251,9,9,0,0,0
445266,299,299,0,0,0
445268,11,11,0,0,0
445271,102,102,0,0,0
445273,246,246,0,0,0
445286,102,102,0,0,0
445292,76,76,0,0,0
445307,306,306,0,0,0
445348,102,102,0,0,0
445366,168,168,0,0,0
445421,180,180,0,0,0
445423,232,232,0,0,0
445434,102,102,0,0,0
445437,45,45,0,0,0
445439,306,306,0,0,0
445445,114,114,0,0,0
445448,259,259,0,0,0
445451,15,15,0,0,0
445461,281,281,0,0,0
445462,17,17,0,0,0
445468,15,15,0,0,0
445486,76,76,0,0,0
445506,353,353,0,0,0
445507,10,10,0,0,0
445512,137,137,0,0,0
445514,113,113,0,0,0
445528,83,83,0,0,0
445550,94,94,0,0,0
445551,232,232,0,0,0
445572,255,255,0,0,0
445576,315,315,0,0,0
445579,75,75,0,0,0
445593,313,313,0,0,0
445605,402,402,0,0,0
445606,7,7,0,0,0
445625,103,103,0,0,0
445634,7,7,0,0,0
445656,180,180,0,0,0
445670,259,259,0,0,0
445677,102,102,0,0,0
445682,353,353,0,0,0
445702,44,44,0,0,0
445703,101,101,0,0,0
445708,310,310,0,0,0
445710,130,130,0,0,0
445712,15,15,0,0,0
445728,63,63,0,0,0
445754,402,402,0,0,0
445755,281,281,0,0,0
445773,315,315,0,0,0
445782,7,7,0,0,0
445788,232,232,0,0,0
445811,57,57,0,0,0
445818,29,29,0,0,0
445838,131,131,0,0,0
445850,232,232,0,0,0
445852,345,345,0,0,0
445853,168,168,0,0,0
445861,102,102,0,0,0
445862,18,18,0,0,0
445874,143,143,0,0,0
445897,74,74,0,0,0
445902,87,87,0,0,0
445906,232,232,0,0,0
445907,77,77,0,0,0
445919,252,252,0,0,0
445952,143,143,0,0,0
445962,402,402,0,0,0
445977,1,1,0,0,0
445991,353,353,0,0,0
445996,353,353,0,0,0
446009,259,259,0,0,0
446022,113,113,0,0,0
446025,345,345,0,0,0
446053,259,259,0,0,0
446055,151,151,0,0,0
446072,353,353,0,0,0
446081,353,353,0,0,0
446092,12,12,0,0,0
446096,198,198,0,0,0
446113,246,246,0,0,0
446135,55,55,0,0,0
446166,281,281,0,0,0
446175,30,30,0,0,0
446213,306,306,0,0,0
446217,180,180,0,0,0
446220,29,29,0,0,0
446226,315,315,0,0,0
446240,313,313,0,0,0
446244,180,180,0,0,0
446254,65,65,0,0,0
446271,255,255,0,0,0
446274,103,103,0,0,0
446275,359,359,0,0,0
446282,76,76,0,0,0
446285,121,121,0,0,0
446290,3,3,0,0,0
446298,97,97,0,0,0
446304,299,299,0,0,0
446305,39,39,0,0,0
446335,246,246,0,0,0
446337,259,259,0,0,0
446340,232,232,0,0,0
446348,75,75,0,0,0
446351,34,34,0,0,0
446364,82,82,0,0,0
446365,11,11,0,0,0
446366,193,193,0,0,0
446367,85,85,0,0,0
446379,306,306,0,0,0
446403,137,137,0,0,0
446414,1,1,0,0,0
446415,251,251,0,0,0
446440,32,32,0,0,0
446461,137,137,0,0,0
446477,54,54,0,0,0
446487,144,144,0,0,0
446488,130,130,0,0,0
446491,259,259,0,0,0
446499,28,28,0,0,0
446506,3,3,0,0,0
446525,232,232,0,0,0
446527,36,36,0,0,0
446542,359,359,0,0,0
446543,17,17,0,0,0
446561,152,152,0,0,0
446572,310,310,0,0,0
446581,306,306,0,0,0
446595,255,255,0,0,0
446601,168,168,0,0,0
446607,45,45,0,0,0
446616,282,282,0,0,0
446637,310,310,0,0,0
446669,158,158,0,0,0
446670,163,163,0,0,0
446674,299,299,0,0,0
446689,41,41,0,0,0
446702,83,83,0,0,0
446708,50,50,0,0,0
446709,83,83,0,0,0
446720,102,102,0,0,0
446724,72,72,0,0,0
446752,120,120,0,0,0
446760,54,54,0,0,0
446765,43,43,0,0,0
446768,306,306,0,0,0
446773,252,252,0,0,0
446785,315,315,0,0,0
446791,18,18,0,0,0
446800,83,83,0,0,0
446802,345,345,0,0,0
446814,101,101,0,0,0
446823,152,152,0,0,0
446829,180,180,0,0,0
446831,299,299,0,0,0
446841,152,152,0,0,0
446859,24,24,0,0,0
446860,359,359,0,0,0
446870,252,252,0,0,0
446909,252,252,0,0,0
446910,4,4,0,0,0
446913,313,313,0,0,0
446916,251,251,0,0,0
446932,152,152,0,0,0
446940,299,299,0,0,0
446949,82,82,0,0,0
446957,184,184,0,0,0
446968,310,310,0,0,0
446973,315,315,0,0,0
446980,121,121,0,0,0
446989,359,359,0,0,0
446992,74,74,0,0,0
446999,345,345,0,0,0
447011,50,50,0,0,0
447020,255,255,0,0,0
447023,251,251,0,0,0
447074,128,128,0,0,0
447075,143,143,0,0,0
447083,345,345,0,0,0
447086,201,201,0,0,0
447089,198,198,0,0,0
447090,97,97,0,0,0
447101,44,44,0,0,0
447114,77,77,0,0,0
447123,193,193,0,0,0
447134,65,65,0,0,0
447152,69,69,0,0,0
447159,232,232,0,0,0
447181,168,168,0,0,0
447193,43,43,0,0,0
447204,54,54,0,0,0
447205,143,143,0,0,0
447219,22,22,0,0,0
447236,402,402,0,0,0
447266,75,75,0,0,0
447268,201,201,0,0,0
447269,299,299,0,0,0
447270,163,163,0,0,0
447273,193,193,0,0,0
447287,198,198,0,0,0
447295,87,87,0,0,0
447300,193,193,0,0,0
447312,6,6,0,0,0
447332,28,28,0,0,0
447370,120,120,0,0,0
447374,74,74,0,0,0
447394,353,353,0,0,0
447399,137,137,0,0,0
447400,5,5,0,0,0
447406,251,251,0,0,0
447411,345,345,0,0,0
447421,77,77,0,0,0
447424,313,313,0,0,0
447430,345,345,0,0,0
447436,14,14,0,0,0
447463,133,133,0,0,0
447470,402,402,0,0,0
447472,193,193,0,0,0
447479,85,85,0,0,0
447481,75,75,0,0,0
447484,3,3,0,0,0
447487,345,345,0,0,0
447489,246,246,0,0,0
447522,56,56,0,0,0
447528,282,282,0,0,0
447551,151,151,0,0,0
447552,144,144,0,0,0
447558,101,101,0,0,0
447561,25,25,0,0,0
447571,246,246,0,0,0
447598,251,251,0,0,0
447600,246,246,0,0,0
447617,232,232,0,0,0
447618,103,103,0,0,0
447622,114,114,0,0,0
447635,259,259,0,0,0
447656,313,313,0,0,0
447684,402,402,0,0,0
447709,232,232,0,0,0
447733,75,75,0,0,0
447736,24,24,0,0,0
447738,67,67,0,0,0
447739,251,251,0,0,0
447744,57,57,0,0,0
447747,359,359,0,0,0
447753,56,56,0,0,0
447755,313,313,0,0,0
447759,345,345,0,0,0
447772,152,152,0,0,0
447786,353,353,0,0,0
447796,103,103,0,0,0
447817,30,30,0,0,0
447824,315,315,0,0,0
447831,184,184,0,0,0
447834,82,82,0,0,0
447845,16,16,0,0,0
447848,143,143,0,0,0
447873,67,67,0,0,0
447885,71,71,0,0,0
447888,16,16,0,0,0
447904,3,3,0,0,0
447906,152,152,0,0,0
447934,74,74,0,0,0
447939,10,10,0,0,0
447953,180,180,0,0,0
447965,255,255,0,0,0
447968,65,65,0,0,0
447973,114,114,0,0,0
447975,76,76,0,0,0
447988,74,74,0,0,0
447995,353,353,0,0,0
448004,193,193,0,0,0
448038,102,102,0,0,0
448045,315,315,0,0,0
448050,44,44,0,0,0
448078,402,402,0,0,0
448091,184,184,0,0,0
448098,246,246,0,0,0
448105,299,299,0,0,0
448127,313,313,0,0,0
448135,171,171,0,0,0
448152,121,121,0,0,0
448154,201,201,0,0,0
448166,167,167,0,0,0
448169,39,39,0,0,0
448172,7,7,0,0,0
448188,345,345,0,0,0
448191,102,102,0,0,0
448192,163,163,0,0,0
448193,353,353,0,0,0
448212,25,25,0,0,0
448218,17,17,0,0,0
448219,83,83,0,0,0
448226,9,9,0,0,0
448267,8,8,0,0,0
448276,63,63,0,0,0
448287,299,299,0,0,0
448309,18,18,0,0,0
448318,345,345,0,0,0
448321,193,193,0,0,0
448325,299,299,0,0,0
448333,232,232,0,0,0
448345,3,3,0,0,0
448352,359,359,0,0,0
448356,94,94,0,0,0
448446,180,180,0,0,0
448455,246,246,0,0,0
448460,77,77,0,0,0
448461,25,25,0,0,0
448505,252,252,0,0,0
448514,85,85,0,0,0
448527,163,163,0,0,0
448547,133,133,0,0,0
448553,97,97,0,0,0
448561,121,121,0,0,0
448573,137,137,0,0,0
448593,315,315,0,0,0
448658,128,128,0,0,0
448670,232,232,0,0,0
448671,232,232,0,0,0
448675,57,57,0,0,0
448687,255,255,0,0,0
448695,40,40,0,0,0
448696,198,198,0,0,0
448697,94,94,0,0,0
448710,29,29,0,0,0
448714,87,87,0,0,0
448715,44,44,0,0,0
448716,17,17,0,0,0
448736,281,281,0,0,0
448737,20,20,0,0,0
448738,85,85,0,0,0
448744,82,82,0,0,0
448745,180,180,0,0,0
448746,282,282,0,0,0
448756,353,353,0,0,0
448778,20,20,0,0,0
448780,19,19,0,0,0
448785,44,44,0,0,0
448800,85,85,0,0,0
448871,144,144,0,0,0
448889,144,144,0,0,0
448900,101,101,0,0,0
448901,45,45,0,0,0
448903,27,27,0,0,0
448937,114,114,0,0,0
448940,44,44,0,0,0
448971,168,168,0,0,0
448986,19,19,0,0,0
448991,133,133,0,0,0
449008,30,30,0,0,0
449009,76,76,0,0,0
449039,171,171,0,0,0
449046,313,313,0,0,0
449050,281,281,0,0,0
449052,43,43,0,0,0
449070,163,163,0,0,0
449079,168,168,0,0,0
449083,259,259,0,0,0
449084,102,102,0,0,0
449105,101,101,0,0,0
449106,35,35,0,0,0
449107,281,281,0,0,0
449127,353,353,0,0,0
449128,121,121,0,0,0
449144,180,180,0,0,0
449151,167,167,0,0,0
449161,402,402,0,0,0
449166,9,9,0,0,0
449168,8,8,0,0,0
449197,201,201,0,0,0
449198,120,120,0,0,0
449208,246,246,0,0,0
449212,313,313,0,0,0
449233,315,315,0,0,0
449245,310,310,0,0,0
449256,43,43,0,0,0
449274,306,306,0,0,0
449275,184,184,0,0,0
449284,83,83,0,0,0
449292,252,252,0,0,0
449319,97,97,0,0,0
449329,163,163,0,0,0
449343,359,359,0,0,0
449370,137,137,0,0,0
449383,133,133,0,0,0
449388,281,281,0,0,0
449394,12,12,0,0,0
449404,180,180,0,0,0
449416,151,151,0,0,0
449427,74,74,0,0,0
449431,306,306,0,0,0
449433,45,45,0,0,0
449439,7,7,0,0,0
449457,158,158,0,0,0
449476,12,12,0,0,0
449477,252,252,0,0,0
449478,24,24,0,0,0
449479,70,70,0,0,0
449482,151,151,0,0,0
449483,25,25,0,0,0
449485,315,315,0,0,0
449486,137,137,0,0,0
449494,17,17,0,0,0
449497,198,198,0,0,0
449507,143,143,0,0,0
449512,299,299,0,0,0
449517,29,29,0,0,0
449520,101,101,0,0,0
449522,345,345,0,0,0
449530,299,299,0,0,0
449553,25,25,0,0,0
449566,137,137,0,0,0
449602,198,198,0,0,0
449604,402,402,0,0,0
449611,19,19,0,0,0
449612,143,143,0,0,0
449614,25,25,0,0,0
449618,18,18,0,0,0
449622,22,22,0,0,0
449637,137,137,0,0,0
449638,7,7,0,0,0
449643,299,299,0,0,0
449644,359,359,0,0,0
449650,255,255,0,0,0
449659,201,201,0,0,0
449673,74,74,0,0,0
449676,306,306,0,0,0
449688,315,315,0,0,0
449712,101,101,0,0,0
449713,163,163,0,0,0
449733,24,24,0,0,0
449741,168,168,0,0,0
449744,282,282,0,0,0
449748,114,114,0,0,0
449763,313,313,0,0,0
449774,7,7,0,0,0
449781,315,315,0,0,0
449821,69,69,0,0,0
449825,353,353,0,0,0
449829,299,299,0,0,0
449841,315,315,0,0,0
449845,71,71,0,0,0
449864,306,306,0,0,0
449876,102,102,0,0,0
449887,313,313,0,0,0
449888,66,66,0,0,0
449891,102,102,0,0,0
449904,353,353,0,0,0
449905,133,133,0,0,0
449915,3,3,0,0,0
449935,12,12,0,0,0
449944,359,359,0,0,0
449945,30,30,0,0,0
449961,345,345,0,0,0
449972,72,72,0,0,0
449973,20,20,0,0,0
449981,315,315,0,0,0
449982,310,310,0,0,0
449985,259,259,0,0,0
449992,114,114,0,0,0
449993,12,12,0,0,0
450002,50,50,0,0,0
450012,168,168,0,0,0
450017,315,315,0,0,0
450030,353,353,0,0,0
450032,41,41,0,0,0
450044,6,6,0,0,0
450056,44,44,0,0,0
450067,168,168,0,0,0
450087,102,102,0,0,0
450088,180,180,0,0,0
450109,3,3,0,0,0
450111,193,193,0,0,0
450123,21,21,0,0,0
450132,28,28,0,0,0
450135,151,151,0,0,0
450156,66,66,0,0,0
450164,359,359,0,0,0
450176,167,167,0,0,0
450179,345,345,0,0,0
450181,20,20,0,0,0
450198,315,315,0,0,0
450250,198,198,0,0,0
450253,299,299,0,0,0
450256,353,353,0,0,0
450277,144,144,0,0,0
450279,171,171,0,0,0
450286,402,402,0,0,0
450300,310,310,0,0,0
450303,353,353,0,0,0
450317,67,67,0,0,0
450323,315,315,0,0,0
450332,359,359,0,0,0
450366,6,6,0,0,0
450374,97,97,0,0,0
450394,82,82,0,0,0
450406,14,14,0,0,0
450415,345,345,0,0,0
450418,282,282,0,0,0
450424,359,359,0,0,0
450429,251,251,0,0,0
450438,7,7,0,0,0
450444,359,359,0,0,0
450448,151,151,0,0,0
450459,151,151,0,0,0
450461,168,168,0,0,0
450467,75,75,0,0,0
450472,43,43,0,0,0
450481,163,163,0,0,0
450496,353,353,0,0,0
450542,353,353,0,0,0
450566,201,201,0,0,0
450569,306,306,0,0,0
450570,128,128,0,0,0
450572,24,24,0,0,0
450579,74,74,0,0,0
450606,130,130,0,0,0
450611,137,137,0,0,0
450640,25,25,0,0,0
450647,50,50,0,0,0
450657,168,168,0,0,0
450668,77,77,0,0,0
450699,114,114,0,0,0
450718,251,251,0,0,0
450725,3,3,0,0,0
450748,299,299,0,0,0
450753,113,113,0,0,0
450755,282,282,0,0,0
450759,76,76,0,0,0
450769,29,29,0,0,0
450819,121,121,0,0,0
450841,345,345,0,0,0
450843,246,246,0,0,0
450844,114,114,0,0,0
450854,85,85,0,0,0
450868,402,402,0,0,0
450899,25,25,0,0,0
450902,193,193,0,0,0
450905,24,24,0,0,0
450915,402,402,0,0,0
450924,74,74,0,0,0
450970,259,259,0,0,0
450977,163,163,0,0,0
450986,25,25,0,0,0
450989,76,76,0,0,0
451011,299,299,0,0,0
451012,11,11,0,0,0
451023,14,14,0,0,0
451029,255,255,0,0,0
451045,74,74,0,0,0
451048,24,24,0,0,0
451055,282,282,0,0,0
451063,259,259,0,0,0
451064,72,72,0,0,0
451073,313,313,0,0,0
451099,163,163,0,0,0
451113,359,359,0,0,0
451117,198,198,0,0,0
451144,3,3,0,0,0
451153,152,152,0,0,0
451166,402,402,0,0,0
451184,281,281,0,0,0
451190,255,255,0,0,0
451203,45,45,0,0,0
451234,121,121,0,0,0
451258,12,12,0,0,0
451270,353,353,0,0,0
451278,29,29,0,0,0
451287,25,25,0,0,0
451311,310,310,0,0,0
451329,82,82,0,0,0
451337,114,114,0,0,0
451358,402,402,0,0,0
451362,76,76,0,0,0
451418,114,114,0,0,0
451419,103,103,0,0,0
451423,158,158,0,0,0
451436,201,201,0,0,0
451437,94,94,0,0,0
451445,121,121,0,0,0
451462,13,13,0,0,0
451480,282,282,0,0,0
451486,345,345,0,0,0
451487,103,103,0,0,0
451509,313,313,0,0,0
451526,65,65,0,0,0
451533,15,15,0,0,0
451534,67,67,0,0,0
451541,113,113,0,0,0
451556,171,171,0,0,0
451558,310,310,0,0,0
451569,29,29,0,0,0
451581,167,167,0,0,0
451592,246,246,0,0,0
451595,198,198,0,0,0
451600,359,359,0,0,0
451602,70,70,0,0,0
451605,353,353,0,0,0
451613,101,101,0,0,0
451616,345,345,0,0,0
451621,402,402,0,0,0
451628,102,102,0,0,0
451644,15,15,0,0,0
451648,75,75,0,0,0
451650,11,11,0,0,0
451656,252,252,0,0,0
451658,3,3,0,0,0
451659,114,114,0,0,0
451665,102,102,0,0,0
451668,65,65,0,0,0
451673,259,259,0,0,0
451675,163,163,0,0,0
451682,102,102,0,0,0
451733,184,184,0,0,0
451759,313,313,0,0,0
451763,58,58,0,0,0
451767,171,171,0,0,0
451776,133,133,0,0,0
451777,255,255,0,0,0
451779,251,251,0,0,0
451780,171,171,0,0,0
451782,24,24,0,0,0
451783,299,299,0,0,0
451795,353,353,0,0,0
451802,63,63,0,0,0
451804,252,252,0,0,0
451805,163,163,0,0,0
451813,30,30,0,0,0
451816,151,151,0,0,0
451838,63,63,0,0,0
451867,76,76,0,0,0
451872,251,251,0,0,0
451892,16,16,0,0,0
451900,35,35,0,0,0
451904,69,69,0,0,0
451958,345,345,0,0,0
451966,313,313,0,0,0
451968,246,246,0,0,0
451979,43,43,0,0,0
451981,201,201,0,0,0
451987,74,74,0,0,0
452006,63,63,0,0,0
452022,251,251,0,0,0
452024,193,193,0,0,0
452028,128,128,0,0,0
452037,87,87,0,0,0
452042,102,102,0,0,0
452058,39,39,0,0,0
452077,251,251,0,0,0
452092,251,251,0,0,0
452095,168,168,0,0,0
452128,10,10,0,0,0
452135,133,133,0,0,0
452137,45,45,0,0,0
452139,101,101,0,0,0
452151,132,132,0,0,0
452153,282,282,0,0,0
452157,151,151,0,0,0
452165,101,101,0,0,0
452172,345,345,0,0,0
452176,67,67,0,0,0
452184,70,70,0,0,0
452189,131,131,0,0,0
452194,131,131,0,0,0
452213,359,359,0,0,0
452231,13,13,0,0,0
452254,54,54,0,0,0
452259,315,315,0,0,0
452278,15,15,0,0,0
452304,143,143,0,0,0
452321,168,168,0,0,0
452322,41,41,0,0,0
452326,259,259,0,0,0
452333,114,114,0,0,0
452336,299,299,0,0,0
452340,252,252,0,0,0
452346,137,137,0,0,0
452353,15,15,0,0,0
452371,102,102,0,0,0
452385,315,315,0,0,0
452408,2,2,0,0,0
452411,137,137,0,0,0
452433,44,44,0,0,0
452434,25,25,0,0,0
452437,20,20,0,0,0
452448,402,402,0,0,0
452453,359,359,0,0,0
452458,114,114,0,0,0
452468,70,70,0,0,0
452469,58,58,0,0,0
452474,255,255,0,0,0
452476,29,29,0,0,0
452494,102,102,0,0,0
452499,184,184,0,0,0
452504,158,158,0,0,0
452522,282,282,0,0,0
452530,66,66,0,0,0
452538,13,13,0,0,0
452542,315,315,0,0,0
452544,353,353,0,0,0
452545,10,10,0,0,0
452546,144,144,0,0,0
452553,69,69,0,0,0
452554,19,19,0,0,0
452572,193,193,0,0,0
452598,167,167,0,0,0
452601,137,137,0,0,0
452602,232,232,0,0,0
452606,402,402,0,0,0
452617,128,128,0,0,0
452640,171,171,0,0,0
452648,25,25,0,0,0
452652,255,255,0,0,0
452654,313,313,0,0,0
452655,306,306,0,0,0
452666,282,282,0,0,0
452673,18,18,0,0,0
452689,130,130,0,0,0
452694,193,193,0,0,0
452767,74,74,0,0,0
452772,137,137,0,0,0
452788,15,15,0,0,0
452790,198,198,0,0,0
452823,128,128,0,0,0
452828,313,313,0,0,0
452841,359,359,0,0,0
452864,402,402,0,0,0
452886,5,5,0,0,0
452889,143,143,0,0,0
452890,34,34,0,0,0
452892,201,201,0,0,0
452934,71,71,0,0,0
452936,251,251,0,0,0
452949,82,82,0,0,0
452950,76,76,0,0,0
452959,18,18,0,0,0
452968,2,2,0,0,0
452988,114,114,0,0,0
452995,74,74,0,0,0
452999,12,12,0,0,0
453002,1,1,0,0,0
453008,85,85,0,0,0
453014,128,128,0,0,0
453047,167,167,0,0,0
453050,114,114,0,0,0
453058,359,359,0,0,0
453092,198,198,0,0,0
453104,101,101,0,0,0
453113,70,70,0,0,0
453118,3,3,0,0,0
453148,103,103,0,0,0
453170,101,101,0,0,0
453185,25,25,0,0,0
453202,65,65,0,0,0
453224,3,3,0,0,0
453229,12,12,0,0,0
453235,259,259,0,0,0
453240,201,201,0,0,0
453241,246,246,0,0,0
453247,41,41,0,0,0
453248,313,313,0,0,0
453325,158,158,0,0,0
453338,255,255,0,0,0
453344,315,315,0,0,0
453358,66,66,0,0,0
453360,353,353,0,0,0
453363,255,255,0,0,0
453371,168,168,0,0,0
453378,232,232,0,0,0
453380,232,232,0,0,0
453405,72,72,0,0,0
453421,252,252,0,0,0
453453,40,40,0,0,0
453461,313,313,0,0,0
453465,315,315,0,0,0
453468,158,158,0,0,0
453470,44,44,0,0,0
453483,7,7,0,0,0
453485,198,198,0,0,0
453489,306,306,0,0,0
453492,345,345,0,0,0
453525,24,24,0,0,0
453529,133,133,0,0,0
453530,132,132,0,0,0
453565,76,76,0,0,0
453573,71,71,0,0,0
453624,353,353,0,0,0
453664,22,22,0,0,0
453687,114,114,0,0,0
453697,29,29,0,0,0
453730,152,152,0,0,0
453744,315,315,0,0,0
453747,251,251,0,0,0
453753,246,246,0,0,0
453761,163,163,0,0,0
453764,66,66,0,0,0
453768,251,251,0,0,0
453803,18,18,0,0,0
453807,71,71,0,0,0
453813,14,14,0,0,0
453855,193,193,0,0,0
453856,184,184,0,0,0
453861,402,402,0,0,0
453870,72,72,0,0,0
453872,402,402,0,0,0
453881,128,128,0,0,0
453906,152,152,0,0,0
453918,128,128,0,0,0
453947,281,281,0,0,0
453951,130,130,0,0,0
453999,252,252,0,0,0
454003,345,345,0,0,0
454009,16,16,0,0,0
454012,36,36,0,0,0
454019,402,402,0,0,0
454025,184,184,0,0,0
454033,313,313,0,0,0
454040,359,359,0,0,0
454058,198,198,0,0,0
454059,259,259,0,0,0
454070,299,299,0,0,0
454096,402,402,0,0,0
454101,121,121,0,0,0
454112,251,251,0,0,0
454126,299,299,0,0,0
454175,282,282,0,0,0
454184,137,137,0,0,0
454189,30,30,0,0,0
454199,151,151,0,0,0
454202,71,71,0,0,0
454218,58,58,0,0,0
454219,7,7,0,0,0
454258,359,359,0,0,0
454283,8,8,0,0,0
454291,20,20,0,0,0
454301,167,167,0,0,0
454317,306,306,0,0,0
454319,402,402,0,0,0
454320,7,7,0,0,0
454331,345,345,0,0,0
454350,114,114,0,0,0
454360,246,246,0,0,0
454406,85,85,0,0,0
454407,131,131,0,0,0
454428,353,353,0,0,0
454432,76,76,0,0,0
454440,143,143,0,0,0
454445,315,315,0,0,0
454470,19,19,0,0,0
454472,18,18,0,0,0
454502,67,67,0,0,0
454504,102,102,0,0,0
454514,359,359,0,0,0
454515,83,83,0,0,0
454519,310,310,0,0,0
454532,259,259,0,0,0
454542,7,7,0,0,0
454544,102,102,0,0,0
454548,85,85,0,0,0
454552,83,83,0,0,0
454553,131,131,0,0,0
454556,3,3,0,0,0
454582,313,313,0,0,0
454585,97,97,0,0,0
454589,5,5,0,0,0
454595,137,137,0,0,0
454602,167,167,0,0,0
454611,255,255,0,0,0
454612,402,402,0,0,0
454626,137,137,0,0,0
454632,18,18,0,0,0
454633,345,345,0,0,0
454635,20,20,0,0,0
454658,66,66,0,0,0
454674,306,306,0,0,0
454701,9,9,0,0,0
454708,402,402,0,0,0
454715,299,299,0,0,0
454735,121,121,0,0,0
454737,66,66,0,0,0
454746,198,198,0,0,0
454747,315,315,0,0,0
454751,85,85,0,0,0
454770,83,83,0,0,0
454771,76,76,0,0,0
454774,251,251,0,0,0
454787,259,259,0,0,0
454791,143,143,0,0,0
454812,27,27,0,0,0
454813,121,121,0,0,0
454817,114,114,0,0,0
454827,281,281,0,0,0
454841,313,313,0,0,0
454842,55,55,0,0,0
454845,252,252,0,0,0
454852,282,282,0,0,0
454863,128,128,0,0,0
454867,22,22,0,0,0
454878,151,151,0,0,0
454879,306,306,0,0,0
454882,137,137,0,0,0
454891,359,359,0,0,0
454897,36,36,0,0,0
454906,246,246,0,0,0
454907,3,3,0,0,0
454917,76,76,0,0,0
454927,114,114,0,0,0
454939,201,201,0,0,0
454943,133,133,0,0,0
454946,17,17,0,0,0
454948,232,232,0,0,0
454953,128,128,0,0,0
454973,232,232,0,0,0
454974,19,19,0,0,0
454989,306,306,0,0,0
454994,402,402,0,0,0
455008,75,75,0,0,0
455015,76,76,0,0,0
455023,113,113,0,0,0
455033,315,315,0,0,0
455038,74,74,0,0,0
455049,8,8,0,0,0
455053,345,345,0,0,0
455065,94,94,0,0,0
455069,315,315,0,0,0
455075,143,143,0,0,0
455082,299,299,0,0,0
455087,82,82,0,0,0
455095,143,143,0,0,0
455108,163,163,0,0,0
455109,101,101,0,0,0
455115,201,201,0,0,0
455129,50,50,0,0,0
455145,25,25,0,0,0
455151,184,184,0,0,0
455155,22,22,0,0,0
455170,353,353,0,0,0
455186,102,102,0,0,0
455191,137,137,0,0,0
455194,184,184,0,0,0
455197,128,128,0,0,0
455201,14,14,0,0,0
455228,30,30,0,0,0
455231,21,21,0,0,0
455241,345,345,0,0,0
455248,55,55,0,0,0
455267,102,102,0,0,0
455282,18,18,0,0,0
455320,167,167,0,0,0
455336,282,282,0,0,0
455339,102,102,0,0,0
455347,17,17,0,0,0
455363,13,13,0,0,0
455366,163,163,0,0,0
455372,15,15,0,0,0
455384,193,193,0,0,0
455389,121,121,0,0,0
455391,75,75,0,0,0
455404,102,102,0,0,0
455437,69,69,0,0,0
455438,310,310,0,0,0
455442,167,167,0,0,0
455447,299,299,0,0,0
455451,310,310,0,0,0
455483,299,299,0,0,0
455487,282,282,0,0,0
455496,34,34,0,0,0
455500,121,121,0,0,0
455508,94,94,0,0,0
455516,87,87,0,0,0
455526,152,152,0,0,0
455548,152,152,0,0,0
455580,57,57,0,0,0
455593,310,310,0,0,0
455605,36,36,0,0,0
455606,255,255,0,0,0
455609,152,152,0,0,0
455643,252,252,0,0,0
455650,76,76,0,0,0
455661,402,402,0,0,0
455677,137,137,0,0,0
455709,281,281,0,0,0
455711,54,54,0,0,0
455723,82,82,0,0,0
455770,66,66,0,0,0
455777,167,167,0,0,0
455785,345,345,0,0,0
455806,359,359,0,0,0
455807,74,74,0,0,0
455813,39,39,0,0,0
455814,1,1,0,0,0
455817,83,83,0,0,0
455835,198,198,0,0,0
455862,6,6,0,0,0
455889,36,36,0,0,0
455890,29,29,0,0,0
455891,76,76,0,0,0
455893,50,50,0,0,0
455899,103,103,0,0,0
455904,69,69,0,0,0
455907,121,121,0,0,0
455912,94,94,0,0,0
455919,345,345,0,0,0
455921,163,163,0,0,0
455925,143,143,0,0,0
455931,281,281,0,0,0
455940,130,130,0,0,0
455941,353,353,0,0,0
455951,7,7,0,0,0
455959,345,345,0,0,0
455961,114,114,0,0,0
455978,163,163,0,0,0
455982,114,114,0,0,0
455987,282,282,0,0,0
456010,353,353,0,0,0
456011,76,76,0,0,0
456016,128,128,0,0,0
456023,25,25,0,0,0
456028,255,255,0,0,0
456039,12,12,0,0,0
456049,137,137,0,0,0
456066,44,44,0,0,0
456068,315,315,0,0,0
456075,12,12,0,0,0
456121,137,137,0,0,0
456126,16,16,0,0,0
456147,201,201,0,0,0
456163,113,113,0,0,0
456164,76,76,0,0,0
456192,83,83,0,0,0
456212,168,168,0,0,0
456224,232,232,0,0,0
456226,313,313,0,0,0
456255,299,299,0,0,0
456264,128,128,0,0,0
456269,281,281,0,0,0
456281,281,281,0,0,0
456288,121,121,0,0,0
456297,310,310,0,0,0
456299,359,359,0,0,0
456326,76,76,0,0,0
456334,56,56,0,0,0
456341,246,246,0,0,0
456344,130,130,0,0,0
456365,306,306,0,0,0
456370,44,44,0,0,0
456378,103,103,0,0,0
456381,55,55,0,0,0
456386,310,310,0,0,0
456389,120,120,0,0,0
456436,252,252,0,0,0
456450,97,97,0,0,0
456460,65,65,0,0,0
456461,36,36,0,0,0
456478,163,163,0,0,0
456495,353,353,0,0,0
456497,3,3,0,0,0
456505,121,121,0,0,0
456511,40,40,0,0,0
456518,246,246,0,0,0
456522,306,306,0,0,0
456530,35,35,0,0,0
456532,359,359,0,0,0
456534,102,102,0,0,0
456567,144,144,0,0,0
456568,306,306,0,0,0
456637,34,34,0,0,0
456640,402,402,0,0,0
456665,39,39,0,0,0
456692,1,1,0,0,0
456694,359,359,0,0,0
456720,180,180,0,0,0
456725,201,201,0,0,0
456726,184,184,0,0,0
456735,57,57,0,0,0
456758,137,137,0,0,0
456766,402,402,0,0,0
456777,353,353,0,0,0
456785,22,22,0,0,0
456795,282,282,0,0,0
456799,10,10,0,0,0
456809,36,36,0,0,0
456812,168,168,0,0,0
456830,184,184,0,0,0
456836,128,128,0,0,0
456838,101,101,0,0,0
456846,359,359,0,0,0
456849,132,132,0,0,0
456860,102,102,0,0,0
456861,102,102,0,0,0
456866,14,14,0,0,0
456944,193,193,0,0,0
456949,306,306,0,0,0
456975,8,8,0,0,0
456976,12,12,0,0,0
456977,128,128,0,0,0
456983,128,128,0,0,0
457005,65,65,0,0,0
457018,232,232,0,0,0
457024,310,310,0,0,0
457025,114,114,0,0,0
457062,232,232,0,0,0
457069,55,55,0,0,0
457077,44,44,0,0,0
457081,15,15,0,0,0
457088,281,281,0,0,0
457097,193,193,0,0,0
457117,58,58,0,0,0
457120,10,10,0,0,0
457132,252,252,0,0,0
457145,315,315,0,0,0
457161,7,7,0,0,0
457165,232,232,0,0,0
457177,168,168,0,0,0
457201,39,39,0,0,0
457205,251,251,0,0,0
457221,137,137,0,0,0
457226,255,255,0,0,0
457245,120,120,0,0,0
457257,201,201,0,0,0
457259,67,67,0,0,0
457269,299,299,0,0,0
457275,281,281,0,0,0
457288,121,121,0,0,0
457289,193,193,0,0,0
457298,163,163,0,0,0
457307,163,163,0,0,0
457317,315,315,0,0,0
457323,359,359,0,0,0
457339,74,74,0,0,0
457342,313,313,0,0,0
457357,121,121,0,0,0
457403,85,85,0,0,0
457435,12,12,0,0,0
457436,151,151,0,0,0
457465,2,2,0,0,0
457467,345,345,0,0,0
457475,167,167,0,0,0
457491,75,75,0,0,0
457495,6,6,0,0,0
457496,353,353,0,0,0
457498,70,70,0,0,0
457507,12,12,0,0,0
457518,402,402,0,0,0
457534,76,76,0,0,0
457544,66,66,0,0,0
457556,201,201,0,0,0
457561,56,56,0,0,0
457562,359,359,0,0,0
457563,251,251,0,0,0
457570,180,180,0,0,0
457584,83,83,0,0,0
457585,359,359,0,0,0
457595,180,180,0,0,0
457602,7,7,0,0,0
457613,315,315,0,0,0
457614,97,97,0,0,0
457628,167,167,0,0,0
457637,353,353,0,0,0
457641,13,13,0,0,0
457645,72,72,0,0,0
457656,359,359,0,0,0
457663,4,4,0,0,0
457666,353,353,0,0,0
457672,315,315,0,0,0
457678,152,152,0,0,0
457689,306,306,0,0,0
457690,259,259,0,0,0
457697,3,3,0,0,0
457698,167,167,0,0,0
457704,255,255,0,0,0
457721,353,353,0,0,0
457727,8,8,0,0,0
457736,36,36,0,0,0
457742,15,15,0,0,0
457756,17,17,0,0,0
457759,29,29,0,0,0
457800,67,67,0,0,0
457840,246,246,0,0,0
457846,70,70,0,0,0
457879,151,151,0,0,0
457880,76,76,0,0,0
457922,313,313,0,0,0
457923,299,299,0,0,0
457951,281,281,0,0,0
457968,25,25,0,0,0
457980,353,353,0,0,0
457981,29,29,0,0,0
457998,246,246,0,0,0
458008,77,77,0,0,0
458034,131,131,0,0,0
458044,83,83,0,0,0
458047,130,130,0,0,0
458059,171,171,0,0,0
458066,50,50,0,0,0
458087,232,232,0,0,0
458106,359,359,0,0,0
458118,299,299,0,0,0
458135,232,232,0,0,0
458145,3,3,0,0,0
458178,255,255,0,0,0
458185,359,359,0,0,0
458207,103,103,0,0,0
458234,184,184,0,0,0
458239,102,102,0,0,0
458248,76,76,0,0,0
458273,12,12,0,0,0
458274,71,71,0,0,0
458276,102,102,0,0,0
458283,152,152,0,0,0
458295,310,310,0,0,0
458301,131,131,0,0,0
458309,34,34,0,0,0
458327,131,131,0,0,0
458331,5,5,0,0,0
458345,315,315,0,0,0
458346,246,246,0,0,0
458353,27,27,0,0,0
458361,71,71,0,0,0
458367,158,158,0,0,0
458371,70,70,0,0,0
458377,167,167,0,0,0
458378,402,402,0,0,0
458385,133,133,0,0,0
458392,359,359,0,0,0
458394,75,75,0,0,0
458431,67,67,0,0,0
458460,255,255,0,0,0
458461,168,168,0,0,0
458462,55,55,0,0,0
458475,137,137,0,0,0
458482,16,16,0,0,0
458502,168,168,0,0,0
458503,72,72,0,0,0
458514,35,35,0,0,0
458530,58,58,0,0,0
458534,133,133,0,0,0
458583,201,201,0,0,0
458592,5,5,0,0,0
458608,128,128,0,0,0
458624,25,25,0,0,0
458629,130,130,0,0,0
458636,76,76,0,0,0
458649,2,2,0,0,0
458652,29,29,0,0,0
458653,345,345,0,0,0
458663,5,5,0,0,0
458676,281,281,0,0,0
458709,310,310,0,0,0
458712,281,281,0,0,0
458732,252,252,0,0,0
458741,43,43,0,0,0
458756,21,21,0,0,0
458762,77,77,0,0,0
458771,310,310,0,0,0
458804,281,281,0,0,0
458811,5,5,0,0,0
458812,282,282,0,0,0
458814,299,299,0,0,0
458822,63,63,0,0,0
458841,101,101,0,0,0
458846,22,22,0,0,0
458911,255,255,0,0,0
458914,25,25,0,0,0
458916,102,102,0,0,0
458951,306,306,0,0,0
458955,353,353,0,0,0
458977,2,2,0,0,0
458988,255,255,0,0,0
458996,402,402,0,0,0
459014,29,29,0,0,0
459050,281,281,0,0,0
459062,94,94,0,0,0
459080,180,180,0,0,0
459088,310,310,0,0,0
459106,50,50,0,0,0
459115,25,25,0,0,0
459126,29,29,0,0,0
459140,282,282,0,0,0
459153,232,232,0,0,0
459156,315,315,0,0,0
459160,11,11,0,0,0
459166,402,402,0,0,0
459175,306,306,0,0,0
459182,66,66,0,0,0
459195,128,128,0,0,0
459209,402,402,0,0,0
459225,22,22,0,0,0
459236,246,246,0,0,0
459240,163,163,0,0,0
459246,55,55,0,0,0
459249,70,70,0,0,0
459254,102,102,0,0,0
459258,75,75,0,0,0
459277,252,252,0,0,0
459281,67,67,0,0,0
459282,167,167,0,0,0
459297,3,3,0,0,0
459306,313,313,0,0,0
459314,87,87,0,0,0
459322,282,282,0,0,0
459334,198,198,0,0,0
459335,255,255,0,0,0
459341,121,121,0,0,0
459346,313,313,0,0,0
459347,282,282,0,0,0
459363,8,8,0,0,0
459383,345,345,0,0,0
459396,359,359,0,0,0
459405,133,133,0,0,0
459407,184,184,0,0,0
459415,82,82,0,0,0
459421,144,144,0,0,0
459458,299,299,0,0,0
459465,246,246,0,0,0
459466,76,76,0,0,0
459471,144,144,0,0,0
459473,281,281,0,0,0
459475,315,315,0,0,0
459481,252,252,0,0,0
459485,184,184,0,0,0
459499,102,102,0,0,0
459506,114,114,0,0,0
459509,6,6,0,0,0
459513,10,10,0,0,0
459521,67,67,0,0,0
459524,168,168,0,0,0
459546,281,281,0,0,0
459550,7,7,0,0,0
459559,74,74,0,0,0
459566,306,306,0,0,0
459568,77,77,0,0,0
459574,66,66,0,0,0
459587,121,121,0,0,0
459591,23,23,0,0,0
459594,12,12,0,0,0
459596,158,158,0,0,0
459646,180,180,0,0,0
459650,282,282,0,0,0
459669,163,163,0,0,0
459679,255,255,0,0,0
459696,76,76,0,0,0
459707,259,259,0,0,0
459708,171,171,0,0,0
459713,158,158,0,0,0
459721,56,56,0,0,0
459743,74,74,0,0,0
459754,101,101,0,0,0
459765,345,345,0,0,0
459789,6,6,0,0,0
459801,3,3,0,0,0
459802,102,102,0,0,0
459841,259,259,0,0,0
459860,345,345,0,0,0
459878,128,128,0,0,0
459880,299,299,0,0,0
459883,281,281,0,0,0
459903,151,151,0,0,0
459919,121,121,0,0,0
459925,120,120,0,0,0
459933,29,29,0,0,0
459948,44,44,0,0,0
459973,251,251,0,0,0
459983,310,310,0,0,0
459996,281,281,0,0,0
460002,101,101,0,0,0
460011,306,306,0,0,0
460012,184,184,0,0,0
460014,158,158,0,0,0
460015,114,114,0,0,0
460024,137,137,0,0,0
460036,299,299,0,0,0
460047,32,32,0,0,0
460052,34,34,0,0,0
460065,102,102,0,0,0
460080,4,4,0,0,0
460093,9,9,0,0,0
460100,34,34,0,0,0
460108,77,77,0,0,0
460113,168,168,0,0,0
460129,143,143,0,0,0
460135,171,171,0,0,0
460155,23,23,0,0,0
460160,27,27,0,0,0
460163,44,44,0,0,0
460183,8,8,0,0,0
460216,6,6,0,0,0
460226,56,56,0,0,0
460229,180,180,0,0,0
460270,359,359,0,0,0
460271,22,22,0,0,0
460284,299,299,0,0,0
460295,281,281,0,0,0
460299,158,158,0,0,0
460311,114,114,0,0,0
460316,7,7,0,0,0
460329,359,359,0,0,0
460344,85,85,0,0,0
460346,102,102,0,0,0
460352,281,281,0,0,0
460369,113,113,0,0,0
460395,259,259,0,0,0
460399,310,310,0,0,0
460403,74,74,0,0,0
460407,39,39,0,0,0
460419,251,251,0,0,0
460426,102,102,0,0,0
460427,12,12,0,0,0
460451,402,402,0,0,0
460463,345,345,0,0,0
460467,315,315,0,0,0
460482,102,102,0,0,0
460501,12,12,0,0,0
460534,94,94,0,0,0
460544,114,114,0,0,0
460560,184,184,0,0,0
460562,168,168,0,0,0
460568,163,163,0,0,0
460588,137,137,0,0,0
460590,281,281,0,0,0
460600,198,198,0,0,0
460630,22,22,0,0,0
460636,152,152,0,0,0
460642,41,41,0,0,0
460658,113,113,0,0,0
460679,163,163,0,0,0
460681,29,29,0,0,0
460724,74,74,0,0,0
460739,83,83,0,0,0
460740,306,306,0,0,0
460745,34,34,0,0,0
460750,306,306,0,0,0
460751,310,310,0,0,0
460752,24,24,0,0,0
460763,315,315,0,0,0
460765,143,143,0,0,0
460769,36,36,0,0,0
460800,184,184,0,0,0
460810,345,345,0,0,0
460816,255,255,0,0,0
460835,299,299,0,0,0
460837,34,34,0,0,0
460869,128,128,0,0,0
460883,44,44,0,0,0
460889,171,171,0,0,0
460890,359,359,0,0,0
460905,281,281,0,0,0
460908,180,180,0,0,0
460913,313,313,0,0,0
460918,201,201,0,0,0
460958,306,306,0,0,0
460991,184,184,0,0,0
461007,130,130,0,0,0
461017,246,246,0,0,0
461021,353,353,0,0,0
461034,163,163,0,0,0
461037,72,72,0,0,0
461050,315,315,0,0,0
461063,63,63,0,0,0
461076,299,299,0,0,0
461085,184,184,0,0,0
461107,171,171,0,0,0
461109,306,306,0,0,0
461110,198,198,0,0,0
461113,313,313,0,0,0
461114,121,121,0,0,0
461120,113,113,0,0,0
461134,14,14,0,0,0
461136,63,63,0,0,0
461138,65,65,0,0,0
461142,114,114,0,0,0
461157,198,198,0,0,0
461166,75,75,0,0,0
461196,315,315,0,0,0
461199,133,133,0,0,0
461205,74,74,0,0,0
461209,128,128,0,0,0
461211,133,133,0,0,0
461223,137,137,0,0,0
461224,310,310,0,0,0
461235,29,29,0,0,0
461238,17,17,0,0,0
461245,281,281,0,0,0
461246,184,184,0,0,0
461249,299,299,0,0,0
461255,310,310,0,0,0
461260,306,306,0,0,0
461262,255,255,0,0,0
461282,315,315,0,0,0
461286,232,232,0,0,0
461287,402,402,0,0,0
461290,8,8,0,0,0
461292,193,193,0,0,0
461306,25,25,0,0,0
461318,83,83,0,0,0
461324,246,246,0,0,0
461335,252,252,0,0,0
461364,171,171,0,0,0
461377,281,281,0,0,0
461384,310,310,0,0,0
461388,402,402,0,0,0
461393,50,50,0,0,0
461418,151,151,0,0,0
461451,97,97,0,0,0
461455,353,353,0,0,0
461460,137,137,0,0,0
461470,252,252,0,0,0
461478,133,133,0,0,0
461479,11,11,0,0,0
461492,71,71,0,0,0
461501,76,76,0,0,0
461503,252,252,0,0,0
461505,114,114,0,0,0
461508,306,306,0,0,0
461513,39,39,0,0,0
461515,7,7,0,0,0
461517,29,29,0,0,0
461527,255,255,0,0,0
461530,87,87,0,0,0
461548,71,71,0,0,0
461549,306,306,0,0,0
461557,171,171,0,0,0
461562,34,34,0,0,0
461582,71,71,0,0,0
461604,20,20,0,0,0
461606,315,315,0,0,0
461614,9,9,0,0,0
461624,29,29,0,0,0
461634,252,252,0,0,0
461661,299,299,0,0,0
461676,281,281,0,0,0
461681,306,306,0,0,0
461707,2,2,0,0,0
461723,167,167,0,0,0
461738,6,6,0,0,0
461752,15,15,0,0,0
461758,282,282,0,0,0
461776,315,315,0,0,0
461781,29,29,0,0,0
461803,83,83,0,0,0
461805,255,255,0,0,0
461811,11,11,0,0,0
461819,252,252,0,0,0
461827,2,2,0,0,0
461831,23,23,0,0,0
461846,313,313,0,0,0
461866,299,299,0,0,0
461873,152,152,0,0,0
461880,198,198,0,0,0
461901,114,114,0,0,0
461904,163,163,0,0,0
461906,306,306,0,0,0
461918,6,6,0,0,0
461919,56,56,0,0,0
461928,315,315,0,0,0
461929,345,345,0,0,0
461932,66,66,0,0,0
461944,201,201,0,0,0
461955,167,167,0,0,0
461964,259,259,0,0,0
461966,94,94,0,0,0
461979,20,20,0,0,0
461983,198,198,0,0,0
462000,63,63,0,0,0
462054,255,255,0,0,0
462066,345,345,0,0,0
462085,255,255,0,0,0
462092,353,353,0,0,0
462100,76,76,0,0,0
462101,131,131,0,0,0
462123,29,29,0,0,0
462143,74,74,0,0,0
462182,315,315,0,0,0
462186,246,246,0,0,0
462189,121,121,0,0,0
462203,94,94,0,0,0
462210,306,306,0,0,0
462212,345,345,0,0,0
462220,201,201,0,0,0
462222,39,39,0,0,0
462273,310,310,0,0,0
462288,313,313,0,0,0
462295,114,114,0,0,0
462308,259,259,0,0,0
462317,137,137,0,0,0
462321,163,163,0,0,0
462348,251,251,0,0,0
462353,19,19,0,0,0
462364,72,72,0,0,0
462374,353,353,0,0,0
462392,114,114,0,0,0
462410,35,35,0,0,0
462418,171,171,0,0,0
462419,8,8,0,0,0
462433,3,3,0,0,0
462439,167,167,0,0,0
462447,44,44,0,0,0
462448,353,353,0,0,0
462449,151,151,0,0,0
462480,232,232,0,0,0
462482,167,167,0,0,0
462495,17,17,0,0,0
462518,198,198,0,0,0
462521,313,313,0,0,0
462543,103,103,0,0,0
462547,24,24,0,0,0
462552,16,16,0,0,0
462563,193,193,0,0,0
462592,16,16,0,0,0
462595,3,3,0,0,0
462607,252,252,0,0,0
462609,158,158,0,0,0
462620,198,198,0,0,0
462642,50,50,0,0,0
462643,132,132,0,0,0
462648,34,34,0,0,0
462650,252,252,0,0,0
462653,251,251,0,0,0
462656,27,27,0,0,0
462687,232,232,0,0,0
462694,184,184,0,0,0
462702,87,87,0,0,0
462705,113,113,0,0,0
462711,75,75,0,0,0
462730,121,121,0,0,0
462733,158,158,0,0,0
462753,315,315,0,0,0
462754,67,67,0,0,0
462755,103,103,0,0,0
462767,201,201,0,0,0
462790,402,402,0,0,0
462795,3,3,0,0,0
462811,18,18,0,0,0
462815,282,282,0,0,0
462825,131,131,0,0,0
462834,56,56,0,0,0
462851,133,133,0,0,0
462855,359,359,0,0,0
462876,180,180,0,0,0
462877,255,255,0,0,0
462899,2,2,0,0,0
462935,137,137,0,0,0
462942,10,10,0,0,0
462947,353,353,0,0,0
462954,353,353,0,0,0
462957,101,101,0,0,0
462974,120,120,0,0,0
463048,16,16,0,0,0
463056,201,201,0,0,0
463066,128,128,0,0,0
463088,121,121,0,0,0
463114,310,310,0,0,0
463131,8,8,0,0,0
463137,315,315,0,0,0
463144,72,72,0,0,0
463153,198,198,0,0,0
463166,359,359,0,0,0
463178,313,313,0,0,0
463199,76,76,0,0,0
463202,20,20,0,0,0
463211,359,359,0,0,0
463212,87,87,0,0,0
463230,2,2,0,0,0
463238,32,32,0,0,0
463246,359,359,0,0,0
463272,306,306,0,0,0
463286,143,143,0,0,0
463294,163,163,0,0,0
463297,94,94,0,0,0
463324,143,143,0,0,0
463327,184,184,0,0,0
463328,167,167,0,0,0
463341,259,259,0,0,0
463353,1,1,0,0,0
463358,113,113,0,0,0
463364,45,45,0,0,0
463365,259,259,0,0,0
463379,20,20,0,0,0
463392,151,151,0,0,0
463399,102,102,0,0,0
463428,101,101,0,0,0
463440,152,152,0,0,0
463444,69,69,0,0,0
463492,152,152,0,0,0
463498,246,246,0,0,0
463499,76,76,0,0,0
463513,255,255,0,0,0
463518,315,315,0,0,0
463525,20,20,0,0,0
463526,143,143,0,0,0
463545,40,40,0,0,0
463547,163,163,0,0,0
463550,315,315,0,0,0
463567,402,402,0,0,0
463576,184,184,0,0,0
463590,193,193,0,0,0
463595,16,16,0,0,0
463610,171,171,0,0,0
463611,359,359,0,0,0
463634,130,130,0,0,0
463635,34,34,0,0,0
463651,94,94,0,0,0
463660,255,255,0,0,0
463662,402,402,0,0,0
463674,167,167,0,0,0
463679,50,50,0,0,0
463685,252,252,0,0,0
463693,121,121,0,0,0
463699,310,310,0,0,0
463709,15,15,0,0,0
463722,246,246,0,0,0
463736,315,315,0,0,0
463746,251,251,0,0,0
463761,402,402,0,0,0
463767,55,55,0,0,0
463770,19,19,0,0,0
463771,282,282,0,0,0
463774,252,252,0,0,0
463781,282,282,0,0,0
463784,282,282,0,0,0
463801,315,315,0,0,0
463807,13,13,0,0,0
463821,133,133,0,0,0
463826,193,193,0,0,0
463837,36,36,0,0,0
463838,345,345,0,0,0
463844,144,144,0,0,0
463849,114,114,0,0,0
463881,251,251,0,0,0
463903,6,6,0,0,0
463904,121,121,0,0,0
463907,259,259,0,0,0
463910,57,57,0,0,0
463928,345,345,0,0,0
463944,306,306,0,0,0
463949,34,34,0,0,0
463954,11,11,0,0,0
463973,45,45,0,0,0
463979,313,313,0,0,0
463982,232,232,0,0,0
463988,83,83,0,0,0
463994,232,232,0,0,0
463999,6,6,0,0,0
464004,246,246,0,0,0
464007,315,315,0,0,0
464016,102,102,0,0,0
464030,345,345,0,0,0
464035,13,13,0,0,0
464068,201,201,0,0,0
464069,353,353,0,0,0
464074,137,137,0,0,0
464101,402,402,0,0,0
464111,246,246,0,0,0
464112,282,282,0,0,0
464115,143,143,0,0,0
464120,63,63,0,0,0
464121,158,158,0,0,0
464122,12,12,0,0,0
464133,137,137,0,0,0
464136,2,2,0,0,0
464166,3,3,0,0,0
464178,184,184,0,0,0
464179,345,345,0,0,0
464183,137,137,0,0,0
464200,255,255,0,0,0
464225,50,50,0,0,0
464227,39,39,0,0,0
464233,113,113,0,0,0
464269,201,201,0,0,0
464273,72,72,0,0,0
464279,17,17,0,0,0
464293,69,69,0,0,0
464298,15,15,0,0,0
464311,128,128,0,0,0
464317,315,315,0,0,0
464340,353,353,0,0,0
464343,55,55,0,0,0
464360,402,402,0,0,0
464376,22,22,0,0,0
464385,87,87,0,0,0
464386,252,252,0,0,0
464394,10,10,0,0,0
464400,359,359,0,0,0
464409,345,345,0,0,0
464410,282,282,0,0,0
464414,2,2,0,0,0
464417,94,94,0,0,0
464433,184,184,0,0,0
464459,299,299,0,0,0
464464,359,359,0,0,0
464508,246,246,0,0,0
464515,76,76,0,0,0
464527,114,114,0,0,0
464534,131,131,0,0,0
464543,121,121,0,0,0
464552,359,359,0,0,0
464577,2,2,0,0,0
464584,7,7,0,0,0
464589,163,163,0,0,0
464609,259,259,0,0,0
464625,310,310,0,0,0
464651,171,171,0,0,0
464659,353,353,0,0,0
464693,252,252,0,0,0
464697,137,137,0,0,0
464701,353,353,0,0,0
464719,246,246,0,0,0
464739,7,7,0,0,0
464754,251,251,0,0,0
464758,29,29,0,0,0
464771,359,359,0,0,0
464774,158,158,0,0,0
464793,315,315,0,0,0
464807,184,184,0,0,0
464822,144,144,0,0,0
464841,8,8,0,0,0
464872,310,310,0,0,0
464874,75,75,0,0,0
464915,201,201,0,0,0
464923,103,103,0,0,0
464930,252,252,0,0,0
464935,402,402,0,0,0
464943,103,103,0,0,0
464947,345,345,0,0,0
464949,232,232,0,0,0
464963,50,50,0,0,0
464970,69,69,0,0,0
464972,70,70,0,0,0
464979,36,36,0,0,0
465014,74,74,0,0,0
465016,19,19,0,0,0
465019,39,39,0,0,0
465022,193,193,0,0,0
465065,3,3,0,0,0
465066,17,17,0,0,0
465073,3,3,0,0,0
465082,15,15,0,0,0
465094,137,137,0,0,0
465106,151,151,0,0,0
465107,353,353,0,0,0
465112,70,70,0,0,0
465120,3,3,0,0,0
465141,252,252,0,0,0
465155,102,102,0,0,0
465170,56,56,0,0,0
465172,69,69,0,0,0
465203,198,198,0,0,0
465207,255,255,0,0,0
465211,50,50,0,0,0
465243,345,345,0,0,0
465244,402,402,0,0,0
465266,9,9,0,0,0
465274,102,102,0,0,0
465283,299,299,0,0,0
465294,15,15,0,0,0
465299,201,201,0,0,0
465307,315,315,0,0,0
465332,57,57,0,0,0
465335,137,137,0,0,0
465339,345,345,0,0,0
465367,30,30,0,0,0
465381,252,252,0,0,0
465382,131,131,0,0,0
465391,35,35,0,0,0
465420,180,180,0,0,0
465438,5,5,0,0,0
465444,19,19,0,0,0
465445,11,11,0,0,0
465448,168,168,0,0,0
465453,193,193,0,0,0
465461,1,1,0,0,0
465469,113,113,0,0,0
465481,201,201,0,0,0
465488,30,30,0,0,0
465508,54,54,0,0,0
465519,259,259,0,0,0
465522,345,345,0,0,0
465542,128,128,0,0,0
465551,70,70,0,0,0
465583,232,232,0,0,0
465593,94,94,0,0,0
465594,402,402,0,0,0
465606,65,65,0,0,0
465615,2,2,0,0,0
465622,315,315,0,0,0
465650,282,282,0,0,0
465652,97,97,0,0,0
465663,158,158,0,0,0
465665,8,8,0,0,0
465670,120,120,0,0,0
465689,30,30,0,0,0
465704,281,281,0,0,0
465711,359,359,0,0,0
465718,282,282,0,0,0
465723,306,306,0,0,0
465727,137,137,0,0,0
465733,113,113,0,0,0
465763,345,345,0,0,0
465773,102,102,0,0,0
465778,114,114,0,0,0
465797,3,3,0,0,0
465800,102,102,0,0,0
465812,76,76,0,0,0
465816,402,402,0,0,0
465820,282,282,0,0,0
465822,44,44,0,0,0
465824,128,128,0,0,0
465825,137,137,0,0,0
465840,70,70,0,0,0
465850,315,315,0,0,0
465864,39,39,0,0,0
465895,252,252,0,0,0
465924,103,103,0,0,0
465936,163,163,0,0,0
465953,87,87,0,0,0
465995,402,402,0,0,0
465998,12,12,0,0,0
465999,50,50,0,0,0
466023,163,163,0,0,0
466033,251,251,0,0,0
466062,232,232,0,0,0
466074,137,137,0,0,0
466109,313,313,0,0,0
466115,313,313,0,0,0
466132,114,114,0,0,0
466153,22,22,0,0,0
466154,144,144,0,0,0
466183,282,282,0,0,0
466202,133,133,0,0,0
466222,8,8,0,0,0
466229,299,299,0,0,0
466240,281,281,0,0,0
466241,50,50,0,0,0
466259,232,232,0,0,0
466296,310,310,0,0,0
466305,299,299,0,0,0
466312,137,137,0,0,0
466315,299,299,0,0,0
466342,152,152,0,0,0
466364,24,24,0,0,0
466378,22,22,0,0,0
466403,133,133,0,0,0
466407,143,143,0,0,0
466411,74,74,0,0,0
466414,41,41,0,0,0
466416,11,11,0,0,0
466427,102,102,0,0,0
466434,232,232,0,0,0
466442,121,121,0,0,0
466464,232,232,0,0,0
466480,74,74,0,0,0
466486,306,306,0,0,0
466496,16,16,0,0,0
466509,402,402,0,0,0
466518,43,43,0,0,0
466548,36,36,0,0,0
466558,137,137,0,0,0
466567,114,114,0,0,0
466575,152,152,0,0,0
466576,168,168,0,0,0
466587,128,128,0,0,0
466599,193,193,0,0,0
466600,9,9,0,0,0
466603,103,103,0,0,0
466625,167,167,0,0,0
466634,359,359,0,0,0
466649,281,281,0,0,0
466660,128,128,0,0,0
466665,313,313,0,0,0
466709,313,313,0,0,0
466710,402,402,0,0,0
466715,113,113,0,0,0
466721,36,36,0,0,0
466728,180,180,0,0,0
466738,259,259,0,0,0
466752,246,246,0,0,0
466780,12,12,0,0,0
466786,345,345,0,0,0
466787,232,232,0,0,0
466789,359,359,0,0,0
466809,77,77,0,0,0
466811,313,313,0,0,0
466819,251,251,0,0,0
466823,310,310,0,0,0
466834,163,163,0,0,0
466838,71,71,0,0,0
466861,75,75,0,0,0
466866,41,41,0,0,0
466883,2,2,0,0,0
466889,74,74,0,0,0
466893,29,29,0,0,0
466904,306,306,0,0,0
466928,34,34,0,0,0
466943,56,56,0,0,0
466962,184,184,0,0,0
466972,50,50,0,0,0
466976,359,359,0,0,0
466985,29,29,0,0,0
466998,353,353,0,0,0
467006,114,114,0,0,0
467008,16,16,0,0,0
467019,74,74,0,0,0
467035,103,103,0,0,0
467036,144,144,0,0,0
467049,193,193,0,0,0
467056,151,151,0,0,0
467060,27,27,0,0,0
467076,345,345,0,0,0
467092,345,345,0,0,0
467097,193,193,0,0,0
467108,255,255,0,0,0
467124,130,130,0,0,0
467142,75,75,0,0,0
467145,70,70,0,0,0
467156,63,63,0,0,0
467164,252,252,0,0,0
467186,16,16,0,0,0
467204,282,282,0,0,0
467218,246,246,0,0,0
467233,8,8,0,0,0
467234,252,252,0,0,0
467239,13,13,0,0,0
467242,402,402,0,0,0
467249,246,246,0,0,0
467282,1,1,0,0,0
467291,137,137,0,0,0
467292,18,18,0,0,0
467296,76,76,0,0,0
467299,246,246,0,0,0
467304,25,25,0,0,0
467308,71,71,0,0,0
467313,184,184,0,0,0
467326,359,359,0,0,0
467334,359,359,0,0,0
467344,313,313,0,0,0
467356,133,133,0,0,0
467361,402,402,0,0,0
467363,232,232,0,0,0
467371,35,35,0,0,0
467372,201,201,0,0,0
467381,315,315,0,0,0
467401,252,252,0,0,0
467407,251,251,0,0,0
467412,143,143,0,0,0
467453,113,113,0,0,0
467464,246,246,0,0,0
467466,359,359,0,0,0
467467,24,24,0,0,0
467478,7,7,0,0,0
467513,193,193,0,0,0
467514,8,8,0,0,0
467516,180,180,0,0,0
467521,34,34,0,0,0
467526,76,76,0,0,0
467549,24,24,0,0,0
467582,281,281,0,0,0
467604,299,299,0,0,0
467611,35,35,0,0,0
467624,121,121,0,0,0
467637,281,281,0,0,0
467656,12,12,0,0,0
467671,50,50,0,0,0
467672,131,131,0,0,0
467709,163,163,0,0,0
467730,359,359,0,0,0
467746,299,299,0,0,0
467754,345,345,0,0,0
467763,2,2,0,0,0
467767,402,402,0,0,0
467768,70,70,0,0,0
467787,171,171,0,0,0
467796,158,158,0,0,0
467804,74,74,0,0,0
467805,232,232,0,0,0
467832,345,345,0,0,0
467838,259,259,0,0,0
467844,232,232,0,0,0
467881,131,131,0,0,0
467896,77,77,0,0,0
467897,281,281,0,0,0
467929,171,171,0,0,0
467934,137,137,0,0,0
467936,259,259,0,0,0
467944,306,306,0,0,0
467955,171,171,0,0,0
467979,168,168,0,0,0
467985,2,2,0,0,0
467989,65,65,0,0,0
467995,17,17,0,0,0
468001,143,143,0,0,0
468003,70,70,0,0,0
468012,25,25,0,0,0
468019,70,70,0,0,0
468020,144,144,0,0,0
468026,137,137,0,0,0
468039,184,184,0,0,0
468044,69,69,0,0,0
468046,259,259,0,0,0
468058,306,306,0,0,0
468069,44,44,0,0,0
468083,17,17,0,0,0
468090,246,246,0,0,0
468116,137,137,0,0,0
468118,85,85,0,0,0
468119,259,259,0,0,0
468133,313,313,0,0,0
468141,152,152,0,0,0
468154,259,259,0,0,0
468162,102,102,0,0,0
468175,310,310,0,0,0
468176,345,345,0,0,0
468188,66,66,0,0,0
468190,20,20,0,0,0
468199,359,359,0,0,0
468211,94,94,0,0,0
468216,402,402,0,0,0
468236,102,102,0,0,0
468237,131,131,0,0,0
468265,13,13,0,0,0
468285,40,40,0,0,0
468291,44,44,0,0,0
468296,259,259,0,0,0
468299,402,402,0,0,0
468327,306,306,0,0,0
468334,102,102,0,0,0
468354,167,167,0,0,0
468356,171,171,0,0,0
468359,20,20,0,0,0
468376,101,101,0,0,0
468406,313,313,0,0,0
468421,306,306,0,0,0
468446,255,255,0,0,0
468473,82,82,0,0,0
468479,94,94,0,0,0
468488,299,299,0,0,0
468509,6,6,0,0,0
468519,66,66,0,0,0
468520,402,402,0,0,0
468544,76,76,0,0,0
468550,144,144,0,0,0
468558,152,152,0,0,0
468560,24,24,0,0,0
468567,315,315,0,0,0
468570,54,54,0,0,0
468580,102,102,0,0,0
468589,402,402,0,0,0
468599,359,359,0,0,0
468600,252,252,0,0,0
468623,281,281,0,0,0
468648,313,313,0,0,0
468652,246,246,0,0,0
468681,252,252,0,0,0
468703,315,315,0,0,0
468729,201,201,0,0,0
468734,306,306,0,0,0
468735,402,402,0,0,0
468748,131,131,0,0,0
468750,255,255,0,0,0
468774,345,345,0,0,0
468778,133,133,0,0,0
468784,120,120,0,0,0
468787,151,151,0,0,0
468807,5,5,0,0,0
468816,94,94,0,0,0
468817,151,151,0,0,0
468826,306,306,0,0,0
468838,255,255,0,0,0
468848,137,137,0,0,0
468851,315,315,0,0,0
468853,310,310,0,0,0
468856,353,353,0,0,0
468860,353,353,0,0,0
468864,103,103,0,0,0
468865,402,402,0,0,0
468866,163,163,0,0,0
468875,281,281,0,0,0
468908,121,121,0,0,0
468912,232,232,0,0,0
468917,158,158,0,0,0
468959,251,251,0,0,0
468962,22,22,0,0,0
468967,232,232,0,0,0
468993,281,281,0,0,0
469003,54,54,0,0,0
469030,120,120,0,0,0
469031,69,69,0,0,0
469041,255,255,0,0,0
469048,167,167,0,0,0
469049,63,63,0,0,0
469054,72,72,0,0,0
469073,76,76,0,0,0
469076,74,74,0,0,0
469097,402,402,0,0,0
469109,310,310,0,0,0
469112,252,252,0,0,0
469116,77,77,0,0,0
469117,85,85,0,0,0
469118,198,198,0,0,0
469121,171,171,0,0,0
469130,353,353,0,0,0
469141,282,282,0,0,0
469143,232,232,0,0,0
469146,143,143,0,0,0
469154,97,97,0,0,0
469160,310,310,0,0,0
469178,232,232,0,0,0
469195,50,50,0,0,0
469197,133,133,0,0,0
469205,359,359,0,0,0
469224,43,43,0,0,0
469234,313,313,0,0,0
469241,310,310,0,0,0
469244,103,103,0,0,0
469261,152,152,0,0,0
469271,281,281,0,0,0
469272,101,101,0,0,0
469278,158,158,0,0,0
469292,70,70,0,0,0
469297,313,313,0,0,0
469299,246,246,0,0,0
469312,353,353,0,0,0
469324,121,121,0,0,0
469335,113,113,0,0,0
469346,144,144,0,0,0
469347,282,282,0,0,0
469371,17,17,0,0,0
469378,121,121,0,0,0
469381,251,251,0,0,0
469382,353,353,0,0,0
469386,246,246,0,0,0
469390,29,29,0,0,0
469393,151,151,0,0,0
469403,130,130,0,0,0
469430,128,128,0,0,0
469437,75,75,0,0,0
469459,246,246,0,0,0
469480,310,310,0,0,0
469493,310,310,0,0,0
469515,103,103,0,0,0
469528,7,7,0,0,0
469537,137,137,0,0,0
469549,158,158,0,0,0
469574,70,70,0,0,0
469576,137,137,0,0,0
469580,353,353,0,0,0
469604,168,168,0,0,0
469606,193,193,0,0,0
469616,85,85,0,0,0
469617,353,353,0,0,0
469621,87,87,0,0,0
469622,17,17,0,0,0
469623,22,22,0,0,0
469630,70,70,0,0,0
469634,102,102,0,0,0
469635,18,18,0,0,0
469657,299,299,0,0,0
469664,180,180,0,0,0
469685,3,3,0,0,0
469694,18,18,0,0,0
469696,15,15,0,0,0
469710,63,63,0,0,0
469722,353,353,0,0,0
469730,17,17,0,0,0
469740,29,29,0,0,0
469756,43,43,0,0,0
469766,151,151,0,0,0
469769,11,11,0,0,0
469770,75,75,0,0,0
469792,306,306,0,0,0
469803,282,282,0,0,0
469820,25,25,0,0,0
469828,282,282,0,0,0
469843,259,259,0,0,0
469844,8,8,0,0,0
469846,114,114,0,0,0
469847,121,121,0,0,0
469870,151,151,0,0,0
469874,14,14,0,0,0
469882,282,282,0,0,0
469889,97,97,0,0,0
469946,102,102,0,0,0
469950,76,76,0,0,0
469952,101,101,0,0,0
469953,12,12,0,0,0
469981,313,313,0,0,0
469999,198,198,0,0,0
470013,299,299,0,0,0
470019,281,281,0,0,0
470026,345,345,0,0,0
470032,198,198,0,0,0
470045,180,180,0,0,0
470046,306,306,0,0,0
470062,131,131,0,0,0
470067,246,246,0,0,0
470095,359,359,0,0,0
470116,44,44,0,0,0
470125,8,8,0,0,0
470128,120,120,0,0,0
470140,310,310,0,0,0
470144,282,282,0,0,0
470145,77,77,0,0,0
470155,16,16,0,0,0
470177,255,255,0,0,0
470186,76,76,0,0,0
470195,29,29,0,0,0
470221,184,184,0,0,0
470232,353,353,0,0,0
470283,144,144,0,0,0
470289,121,121,0,0,0
470290,40,40,0,0,0
470302,252,252,0,0,0
470309,57,57,0,0,0
470313,246,246,0,0,0
470327,27,27,0,0,0
470330,65,65,0,0,0
470341,15,15,0,0,0
470343,17,17,0,0,0
470354,63,63,0,0,0
470355,313,313,0,0,0
470365,34,34,0,0,0
470369,152,152,0,0,0
470386,17,17,0,0,0
470390,34,34,0,0,0
470411,120,120,0,0,0
470414,232,232,0,0,0
470448,310,310,0,0,0
470466,24,24,0,0,0
470482,102,102,0,0,0
470490,359,359,0,0,0
470494,171,171,0,0,0
470508,74,74,0,0,0
470520,313,313,0,0,0
470525,76,76,0,0,0
470532,402,402,0,0,0
470534,121,121,0,0,0
470555,11,11,0,0,0
470581,54,54,0,0,0
470627,65,65,0,0,0
470635,75,75,0,0,0
470650,282,282,0,0,0
470658,45,45,0,0,0
470670,180,180,0,0,0
470685,259,259,0,0,0
470703,259,259,0,0,0
470704,345,345,0,0,0
470711,345,345,0,0,0
470715,313,313,0,0,0
470720,44,44,0,0,0
470724,143,143,0,0,0
470752,306,306,0,0,0
470755,8,8,0,0,0
470768,255,255,0,0,0
470794,193,193,0,0,0
470797,246,246,0,0,0
470804,74,74,0,0,0
470812,5,5,0,0,0
470824,255,255,0,0,0
470853,151,151,0,0,0
470855,315,315,0,0,0
470899,252,252,0,0,0
470929,77,77,0,0,0
470945,76,76,0,0,0
470971,299,299,0,0,0
470982,69,69,0,0,0
470983,83,83,0,0,0
471021,120,120,0,0,0
471030,402,402,0,0,0
471034,345,345,0,0,0
471057,74,74,0,0,0
471061,171,171,0,0,0
471068,306,306,0,0,0
471142,102,102,0,0,0
471143,353,353,0,0,0
471146,359,359,0,0,0
471148,184,184,0,0,0
471157,7,7,0,0,0
471164,313,313,0,0,0
471165,5,5,0,0,0
471185,97,97,0,0,0
471189,255,255,0,0,0
471190,137,137,0,0,0
471192,246,246,0,0,0
471193,120,120,0,0,0
471215,70,70,0,0,0
471220,310,310,0,0,0
471227,36,36,0,0,0
471230,251,251,0,0,0
471283,252,252,0,0,0
471330,255,255,0,0,0
471352,83,83,0,0,0
471358,143,143,0,0,0
471384,130,130,0,0,0
471394,193,193,0,0,0
471404,1,1,0,0,0
471426,345,345,0,0,0
471433,246,246,0,0,0
471434,4,4,0,0,0
471450,151,151,0,0,0
471457,121,121,0,0,0
471465,72,72,0,0,0
471482,167,167,0,0,0
471504,184,184,0,0,0
471505,44,44,0,0,0
471574,353,353,0,0,0
471577,121,121,0,0,0
471582,76,76,0,0,0
471592,198,198,0,0,0
471598,402,402,0,0,0
471617,402,402,0,0,0
471619,137,137,0,0,0
471620,167,167,0,0,0
471637,201,201,0,0,0
471639,10,10,0,0,0
471642,251,251,0,0,0
471644,120,120,0,0,0
471677,22,22,0,0,0
471685,36,36,0,0,0
471690,74,74,0,0,0
471699,137,137,0,0,0
471717,120,120,0,0,0
471730,255,255,0,0,0
471739,310,310,0,0,0
471751,299,299,0,0,0
471772,232,232,0,0,0
471779,310,310,0,0,0
471781,20,20,0,0,0
471794,22,22,0,0,0
471796,137,137,0,0,0
471803,102,102,0,0,0
471826,163,163,0,0,0
471842,57,57,0,0,0
471843,345,345,0,0,0
471846,310,310,0,0,0
471855,24,24,0,0,0
471857,310,310,0,0,0
471884,345,345,0,0,0
471891,402,402,0,0,0
471916,402,402,0,0,0
471933,55,55,0,0,0
471940,315,315,0,0,0
471951,315,315,0,0,0
471959,6,6,0,0,0
471973,251,251,0,0,0
471978,74,74,0,0,0
472002,144,144,0,0,0
472021,402,402,0,0,0
472042,359,359,0,0,0
472076,94,94,0,0,0
472080,114,114,0,0,0
472106,102,102,0,0,0
472117,133,133,0,0,0
472128,30,30,0,0,0
472140,281,281,0,0,0
472176,359,359,0,0,0
472187,94,94,0,0,0
472188,163,163,0,0,0
472190,359,359,0,0,0
472191,255,255,0,0,0
472196,143,143,0,0,0
472224,103,103,0,0,0
472237,281,281,0,0,0
472243,251,251,0,0,0
472248,121,121,0,0,0
472251,167,167,0,0,0
472254,76,76,0,0,0
472261,76,76,0,0,0
472266,282,282,0,0,0
472267,402,402,0,0,0
472268,281,281,0,0,0
472273,25,25,0,0,0
472279,113,113,0,0,0
472288,19,19,0,0,0
472301,114,114,0,0,0
472302,251,251,0,0,0
472312,75,75,0,0,0
472321,87,87,0,0,0
472326,359,359,0,0,0
472340,345,345,0,0,0
472351,180,180,0,0,0
472359,19,19,0,0,0
472362,315,315,0,0,0
472372,9,9,0,0,0
472379,158,158,0,0,0
472380,353,353,0,0,0
472385,102,102,0,0,0
472393,29,29,0,0,0
472395,20,20,0,0,0
472398,113,113,0,0,0
472400,167,167,0,0,0
472401,201,201,0,0,0
472406,44,44,0,0,0
472408,158,158,0,0,0
472428,143,143,0,0,0
472429,402,402,0,0,0
472449,29,29,0,0,0
472460,27,27,0,0,0
472462,69,69,0,0,0
472480,10,10,0,0,0
472498,151,151,0,0,0
472507,402,402,0,0,0
472545,101,101,0,0,0
472574,128,128,0,0,0
472575,87,87,0,0,0
472586,158,158,0,0,0
472598,63,63,0,0,0
472606,143,143,0,0,0
472608,201,201,0,0,0
472624,18,18,0,0,0
472641,1,1,0,0,0
472648,40,40,0,0,0
472649,184,184,0,0,0
472656,114,114,0,0,0
472683,94,94,0,0,0
472705,3,3,0,0,0
472782,103,103,0,0,0
472794,120,120,0,0,0
472796,103,103,0,0,0
472804,97,97,0,0,0
472820,45,45,0,0,0
472835,103,103,0,0,0
472838,198,198,0,0,0
472849,36,36,0,0,0
472855,310,310,0,0,0
472864,66,66,0,0,0
472888,74,74,0,0,0
472912,402,402,0,0,0
472918,345,345,0,0,0
472920,1,1,0,0,0
472930,87,87,0,0,0
472939,345,345,0,0,0
472976,143,143,0,0,0
472981,184,184,0,0,0
472985,251,251,0,0,0
472997,131,131,0,0,0
473022,25,25,0,0,0
473023,101,101,0,0,0
473042,252,252,0,0,0
473050,102,102,0,0,0
473051,151,151,0,0,0
473058,45,45,0,0,0
473073,198,198,0,0,0
473080,310,310,0,0,0
473083,72,72,0,0,0
473084,201,201,0,0,0
473095,359,359,0,0,0
473109,281,281,0,0,0
473126,54,54,0,0,0
473134,151,151,0,0,0
473164,180,180,0,0,0
473171,299,299,0,0,0
473192,402,402,0,0,0
473196,29,29,0,0,0
473203,299,299,0,0,0
473210,315,315,0,0,0
473216,345,345,0,0,0
473232,246,246,0,0,0
473282,121,121,0,0,0
473283,313,313,0,0,0
473295,315,315,0,0,0
473307,74,74,0,0,0
473319,137,137,0,0,0
473320,402,402,0,0,0
473337,251,251,0,0,0
473354,133,133,0,0,0
473355,402,402,0,0,0
473364,259,259,0,0,0
473373,19,19,0,0,0
473377,76,76,0,0,0
473401,246,246,0,0,0
473423,121,121,0,0,0
473428,24,24,0,0,0
473430,402,402,0,0,0
473436,402,402,0,0,0
473442,151,151,0,0,0
473449,137,137,0,0,0
473464,251,251,0,0,0
473477,27,27,0,0,0
473486,163,163,0,0,0
473513,2,2,0,0,0
473526,359,359,0,0,0
473552,259,259,0,0,0
473564,259,259,0,0,0
473566,184,184,0,0,0
473569,39,39,0,0,0
473582,94,94,0,0,0
473587,168,168,0,0,0
473592,402,402,0,0,0
473596,75,75,0,0,0
473603,10,10,0,0,0
473605,43,43,0,0,0
473610,299,299,0,0,0
473624,9,9,0,0,0
473633,43,43,0,0,0
473634,152,152,0,0,0
473638,345,345,0,0,0
473663,184,184,0,0,0
473669,12,12,0,0,0
473710,313,313,0,0,0
473734,353,353,0,0,0
473743,34,34,0,0,0
473752,282,282,0,0,0
473753,251,251,0,0,0
473778,87,87,0,0,0
473779,44,44,0,0,0
473784,359,359,0,0,0
473786,282,282,0,0,0
473787,255,255,0,0,0
473791,39,39,0,0,0
473813,36,36,0,0,0
473829,120,120,0,0,0
473832,133,133,0,0,0
473834,232,232,0,0,0
473847,359,359,0,0,0
473878,180,180,0,0,0
473881,5,5,0,0,0
473890,171,171,0,0,0
473892,9,9,0,0,0
473895,299,299,0,0,0
473902,282,282,0,0,0
473915,310,310,0,0,0
473921,41,41,0,0,0
473931,137,137,0,0,0
473932,152,152,0,0,0
473937,158,158,0,0,0
473961,71,71,0,0,0
473962,359,359,0,0,0
473963,14,14,0,0,0
473967,121,121,0,0,0
473971,137,137,0,0,0
473983,55,55,0,0,0
473986,65,65,0,0,0
473998,87,87,0,0,0
474000,402,402,0,0,0
474008,306,306,0,0,0
474011,251,251,0,0,0
474023,313,313,0,0,0
474025,201,201,0,0,0
474028,315,315,0,0,0
474037,402,402,0,0,0
474041,113,113,0,0,0
474053,402,402,0,0,0
474080,57,57,0,0,0
474087,282,282,0,0,0
474089,137,137,0,0,0
474094,171,171,0,0,0
474097,19,19,0,0,0
474098,167,167,0,0,0
474100,77,77,0,0,0
474105,128,128,0,0,0
474122,255,255,0,0,0
474160,44,44,0,0,0
474161,402,402,0,0,0
474171,18,18,0,0,0
474176,75,75,0,0,0
474193,282,282,0,0,0
474196,281,281,0,0,0
474200,20,20,0,0,0
474211,345,345,0,0,0
474228,2,2,0,0,0
474230,55,55,0,0,0
474244,76,76,0,0,0
474247,167,167,0,0,0
474265,17,17,0,0,0
474287,44,44,0,0,0
474291,143,143,0,0,0
474292,4,4,0,0,0
474303,168,168,0,0,0
474321,103,103,0,0,0
474346,310,310,0,0,0
474363,13,13,0,0,0
474367,232,232,0,0,0
474378,85,85,0,0,0
474397,56,56,0,0,0
474407,259,259,0,0,0
474409,87,87,0,0,0
474428,130,130,0,0,0
474438,56,56,0,0,0
474439,345,345,0,0,0
474447,359,359,0,0,0
474465,137,137,0,0,0
474469,359,359,0,0,0
474481,15,15,0,0,0
474500,132,132,0,0,0
474503,74,74,0,0,0
474504,29,29,0,0,0
474509,41,41,0,0,0
474526,5,5,0,0,0
474545,8,8,0,0,0
474581,35,35,0,0,0
474593,74,74,0,0,0
474595,232,232,0,0,0
474602,29,29,0,0,0
474603,259,259,0,0,0
474609,184,184,0,0,0
474622,193,193,0,0,0
474637,306,306,0,0,0
474644,19,19,0,0,0
474646,74,74,0,0,0
474654,184,184,0,0,0
474658,22,22,0,0,0
474685,27,27,0,0,0
474688,10,10,0,0,0
474695,128,128,0,0,0
474703,246,246,0,0,0
474715,101,101,0,0,0
474732,29,29,0,0,0
474738,75,75,0,0,0
474739,130,130,0,0,0
474760,152,152,0,0,0
474769,315,315,0,0,0
474780,152,152,0,0,0
474788,310,310,0,0,0
474798,246,246,0,0,0
474810,184,184,0,0,0
474817,7,7,0,0,0
474818,259,259,0,0,0
474820,44,44,0,0,0
474829,310,310,0,0,0
474832,131,131,0,0,0
474837,22,22,0,0,0
474838,11,11,0,0,0
474869,193,193,0,0,0
474874,94,94,0,0,0
474882,82,82,0,0,0
474883,74,74,0,0,0
474889,14,14,0,0,0
474899,97,97,0,0,0
474901,299,299,0,0,0
474903,70,70,0,0,0
474912,201,201,0,0,0
474921,4,4,0,0,0
474926,19,19,0,0,0
474930,310,310,0,0,0
474932,43,43,0,0,0
474948,158,158,0,0,0
474966,198,198,0,0,0
474981,12,12,0,0,0
474984,359,359,0,0,0
474998,102,102,0,0,0
475016,152,152,0,0,0
475024,252,252,0,0,0
475055,10,10,0,0,0
475075,299,299,0,0,0
475076,83,83,0,0,0
475087,76,76,0,0,0
475108,151,151,0,0,0
475113,121,121,0,0,0
475143,17,17,0,0,0
475154,35,35,0,0,0
475157,167,167,0,0,0
475164,27,27,0,0,0
475185,2,2,0,0,0
475186,353,353,0,0,0
475193,130,130,0,0,0
475200,63,63,0,0,0
475213,103,103,0,0,0
475221,10,10,0,0,0
475228,5,5,0,0,0
475242,121,121,0,0,0
475250,44,44,0,0,0
475259,55,55,0,0,0
475269,281,281,0,0,0
475289,255,255,0,0,0
475296,83,83,0,0,0
475312,171,171,0,0,0
475343,201,201,0,0,0
475346,74,74,0,0,0
475347,299,299,0,0,0
475349,151,151,0,0,0
475353,281,281,0,0,0
475356,102,102,0,0,0
475363,101,101,0,0,0
475366,137,137,0,0,0
475379,167,167,0,0,0
475381,201,201,0,0,0
475398,310,310,0,0,0
475407,310,310,0,0,0
475410,251,251,0,0,0
475421,25,25,0,0,0
475425,158,158,0,0,0
475434,8,8,0,0,0
475438,102,102,0,0,0
475462,402,402,0,0,0
475466,137,137,0,0,0
475493,28,28,0,0,0
475503,168,168,0,0,0
475507,1,1,0,0,0
475508,281,281,0,0,0
475509,70,70,0,0,0
475512,41,41,0,0,0
475519,315,315,0,0,0
475523,252,252,0,0,0
475529,306,306,0,0,0
475533,299,299,0,0,0
475535,74,74,0,0,0
475568,246,246,0,0,0
475573,103,103,0,0,0
475598,13,13,0,0,0
475605,315,315,0,0,0
475611,359,359,0,0,0
475639,255,255,0,0,0
475648,255,255,0,0,0
475653,121,121,0,0,0
475673,345,345,0,0,0
475683,255,255,0,0,0
475700,114,114,0,0,0
475703,259,259,0,0,0
475712,299,299,0,0,0
475720,163,163,0,0,0
475744,83,83,0,0,0
475767,251,251,0,0,0
475769,76,76,0,0,0
475775,180,180,0,0,0
475810,102,102,0,0,0
475812,251,251,0,0,0
475819,102,102,0,0,0
475829,8,8,0,0,0
475836,76,76,0,0,0
475847,8,8,0,0,0
475848,65,65,0,0,0
475861,306,306,0,0,0
475881,76,76,0,0,0
475888,76,76,0,0,0
475906,306,306,0,0,0
475908,121,121,0,0,0
475914,163,163,0,0,0
475921,102,102,0,0,0
475929,34,34,0,0,0
475938,315,315,0,0,0
475941,41,41,0,0,0
475944,76,76,0,0,0
475956,137,137,0,0,0
475971,310,310,0,0,0
475976,232,232,0,0,0
475992,168,168,0,0,0
476010,168,168,0,0,0
476011,345,345,0,0,0
476013,259,259,0,0,0
476025,19,19,0,0,0
476047,259,259,0,0,0
476049,54,54,0,0,0
476053,163,163,0,0,0
476062,44,44,0,0,0
476071,4,4,0,0,0
476076,193,193,0,0,0
476088,313,313,0,0,0
476089,246,246,0,0,0
476090,255,255,0,0,0
476099,313,313,0,0,0
476101,201,201,0,0,0
476107,11,11,0,0,0
476120,130,130,0,0,0
476128,402,402,0,0,0
476135,14,14,0,0,0
476142,353,353,0,0,0
476146,133,133,0,0,0
476152,402,402,0,0,0
476160,103,103,0,0,0
476172,121,121,0,0,0
476186,24,24,0,0,0
476189,121,121,0,0,0
476197,2,2,0,0,0
476204,87,87,0,0,0
476233,10,10,0,0,0
476238,67,67,0,0,0
476244,17,17,0,0,0
476269,299,299,0,0,0
476278,77,77,0,0,0
476286,16,16,0,0,0
476289,306,306,0,0,0
476301,315,315,0,0,0
476304,152,152,0,0,0
476319,25,25,0,0,0
476328,315,315,0,0,0
476330,114,114,0,0,0
476345,246,246,0,0,0
476353,102,102,0,0,0
476367,17,17,0,0,0
476420,251,251,0,0,0
476423,77,77,0,0,0
476427,184,184,0,0,0
476439,63,63,0,0,0
476447,16,16,0,0,0
476468,158,158,0,0,0
476472,130,130,0,0,0
476501,13,13,0,0,0
476504,345,345,0,0,0
476526,255,255,0,0,0
476527,152,152,0,0,0
476540,310,310,0,0,0
476545,144,144,0,0,0
476558,50,50,0,0,0
476580,137,137,0,0,0
476587,27,27,0,0,0
476602,103,103,0,0,0
476622,184,184,0,0,0
476633,251,251,0,0,0
476638,19,19,0,0,0
476648,315,315,0,0,0
476652,281,281,0,0,0
476653,345,345,0,0,0
476674,306,306,0,0,0
476682,315,315,0,0,0
476685,359,359,0,0,0
476686,22,22,0,0,0
476701,12,12,0,0,0
476708,310,310,0,0,0
476718,306,306,0,0,0
476737,13,13,0,0,0
476749,198,198,0,0,0
476752,281,281,0,0,0
476791,20,20,0,0,0
476813,152,152,0,0,0
476821,306,306,0,0,0
476841,310,310,0,0,0
476875,74,74,0,0,0
476882,193,193,0,0,0
476884,168,168,0,0,0
476885,22,22,0,0,0
476893,353,353,0,0,0
476927,313,313,0,0,0
476930,315,315,0,0,0
476931,251,251,0,0,0
476933,144,144,0,0,0
476941,72,72,0,0,0
476966,101,101,0,0,0
476977,313,313,0,0,0
476979,25,25,0,0,0
476991,299,299,0,0,0
477015,67,67,0,0,0
477018,2,2,0,0,0
477020,121,121,0,0,0
477021,198,198,0,0,0
477039,137,137,0,0,0
477046,30,30,0,0,0
477062,313,313,0,0,0
477083,20,20,0,0,0
477084,102,102,0,0,0
477090,259,259,0,0,0
477091,232,232,0,0,0
477099,144,144,0,0,0
477123,103,103,0,0,0
477127,131,131,0,0,0
477131,71,71,0,0,0
477151,133,133,0,0,0
477168,151,151,0,0,0
477194,246,246,0,0,0
477210,171,171,0,0,0
477213,83,83,0,0,0
477214,345,345,0,0,0
477223,74,74,0,0,0
477246,359,359,0,0,0
477264,313,313,0,0,0
477289,315,315,0,0,0
477306,114,114,0,0,0
477312,184,184,0,0,0
477317,171,171,0,0,0
477323,12,12,0,0,0
477329,359,359,0,0,0
477348,353,353,0,0,0
477362,345,345,0,0,0
477370,359,359,0,0,0
477371,56,56,0,0,0
477385,281,281,0,0,0
477412,144,144,0,0,0
477441,11,11,0,0,0
477448,17,17,0,0,0
477449,315,315,0,0,0
477472,345,345,0,0,0
477486,281,281,0,0,0
477491,63,63,0,0,0
477497,282,282,0,0,0
477499,137,137,0,0,0
477503,232,232,0,0,0
477520,163,163,0,0,0
477529,29,29,0,0,0
477535,114,114,0,0,0
477544,359,359,0,0,0
477553,246,246,0,0,0
477555,246,246,0,0,0
477564,359,359,0,0,0
477600,158,158,0,0,0
477612,77,77,0,0,0
477624,56,56,0,0,0
477631,128,128,0,0,0
477655,137,137,0,0,0
477677,299,299,0,0,0
477698,131,131,0,0,0
477712,353,353,0,0,0
477728,35,35,0,0,0
477731,310,310,0,0,0
477761,167,167,0,0,0
477785,198,198,0,0,0
477788,315,315,0,0,0
477790,70,70,0,0,0
477792,102,102,0,0,0
477794,313,313,0,0,0
477807,163,163,0,0,0
477814,282,282,0,0,0
477842,151,151,0,0,0
477854,359,359,0,0,0
477860,282,282,0,0,0
477867,313,313,0,0,0
477881,151,151,0,0,0
477918,252,252,0,0,0
477927,315,315,0,0,0
477941,144,144,0,0,0
477942,120,120,0,0,0
477951,310,310,0,0,0
477955,36,36,0,0,0
477960,345,345,0,0,0
477966,29,29,0,0,0
477973,198,198,0,0,0
477985,114,114,0,0,0
477986,201,201,0,0,0
478014,15,15,0,0,0
478044,20,20,0,0,0
478052,152,152,0,0,0
478068,83,83,0,0,0
478076,306,306,0,0,0
478089,315,315,0,0,0
478090,137,137,0,0,0
478097,3,3,0,0,0
478104,97,97,0,0,0
478109,193,193,0,0,0
478122,282,282,0,0,0
478148,180,180,0,0,0
478162,198,198,0,0,0
478173,359,359,0,0,0
478177,25,25,0,0,0
478186,11,11,0,0,0
478192,22,22,0,0,0
478232,313,313,0,0,0
478245,9,9,0,0,0
478272,66,66,0,0,0
478273,24,24,0,0,0
478291,137,137,0,0,0
478296,133,133,0,0,0
478300,23,23,0,0,0
478311,359,359,0,0,0
478316,246,246,0,0,0
478330,85,85,0,0,0
478351,103,103,0,0,0
478353,246,246,0,0,0
478372,252,252,0,0,0
478378,137,137,0,0,0
478387,168,168,0,0,0
478403,18,18,0,0,0
478421,353,353,0,0,0
478423,34,34,0,0,0
478439,310,310,0,0,0
478444,25,25,0,0,0
478446,193,193,0,0,0
478452,198,198,0,0,0
478461,144,144,0,0,0
478477,12,12,0,0,0
478479,259,259,0,0,0
478480,158,158,0,0,0
478482,94,94,0,0,0
478498,70,70,0,0,0
478503,359,359,0,0,0
478506,143,143,0,0,0
478510,306,306,0,0,0
478533,306,306,0,0,0
478546,144,144,0,0,0
478551,137,137,0,0,0
478563,103,103,0,0,0
478565,24,24,0,0,0
478571,63,63,0,0,0
478575,16,16,0,0,0
478579,102,102,0,0,0
478589,281,281,0,0,0
478593,167,167,0,0,0
478594,63,63,0,0,0
478596,251,251,0,0,0
478599,50,50,0,0,0
478607,143,143,0,0,0
478627,168,168,0,0,0
478635,345,345,0,0,0
478650,151,151,0,0,0
478654,345,345,0,0,0
478666,201,201,0,0,0
478692,77,77,0,0,0
478700,359,359,0,0,0
478701,58,58,0,0,0
478702,315,315,0,0,0
478703,299,299,0,0,0
478706,167,167,0,0,0
478724,7,7,0,0,0
478736,74,74,0,0,0
478742,23,23,0,0,0
478758,143,143,0,0,0
478772,121,121,0,0,0
478774,114,114,0,0,0
478786,315,315,0,0,0
478795,259,259,0,0,0
478805,345,345,0,0,0
478807,282,282,0,0,0
478809,180,180,0,0,0
478835,315,315,0,0,0
478849,131,131,0,0,0
478857,232,232,0,0,0
478859,63,63,0,0,0
478899,180,180,0,0,0
478900,201,201,0,0,0
478901,94,94,0,0,0
478904,21,21,0,0,0
478907,345,345,0,0,0
478915,152,152,0,0,0
478925,14,14,0,0,0
478929,281,281,0,0,0
478933,50,50,0,0,0
478946,63,63,0,0,0
478956,65,65,0,0,0
478960,9,9,0,0,0
478964,113,113,0,0,0
478970,144,144,0,0,0
478971,102,102,0,0,0
478998,85,85,0,0,0
479004,137,137,0,0,0
479009,50,50,0,0,0
479010,130,130,0,0,0
479018,232,232,0,0,0
479036,137,137,0,0,0
479039,102,102,0,0,0
479043,121,121,0,0,0
479044,50,50,0,0,0
479088,282,282,0,0,0
479089,74,74,0,0,0
479094,198,198,0,0,0
479095,74,74,0,0,0
479108,144,144,0,0,0
479126,114,114,0,0,0
479137,102,102,0,0,0
479159,83,83,0,0,0
479174,353,353,0,0,0
479177,310,310,0,0,0
479197,299,299,0,0,0
479237,34,34,0,0,0
479254,251,251,0,0,0
479256,24,24,0,0,0
479257,70,70,0,0,0
479266,74,74,0,0,0
479297,201,201,0,0,0
479302,402,402,0,0,0
479303,72,72,0,0,0
479316,20,20,0,0,0
479323,56,56,0,0,0
479326,56,56,0,0,0
479343,102,102,0,0,0
479356,103,103,0,0,0
479371,50,50,0,0,0
479382,353,353,0,0,0
479395,198,198,0,0,0
479397,282,282,0,0,0
479407,74,74,0,0,0
479428,132,132,0,0,0
479441,130,130,0,0,0
479447,58,58,0,0,0
479451,201,201,0,0,0
479461,171,171,0,0,0
479465,74,74,0,0,0
479473,171,171,0,0,0
479477,184,184,0,0,0
479497,402,402,0,0,0
479501,43,43,0,0,0
479522,158,158,0,0,0
479527,63,63,0,0,0
479534,251,251,0,0,0
479542,102,102,0,0,0
479550,281,281,0,0,0
479570,259,259,0,0,0
479573,306,306,0,0,0
479593,121,121,0,0,0
479604,27,27,0,0,0
479615,43,43,0,0,0
479630,85,85,0,0,0
479642,306,306,0,0,0
479644,30,30,0,0,0
479708,114,114,0,0,0
479720,281,281,0,0,0
479738,345,345,0,0,0
479746,131,131,0,0,0
479752,50,50,0,0,0
479753,137,137,0,0,0
479754,76,76,0,0,0
479765,133,133,0,0,0
479767,359,359,0,0,0
479775,56,56,0,0,0
479781,167,167,0,0,0
479802,255,255,0,0,0
479821,252,252,0,0,0
479829,255,255,0,0,0
479837,252,252,0,0,0
479839,34,34,0,0,0
479860,198,198,0,0,0
479863,168,168,0,0,0
479875,137,137,0,0,0
479881,67,67,0,0,0
479895,353,353,0,0,0
479897,56,56,0,0,0
479924,102,102,0,0,0
479928,63,63,0,0,0
479932,76,76,0,0,0
479939,36,36,0,0,0
479943,72,72,0,0,0
479947,345,345,0,0,0
479959,359,359,0,0,0
479981,255,255,0,0,0
479985,36,36,0,0,0
479989,36,36,0,0,0
479992,113,113,0,0,0
480008,353,353,0,0,0
480016,58,58,0,0,0
480021,35,35,0,0,0
480043,54,54,0,0,0
480058,313,313,0,0,0
480069,143,143,0,0,0
480102,158,158,0,0,0
480128,43,43,0,0,0
480141,15,15,0,0,0
480158,158,158,0,0,0
480175,11,11,0,0,0
480194,17,17,0,0,0
480199,13,13,0,0,0
480205,121,121,0,0,0
480216,97,97,0,0,0
480221,76,76,0,0,0
480227,94,94,0,0,0
480234,114,114,0,0,0
480262,184,184,0,0,0
480274,56,56,0,0,0
480292,67,67,0,0,0
480325,281,281,0,0,0
480328,74,74,0,0,0
480352,251,251,0,0,0
480375,120,120,0,0,0
480379,2,2,0,0,0
480382,251,251,0,0,0
480417,82,82,0,0,0
480422,121,121,0,0,0
480445,180,180,0,0,0
480466,252,252,0,0,0
480474,144,144,0,0,0
480478,8,8,0,0,0
480499,310,310,0,0,0
480502,310,310,0,0,0
480516,255,255,0,0,0
480546,35,35,0,0,0
480628,11,11,0,0,0
480637,232,232,0,0,0
480644,76,76,0,0,0
480653,44,44,0,0,0
480676,66,66,0,0,0
480710,144,144,0,0,0
480711,23,23,0,0,0
480713,313,313,0,0,0
480748,6,6,0,0,0
480763,168,168,0,0,0
480794,77,77,0,0,0
480804,18,18,0,0,0
480810,56,56,0,0,0
480812,114,114,0,0,0
480819,152,152,0,0,0
480824,143,143,0,0,0
480843,130,130,0,0,0
480853,137,137,0,0,0
480889,353,353,0,0,0
480897,130,130,0,0,0
480909,65,65,0,0,0
480910,71,71,0,0,0
480913,21,21,0,0,0
480923,281,281,0,0,0
480931,137,137,0,0,0
480937,252,252,0,0,0
480939,198,198,0,0,0
480949,251,251,0,0,0
480953,75,75,0,0,0
480956,359,359,0,0,0
480970,132,132,0,0,0
480987,252,252,0,0,0
481030,315,315,0,0,0
481034,18,18,0,0,0
481044,313,313,0,0,0
481045,71,71,0,0,0
481046,345,345,0,0,0
481069,167,167,0,0,0
481072,232,232,0,0,0
481081,315,315,0,0,0
481100,252,252,0,0,0
481113,184,184,0,0,0
481120,67,67,0,0,0
481140,102,102,0,0,0
481143,128,128,0,0,0
481147,184,184,0,0,0
481154,184,184,0,0,0
481165,306,306,0,0,0
481181,70,70,0,0,0
481185,76,76,0,0,0
481190,310,310,0,0,0
481193,103,103,0,0,0
481208,282,282,0,0,0
481221,167,167,0,0,0
481228,167,167,0,0,0
481252,184,184,0,0,0
481275,131,131,0,0,0
481288,252,252,0,0,0
481299,232,232,0,0,0
481305,114,114,0,0,0
481313,158,158,0,0,0
481318,8,8,0,0,0
481323,255,255,0,0,0
481329,83,83,0,0,0
481331,171,171,0,0,0
481340,75,75,0,0,0
481353,313,313,0,0,0
481355,21,21,0,0,0
481357,315,315,0,0,0
481363,101,101,0,0,0
481364,193,193,0,0,0
481379,201,201,0,0,0
481382,315,315,0,0,0
481388,180,180,0,0,0
481404,70,70,0,0,0
481414,345,345,0,0,0
481421,201,201,0,0,0
481463,65,65,0,0,0
481471,282,282,0,0,0
481474,281,281,0,0,0
481476,359,359,0,0,0
481490,5,5,0,0,0
481529,50,50,0,0,0
481535,201,201,0,0,0
481564,121,121,0,0,0
481566,121,121,0,0,0
481585,255,255,0,0,0
481586,163,163,0,0,0
481587,35,35,0,0,0
481591,87,87,0,0,0
481609,30,30,0,0,0
481615,39,39,0,0,0
481655,313,313,0,0,0
481660,114,114,0,0,0
481664,121,121,0,0,0
481665,144,144,0,0,0
481688,76,76,0,0,0
481710,313,313,0,0,0
481723,34,34,0,0,0
481732,158,158,0,0,0
481740,18,18,0,0,0
481752,353,353,0,0,0
481754,259,259,0,0,0
481787,17,17,0,0,0
481788,35,35,0,0,0
481806,306,306,0,0,0
481815,15,15,0,0,0
481842,171,171,0,0,0
481847,168,168,0,0,0
481852,120,120,0,0,0
481873,103,103,0,0,0
481886,137,137,0,0,0
481917,130,130,0,0,0
481932,20,20,0,0,0
481945,87,87,0,0,0
481969,121,121,0,0,0
481994,255,255,0,0,0
482001,74,74,0,0,0
482025,299,299,0,0,0
482059,66,66,0,0,0
482063,184,184,0,0,0
482076,102,102,0,0,0
482079,151,151,0,0,0
482081,131,131,0,0,0
482089,345,345,0,0,0
482096,167,167,0,0,0
482100,359,359,0,0,0
482134,201,201,0,0,0
482163,128,128,0,0,0
482177,251,251,0,0,0
482209,193,193,0,0,0
482216,251,251,0,0,0
482218,359,359,0,0,0
482222,310,310,0,0,0
482228,74,74,0,0,0
482237,75,75,0,0,0
482248,56,56,0,0,0
482249,24,24,0,0,0
482254,282,282,0,0,0
482274,151,151,0,0,0
482277,34,34,0,0,0
482281,255,255,0,0,0
482282,198,198,0,0,0
482285,74,74,0,0,0
482289,56,56,0,0,0
482307,198,198,0,0,0
482308,143,143,0,0,0
482317,50,50,0,0,0
482333,252,252,0,0,0
482334,198,198,0,0,0
482382,299,299,0,0,0
482383,55,55,0,0,0
482394,353,353,0,0,0
482397,143,143,0,0,0
482400,54,54,0,0,0
482410,57,57,0,0,0
482423,310,310,0,0,0
482424,359,359,0,0,0
482425,55,55,0,0,0
482429,28,28,0,0,0
482431,259,259,0,0,0
482444,232,232,0,0,0
482467,163,163,0,0,0
482477,353,353,0,0,0
482495,56,56,0,0,0
482498,180,180,0,0,0
482516,45,45,0,0,0
482530,232,232,0,0,0
482531,83,83,0,0,0
482546,152,152,0,0,0
482558,18,18,0,0,0
482573,67,67,0,0,0
482578,402,402,0,0,0
482584,313,313,0,0,0
482586,251,251,0,0,0
482588,102,102,0,0,0
482605,201,201,0,0,0
482607,6,6,0,0,0
482631,281,281,0,0,0
482633,1,1,0,0,0
482642,22,22,0,0,0
482669,201,201,0,0,0
482710,232,232,0,0,0
482714,55,55,0,0,0
482720,402,402,0,0,0
482723,193,193,0,0,0
482731,171,171,0,0,0
482765,251,251,0,0,0
482767,180,180,0,0,0
482778,167,167,0,0,0
482796,259,259,0,0,0
482829,114,114,0,0,0
482858,306,306,0,0,0
482874,402,402,0,0,0
482904,353,353,0,0,0
482908,193,193,0,0,0
482926,167,167,0,0,0
482935,8,8,0,0,0
482944,43,43,0,0,0
482953,6,6,0,0,0
482957,2,2,0,0,0
482963,57,57,0,0,0
482968,120,120,0,0,0
482972,353,353,0,0,0
482975,163,163,0,0,0
482976,152,152,0,0,0
482980,10,10,0,0,0
482998,259,259,0,0,0
483003,313,313,0,0,0
483020,74,74,0,0,0
483024,5,5,0,0,0
483044,43,43,0,0,0
483051,299,299,0,0,0
483054,359,359,0,0,0
483062,152,152,0,0,0
483063,299,299,0,0,0
483088,345,345,0,0,0
483104,120,120,0,0,0
483119,353,353,0,0,0
483125,70,70,0,0,0
483147,56,56,0,0,0
483148,120,120,0,0,0
483160,137,137,0,0,0
483174,15,15,0,0,0
483199,313,313,0,0,0
483208,102,102,0,0,0
483213,97,97,0,0,0
483215,114,114,0,0,0
483237,167,167,0,0,0
483255,198,198,0,0,0
483272,83,83,0,0,0
483280,310,310,0,0,0
483289,131,131,0,0,0
483302,345,345,0,0,0
483319,74,74,0,0,0
483338,246,246,0,0,0
483339,259,259,0,0,0
483342,281,281,0,0,0
483346,299,299,0,0,0
483380,20,20,0,0,0
483390,55,55,0,0,0
483397,94,94,0,0,0
483413,24,24,0,0,0
483447,310,310,0,0,0
483451,114,114,0,0,0
483470,137,137,0,0,0
483491,34,34,0,0,0
483520,121,121,0,0,0
483566,58,58,0,0,0
483583,74,74,0,0,0
483620,94,94,0,0,0
483645,359,359,0,0,0
483663,7,7,0,0,0
483685,83,83,0,0,0
483704,163,163,0,0,0
483722,20,20,0,0,0
483740,198,198,0,0,0
483742,34,34,0,0,0
483752,158,158,0,0,0
483753,56,56,0,0,0
483759,168,168,0,0,0
483773,130,130,0,0,0
483796,345,345,0,0,0
483800,11,11,0,0,0
483801,113,113,0,0,0
483811,131,131,0,0,0
483814,259,259,0,0,0
483847,282,282,0,0,0
483890,7,7,0,0,0
483920,313,313,0,0,0
483922,299,299,0,0,0
483927,402,402,0,0,0
483956,24,24,0,0,0
483958,255,255,0,0,0
483971,310,310,0,0,0
483976,310,310,0,0,0
483991,168,168,0,0,0
483993,281,281,0,0,0
483995,131,131,0,0,0
484026,299,299,0,0,0
484028,232,232,0,0,0
484031,359,359,0,0,0
484032,315,315,0,0,0
484036,180,180,0,0,0
484038,5,5,0,0,0
484041,67,67,0,0,0
484063,359,359,0,0,0
484075,313,313,0,0,0
484076,402,402,0,0,0
484091,102,102,0,0,0
484094,402,402,0,0,0
484095,75,75,0,0,0
484106,143,143,0,0,0
484115,13,13,0,0,0
484134,251,251,0,0,0
484158,21,21,0,0,0
484163,345,345,0,0,0
484187,120,120,0,0,0
484191,130,130,0,0,0
484200,232,232,0,0,0
484207,299,299,0,0,0
484218,133,133,0,0,0
484222,353,353,0,0,0
484235,163,163,0,0,0
484251,17,17,0,0,0
484257,232,232,0,0,0
484286,345,345,0,0,0
484300,50,50,0,0,0
484301,353,353,0,0,0
484319,180,180,0,0,0
484330,15,15,0,0,0
484349,22,22,0,0,0
484351,5,5,0,0,0
484355,144,144,0,0,0
484361,281,281,0,0,0
484368,171,171,0,0,0
484391,44,44,0,0,0
484392,180,180,0,0,0
484393,171,171,0,0,0
484403,12,12,0,0,0
484426,34,34,0,0,0
484430,158,158,0,0,0
484445,7,7,0,0,0
484446,345,345,0,0,0
484482,76,76,0,0,0
484504,151,151,0,0,0
484505,56,56,0,0,0
484531,299,299,0,0,0
484553,30,30,0,0,0
484558,259,259,0,0,0
484562,143,143,0,0,0
484570,201,201,0,0,0
484579,201,201,0,0,0
484592,87,87,0,0,0
484599,345,345,0,0,0
484612,70,70,0,0,0
484628,17,17,0,0,0
484634,232,232,0,0,0
484642,151,151,0,0,0
484646,163,163,0,0,0
484669,67,67,0,0,0
484687,359,359,0,0,0
484689,101,101,0,0,0
484702,252,252,0,0,0
484723,44,44,0,0,0
484733,152,152,0,0,0
484735,102,102,0,0,0
484740,22,22,0,0,0
484759,313,313,0,0,0
484769,259,259,0,0,0
484776,345,345,0,0,0
484779,18,18,0,0,0
484788,168,168,0,0,0
484796,29,29,0,0,0
484799,163,163,0,0,0
484823,20,20,0,0,0
484828,76,76,0,0,0
484834,353,353,0,0,0
484853,251,251,0,0,0
484863,133,133,0,0,0
484874,2,2,0,0,0
484880,299,299,0,0,0
484900,259,259,0,0,0
484908,102,102,0,0,0
484910,56,56,0,0,0
484938,130,130,0,0,0
484951,306,306,0,0,0
484972,69,69,0,0,0
484978,137,137,0,0,0
484998,29,29,0,0,0
485013,184,184,0,0,0
485033,131,131,0,0,0
485038,184,184,0,0,0
485039,168,168,0,0,0
485047,15,15,0,0,0
485086,36,36,0,0,0
485103,345,345,0,0,0
485118,15,15,0,0,0
485120,10,10,0,0,0
485123,151,151,0,0,0
485151,50,50,0,0,0
485153,41,41,0,0,0
485156,310,310,0,0,0
485173,201,201,0,0,0
485219,299,299,0,0,0
485232,193,193,0,0,0
485235,128,128,0,0,0
485243,281,281,0,0,0
485260,313,313,0,0,0
485267,359,359,0,0,0
485272,259,259,0,0,0
485283,102,102,0,0,0
485313,44,44,0,0,0
485319,315,315,0,0,0
485344,131,131,0,0,0
485363,281,281,0,0,0
485384,144,144,0,0,0
485387,359,359,0,0,0
485394,102,102,0,0,0
485406,299,299,0,0,0
485415,201,201,0,0,0
485416,252,252,0,0,0
485425,232,232,0,0,0
485429,137,137,0,0,0
485444,22,22,0,0,0
485445,56,56,0,0,0
485467,310,310,0,0,0
485469,359,359,0,0,0
485470,114,114,0,0,0
485472,11,11,0,0,0
485474,19,19,0,0,0
485475,24,24,0,0,0
485478,72,72,0,0,0
485484,102,102,0,0,0
485491,55,55,0,0,0
485494,131,131,0,0,0
485501,66,66,0,0,0
485511,402,402,0,0,0
485516,310,310,0,0,0
485529,198,198,0,0,0
485539,10,10,0,0,0
485540,137,137,0,0,0
485561,402,402,0,0,0
485563,35,35,0,0,0
485568,282,282,0,0,0
485573,313,313,0,0,0
485589,66,66,0,0,0
485590,168,168,0,0,0
485602,246,246,0,0,0
485604,87,87,0,0,0
485618,137,137,0,0,0
485632,184,184,0,0,0
485643,310,310,0,0,0
485682,359,359,0,0,0
485684,35,35,0,0,0
485695,167,167,0,0,0
485696,40,40,0,0,0
485709,30,30,0,0,0
485713,345,345,0,0,0
485714,299,299,0,0,0
485742,83,83,0,0,0
485743,63,63,0,0,0
485778,9,9,0,0,0
485781,39,39,0,0,0
485793,75,75,0,0,0
485798,74,74,0,0,0
485828,76,76,0,0,0
485876,315,315,0,0,0
485877,102,102,0,0,0
485885,299,299,0,0,0
485893,130,130,0,0,0
485899,133,133,0,0,0
485927,6,6,0,0,0
485937,43,43,0,0,0
485959,70,70,0,0,0
486023,85,85,0,0,0
486036,83,83,0,0,0
486043,17,17,0,0,0
486052,121,121,0,0,0
486065,27,27,0,0,0
486082,345,345,0,0,0
486084,171,171,0,0,0
486090,1,1,0,0,0
486111,75,75,0,0,0
486117,85,85,0,0,0
486118,6,6,0,0,0
486120,193,193,0,0,0
486144,232,232,0,0,0
486149,167,167,0,0,0
486150,7,7,0,0,0
486168,313,313,0,0,0
486198,168,168,0,0,0
486216,315,315,0,0,0
486223,255,255,0,0,0
486224,22,22,0,0,0
486253,14,14,0,0,0
486271,281,281,0,0,0
486276,34,34,0,0,0
486284,259,259,0,0,0
486304,180,180,0,0,0
486320,22,22,0,0,0
486327,77,77,0,0,0
486330,246,246,0,0,0
486345,252,252,0,0,0
486376,56,56,0,0,0
486379,4,4,0,0,0
486388,34,34,0,0,0
486409,76,76,0,0,0
486415,255,255,0,0,0
486437,201,201,0,0,0
486456,299,299,0,0,0
486463,252,252,0,0,0
486468,137,137,0,0,0
486472,7,7,0,0,0
486479,23,23,0,0,0
486503,55,55,0,0,0
486517,130,130,0,0,0
486545,101,101,0,0,0
486549,5,5,0,0,0
486562,281,281,0,0,0
486564,306,306,0,0,0
486573,252,252,0,0,0
486579,251,251,0,0,0
486580,251,251,0,0,0
486591,163,163,0,0,0
486605,402,402,0,0,0
486611,56,56,0,0,0
486616,54,54,0,0,0
486628,13,13,0,0,0
486655,50,50,0,0,0
486664,345,345,0,0,0
486692,114,114,0,0,0
486702,45,45,0,0,0
486704,353,353,0,0,0
486707,102,102,0,0,0
486724,21,21,0,0,0
486725,299,299,0,0,0
486728,158,158,0,0,0
486742,299,299,0,0,0
486763,77,77,0,0,0
486764,281,281,0,0,0
486775,193,193,0,0,0
486778,201,201,0,0,0
486800,128,128,0,0,0
486810,315,315,0,0,0
486838,252,252,0,0,0
486842,251,251,0,0,0
486846,12,12,0,0,0
486847,251,251,0,0,0
486854,282,282,0,0,0
486857,65,65,0,0,0
486877,353,353,0,0,0
486894,17,17,0,0,0
486899,30,30,0,0,0
486901,306,306,0,0,0
486905,184,184,0,0,0
486938,11,11,0,0,0
486952,251,251,0,0,0
486982,102,102,0,0,0
486992,36,36,0,0,0
486994,144,144,0,0,0
486998,77,77,0,0,0
487005,246,246,0,0,0
487030,313,313,0,0,0
487031,2,2,0,0,0
487040,144,144,0,0,0
487058,45,45,0,0,0
487060,151,151,0,0,0
487068,281,281,0,0,0
487092,8,8,0,0,0
487095,20,20,0,0,0
487134,163,163,0,0,0
487137,299,299,0,0,0
487147,121,121,0,0,0
487148,306,306,0,0,0
487164,94,94,0,0,0
487166,94,94,0,0,0
487171,17,17,0,0,0
487240,353,353,0,0,0
487241,163,163,0,0,0
487251,137,137,0,0,0
487254,137,137,0,0,0
487257,158,158,0,0,0
487309,15,15,0,0,0
487316,72,72,0,0,0
487317,137,137,0,0,0
487331,168,168,0,0,0
487352,102,102,0,0,0
487353,121,121,0,0,0
487360,82,82,0,0,0
487381,9,9,0,0,0
487394,25,25,0,0,0
487414,144,144,0,0,0
487428,402,402,0,0,0
487437,114,114,0,0,0
487443,34,34,0,0,0
487469,133,133,0,0,0
487491,315,315,0,0,0
487505,201,201,0,0,0
487524,180,180,0,0,0
487534,11,11,0,0,0
487537,232,232,0,0,0
487541,158,158,0,0,0
487549,69,69,0,0,0
487554,137,137,0,0,0
487564,128,128,0,0,0
487575,114,114,0,0,0
487586,198,198,0,0,0
487588,306,306,0,0,0
487595,282,282,0,0,0
487596,63,63,0,0,0
487607,55,55,0,0,0
487608,83,83,0,0,0
487644,102,102,0,0,0
487652,313,313,0,0,0
487662,282,282,0,0,0
487669,128,128,0,0,0
487673,151,151,0,0,0
487694,5,5,0,0,0
487710,144,144,0,0,0
487724,133,133,0,0,0
487728,282,282,0,0,0
487761,306,306,0,0,0
487780,315,315,0,0,0
487786,132,132,0,0,0
487815,359,359,0,0,0
487817,27,27,0,0,0
487831,306,306,0,0,0
487832,246,246,0,0,0
487842,75,75,0,0,0
487844,310,310,0,0,0
487851,12,12,0,0,0
487858,8,8,0,0,0
487869,130,130,0,0,0
487870,402,402,0,0,0
487871,85,85,0,0,0
487881,201,201,0,0,0
487885,114,114,0,0,0
487887,58,58,0,0,0
487894,359,359,0,0,0
487895,121,121,0,0,0
487904,359,359,0,0,0
487916,9,9,0,0,0
487937,103,103,0,0,0
487958,184,184,0,0,0
487974,255,255,0,0,0
487979,4,4,0,0,0
487981,133,133,0,0,0
488006,128,128,0,0,0
488044,313,313,0,0,0
488063,74,74,0,0,0
488072,310,310,0,0,0
488106,402,402,0,0,0
488118,281,281,0,0,0
488128,313,313,0,0,0
488136,20,20,0,0,0
488147,74,74,0,0,0
488151,171,171,0,0,0
488191,40,40,0,0,0
488194,76,76,0,0,0
488261,8,8,0,0,0
488262,17,17,0,0,0
488263,128,128,0,0,0
488272,353,353,0,0,0
488274,87,87,0,0,0
488275,56,56,0,0,0
488287,137,137,0,0,0
488291,252,252,0,0,0
488292,299,299,0,0,0
488293,282,282,0,0,0
488304,246,246,0,0,0
488313,131,131,0,0,0
488337,56,56,0,0,0
488347,14,14,0,0,0
488443,36,36,0,0,0
488464,163,163,0,0,0
488472,1,1,0,0,0
488482,171,171,0,0,0
488497,252,252,0,0,0
488505,201,201,0,0,0
488517,353,353,0,0,0
488527,56,56,0,0,0
488537,66,66,0,0,0
488541,201,201,0,0,0
488542,246,246,0,0,0
488549,28,28,0,0,0
488552,252,252,0,0,0
488559,306,306,0,0,0
488564,184,184,0,0,0
488575,20,20,0,0,0
488587,313,313,0,0,0
488589,299,299,0,0,0
488590,50,50,0,0,0
488601,20,20,0,0,0
488610,7,7,0,0,0
488613,163,163,0,0,0
488634,402,402,0,0,0
488653,281,281,0,0,0
488658,39,39,0,0,0
488668,158,158,0,0,0
488676,402,402,0,0,0
488696,345,345,0,0,0
488711,65,65,0,0,0
488716,281,281,0,0,0
488736,137,137,0,0,0
488738,121,121,0,0,0
488742,35,35,0,0,0
488760,246,246,0,0,0
488785,74,74,0,0,0
488810,18,18,0,0,0
488819,120,120,0,0,0
488827,281,281,0,0,0
488832,184,184,0,0,0
488841,306,306,0,0,0
488855,137,137,0,0,0
488867,114,114,0,0,0
488909,70,70,0,0,0
488935,74,74,0,0,0
488936,85,85,0,0,0
488959,17,17,0,0,0
488962,82,82,0,0,0
488967,353,353,0,0,0
488974,128,128,0,0,0
488985,102,102,0,0,0
488986,345,345,0,0,0
488989,193,193,0,0,0
488993,402,402,0,0,0
488995,306,306,0,0,0
489009,63,63,0,0,0
489033,22,22,0,0,0
489040,22,22,0,0,0
489042,144,144,0,0,0
489052,43,43,0,0,0
489061,133,133,0,0,0
489132,299,299,0,0,0
489134,137,137,0,0,0
489160,83,83,0,0,0
489168,102,102,0,0,0
489182,282,282,0,0,0
489189,152,152,0,0,0
489203,402,402,0,0,0
489236,310,310,0,0,0
489242,137,137,0,0,0
489257,282,282,0,0,0
489265,133,133,0,0,0
489270,246,246,0,0,0
489275,353,353,0,0,0
489293,101,101,0,0,0
489295,34,34,0,0,0
489300,120,120,0,0,0
489310,180,180,0,0,0
489312,255,255,0,0,0
489320,353,353,0,0,0
489332,74,74,0,0,0
489344,310,310,0,0,0
489347,24,24,0,0,0
489354,113,113,0,0,0
489369,74,74,0,0,0
489385,43,43,0,0,0
489409,76,76,0,0,0
489426,19,19,0,0,0
489436,310,310,0,0,0
489462,315,315,0,0,0
489476,143,143,0,0,0
489488,114,114,0,0,0
489490,171,171,0,0,0
489506,2,2,0,0,0
489515,151,151,0,0,0
489540,252,252,0,0,0
489553,167,167,0,0,0
489560,58,58,0,0,0
489564,402,402,0,0,0
489570,102,102,0,0,0
489627,306,306,0,0,0
489631,102,102,0,0,0
489641,167,167,0,0,0
489643,29,29,0,0,0
489652,353,353,0,0,0
489677,315,315,0,0,0
489679,11,11,0,0,0
489684,402,402,0,0,0
489744,143,143,0,0,0
489765,23,23,0,0,0
489770,151,151,0,0,0
489811,402,402,0,0,0
489812,402,402,0,0,0
489817,198,198,0,0,0
489827,151,151,0,0,0
489831,345,345,0,0,0
489833,50,50,0,0,0
489835,246,246,0,0,0
489852,70,70,0,0,0
489872,246,246,0,0,0
489877,131,131,0,0,0
489890,306,306,0,0,0
489895,251,251,0,0,0
489903,313,313,0,0,0
489927,94,94,0,0,0
489940,65,65,0,0,0
489967,232,232,0,0,0
489972,3,3,0,0,0
489984,85,85,0,0,0
489994,44,44,0,0,0
490005,102,102,0,0,0
490008,167,167,0,0,0
490010,299,299,0,0,0
490016,137,137,0,0,0
490018,143,143,0,0,0
490024,402,402,0,0,0
490045,201,201,0,0,0
490051,184,184,0,0,0
490059,167,167,0,0,0
490071,121,121,0,0,0
490073,87,87,0,0,0
490076,128,128,0,0,0
490099,120,120,0,0,0
490118,306,306,0,0,0
490126,137,137,0,0,0
490131,306,306,0,0,0
490161,29,29,0,0,0
490177,171,171,0,0,0
490186,131,131,0,0,0
490194,353,353,0,0,0
490199,121,121,0,0,0
490208,76,76,0,0,0
490211,310,310,0,0,0
490213,70,70,0,0,0
490217,152,152,0,0,0
490230,315,315,0,0,0
490233,151,151,0,0,0
490235,76,76,0,0,0
490248,75,75,0,0,0
490265,50,50,0,0,0
490281,353,353,0,0,0
490283,8,8,0,0,0
490306,2,2,0,0,0
490319,152,152,0,0,0
490344,94,94,0,0,0
490349,9,9,0,0,0
490351,281,281,0,0,0
490353,251,251,0,0,0
490356,102,102,0,0,0
490363,251,251,0,0,0
490371,232,232,0,0,0
490376,163,163,0,0,0
490393,28,28,0,0,0
490394,34,34,0,0,0
490404,113,113,0,0,0
490414,137,137,0,0,0
490417,71,71,0,0,0
490422,41,41,0,0,0
490451,171,171,0,0,0
490459,45,45,0,0,0
490475,101,101,0,0,0
490487,55,55,0,0,0
490489,120,120,0,0,0
490499,306,306,0,0,0
490516,345,345,0,0,0
490520,102,102,0,0,0
490526,402,402,0,0,0
490537,232,232,0,0,0
490553,168,168,0,0,0
490556,103,103,0,0,0
490564,198,198,0,0,0
490567,259,259,0,0,0
490570,94,94,0,0,0
490573,11,11,0,0,0
490575,120,120,0,0,0
490585,102,102,0,0,0
490598,299,299,0,0,0
490607,77,77,0,0,0
490651,34,34,0,0,0
490667,75,75,0,0,0
490674,35,35,0,0,0
490696,251,251,0,0,0
490705,55,55,0,0,0
490733,15,15,0,0,0
490738,246,246,0,0,0
490741,34,34,0,0,0
490745,87,87,0,0,0
490755,120,120,0,0,0
490758,151,151,0,0,0
490763,74,74,0,0,0
490775,56,56,0,0,0
490784,281,281,0,0,0
490798,281,281,0,0,0
490813,4,4,0,0,0
490828,252,252,0,0,0
490833,22,22,0,0,0
490845,25,25,0,0,0
490852,402,402,0,0,0
490877,299,299,0,0,0
490879,402,402,0,0,0
490887,201,201,0,0,0
490897,198,198,0,0,0
490905,299,299,0,0,0
490908,29,29,0,0,0
490912,87,87,0,0,0
490927,255,255,0,0,0
490930,44,44,0,0,0
490934,72,72,0,0,0
490943,12,12,0,0,0
490962,252,252,0,0,0
490976,315,315,0,0,0
490993,77,77,0,0,0
490997,34,34,0,0,0
491002,143,143,0,0,0
491009,259,259,0,0,0
491011,345,345,0,0,0
491044,167,167,0,0,0
491096,25,25,0,0,0
491099,102,102,0,0,0
491134,44,44,0,0,0
491146,121,121,0,0,0
491168,85,85,0,0,0
491170,10,10,0,0,0
491176,97,97,0,0,0
491184,246,246,0,0,0
491207,4,4,0,0,0
491218,36,36,0,0,0
491219,13,13,0,0,0
491220,252,252,0,0,0
491245,25,25,0,0,0
491271,180,180,0,0,0
491274,19,19,0,0,0
491276,198,198,0,0,0
491295,114,114,0,0,0
491302,10,10,0,0,0
491309,57,57,0,0,0
491319,6,6,0,0,0
491323,158,158,0,0,0
491324,131,131,0,0,0
491332,299,299,0,0,0
491339,133,133,0,0,0
491359,50,50,0,0,0
491360,281,281,0,0,0
491368,184,184,0,0,0
491394,113,113,0,0,0
491405,345,345,0,0,0
491427,152,152,0,0,0
491441,345,345,0,0,0
491498,152,152,0,0,0
491502,8,8,0,0,0
491535,299,299,0,0,0
491538,30,30,0,0,0
491547,11,11,0,0,0
491548,76,76,0,0,0
491553,152,152,0,0,0
491565,313,313,0,0,0
491568,299,299,0,0,0
491569,252,252,0,0,0
491570,76,76,0,0,0
491584,50,50,0,0,0
491607,158,158,0,0,0
491610,299,299,0,0,0
491611,315,315,0,0,0
491617,120,120,0,0,0
491618,101,101,0,0,0
491622,50,50,0,0,0
491640,74,74,0,0,0
491648,25,25,0,0,0
491650,359,359,0,0,0
491660,306,306,0,0,0
491665,50,50,0,0,0
491667,137,137,0,0,0
491672,36,36,0,0,0
491687,402,402,0,0,0
491696,3,3,0,0,0
491715,171,171,0,0,0
491724,315,315,0,0,0
491731,251,251,0,0,0
491740,56,56,0,0,0
491751,137,137,0,0,0
491776,402,402,0,0,0
491781,184,184,0,0,0
491797,306,306,0,0,0
491803,193,193,0,0,0
491804,6,6,0,0,0
491841,35,35,0,0,0
491843,232,232,0,0,0
491845,18,18,0,0,0
491846,75,75,0,0,0
491856,171,171,0,0,0
491858,232,232,0,0,0
491866,85,85,0,0,0
491874,17,17,0,0,0
491875,259,259,0,0,0
491890,313,313,0,0,0
491923,18,18,0,0,0
491935,252,252,0,0,0
491942,255,255,0,0,0
491943,6,6,0,0,0
491945,359,359,0,0,0
491950,97,97,0,0,0
491955,131,131,0,0,0
491989,252,252,0,0,0
491993,313,313,0,0,0
492005,345,345,0,0,0
492018,137,137,0,0,0
492028,168,168,0,0,0
492033,232,232,0,0,0
492047,14,14,0,0,0
492062,114,114,0,0,0
492076,313,313,0,0,0
492082,158,158,0,0,0
492084,8,8,0,0,0
492088,306,306,0,0,0
492120,282,282,0,0,0
492124,121,121,0,0,0
492125,299,299,0,0,0
492130,402,402,0,0,0
492140,259,259,0,0,0
492158,130,130,0,0,0
492159,402,402,0,0,0
492160,25,25,0,0,0
492164,402,402,0,0,0
492206,299,299,0,0,0
492216,114,114,0,0,0
492237,17,17,0,0,0
492261,133,133,0,0,0
492272,402,402,0,0,0
492273,359,359,0,0,0
492296,55,55,0,0,0
492305,41,41,0,0,0
492308,74,74,0,0,0
492325,259,259,0,0,0
492349,232,232,0,0,0
492353,310,310,0,0,0
492368,57,57,0,0,0
492375,87,87,0,0,0
492388,158,158,0,0,0
492402,87,87,0,0,0
492417,299,299,0,0,0
492437,94,94,0,0,0
492474,12,12,0,0,0
492477,251,251,0,0,0
492486,345,345,0,0,0
492496,281,281,0,0,0
492506,158,158,0,0,0
492532,282,282,0,0,0
492537,66,66,0,0,0
492555,315,315,0,0,0
492556,58,58,0,0,0
492562,255,255,0,0,0
492563,11,11,0,0,0
492574,43,43,0,0,0
492583,71,71,0,0,0
492589,137,137,0,0,0
492591,85,85,0,0,0
492594,11,11,0,0,0
492606,15,15,0,0,0
492626,359,359,0,0,0
492630,39,39,0,0,0
492634,252,252,0,0,0
492643,144,144,0,0,0
492647,353,353,0,0,0
492652,102,102,0,0,0
492663,14,14,0,0,0
492671,45,45,0,0,0
492680,232,232,0,0,0
492725,313,313,0,0,0
492735,184,184,0,0,0
492738,41,41,0,0,0
492742,32,32,0,0,0
492748,133,133,0,0,0
492762,255,255,0,0,0
492764,18,18,0,0,0
492767,282,282,0,0,0
492770,151,151,0,0,0
492790,299,299,0,0,0
492793,353,353,0,0,0
492796,128,128,0,0,0
492798,353,353,0,0,0
492809,171,171,0,0,0
492814,359,359,0,0,0
492816,402,402,0,0,0
492842,144,144,0,0,0
492849,252,252,0,0,0
492853,67,67,0,0,0
492855,313,313,0,0,0
492904,15,15,0,0,0
492907,345,345,0,0,0
492941,180,180,0,0,0
492968,180,180,0,0,0
492992,63,63,0,0,0
492993,315,315,0,0,0
492997,252,252,0,0,0
493012,193,193,0,0,0
493021,232,232,0,0,0
493022,137,137,0,0,0
493028,132,132,0,0,0
493041,143,143,0,0,0
493062,76,76,0,0,0
493071,201,201,0,0,0
493081,167,167,0,0,0
493087,255,255,0,0,0
493105,55,55,0,0,0
493108,167,167,0,0,0
493137,20,20,0,0,0
493144,102,102,0,0,0
493151,133,133,0,0,0
493166,313,313,0,0,0
493172,198,198,0,0,0
493197,65,65,0,0,0
493222,121,121,0,0,0
493256,353,353,0,0,0
493258,152,152,0,0,0
493291,101,101,0,0,0
493315,74,74,0,0,0
493318,76,76,0,0,0
493334,252,252,0,0,0
493336,143,143,0,0,0
493337,259,259,0,0,0
493348,168,168,0,0,0
493350,306,306,0,0,0
493352,315,315,0,0,0
493376,315,315,0,0,0
493379,353,353,0,0,0
493388,198,198,0,0,0
493389,353,353,0,0,0
493396,402,402,0,0,0
493418,137,137,0,0,0
493426,198,198,0,0,0
493433,34,34,0,0,0
493436,10,10,0,0,0
493441,259,259,0,0,0
493445,255,255,0,0,0
493460,128,128,0,0,0
493461,19,19,0,0,0
493464,359,359,0,0,0
493472,70,70,0,0,0
493502,281,281,0,0,0
493520,163,163,0,0,0
493557,232,232,0,0,0
493560,29,29,0,0,0
493564,103,103,0,0,0
493574,2,2,0,0,0
493586,76,76,0,0,0
493590,353,353,0,0,0
493603,97,97,0,0,0
493616,402,402,0,0,0
493620,120,120,0,0,0
493632,131,131,0,0,0
493645,232,232,0,0,0
493671,18,18,0,0,0
493680,255,255,0,0,0
493683,310,310,0,0,0
493689,94,94,0,0,0
493690,402,402,0,0,0
493693,246,246,0,0,0
493715,315,315,0,0,0
493725,132,132,0,0,0
493729,315,315,0,0,0
493755,75,75,0,0,0
493757,94,94,0,0,0
493779,29,29,0,0,0
493795,353,353,0,0,0
493801,43,43,0,0,0
493829,310,310,0,0,0
493830,29,29,0,0,0
493842,168,168,0,0,0
493845,359,359,0,0,0
493860,353,353,0,0,0
493866,299,299,0,0,0
493870,299,299,0,0,0
493872,306,306,0,0,0
493890,310,310,0,0,0
493942,313,313,0,0,0
493947,180,180,0,0,0
493952,306,306,0,0,0
493965,313,313,0,0,0
493992,184,184,0,0,0
493994,168,168,0,0,0
494002,246,246,0,0,0
494016,151,151,0,0,0
494039,17,17,0,0,0
494051,10,10,0,0,0
494055,353,353,0,0,0
494112,184,184,0,0,0
494113,255,255,0,0,0
494121,167,167,0,0,0
494128,315,315,0,0,0
494130,121,121,0,0,0
494148,299,299,0,0,0
494162,131,131,0,0,0
494207,143,143,0,0,0
494216,251,251,0,0,0
494222,132,132,0,0,0
494224,402,402,0,0,0
494240,56,56,0,0,0
494265,158,158,0,0,0
494272,28,28,0,0,0
494280,13,13,0,0,0
494290,102,102,0,0,0
494292,128,128,0,0,0
494307,56,56,0,0,0
494318,87,87,0,0,0
494322,121,121,0,0,0
494323,3,3,0,0,0
494331,171,171,0,0,0
494343,114,114,0,0,0
494352,94,94,0,0,0
494354,114,114,0,0,0
494371,198,198,0,0,0
494373,163,163,0,0,0
494393,130,130,0,0,0
494394,299,299,0,0,0
494400,281,281,0,0,0
494407,97,97,0,0,0
494417,72,72,0,0,0
494431,70,70,0,0,0
494437,15,15,0,0,0
494475,180,180,0,0,0
494483,353,353,0,0,0
494484,65,65,0,0,0
494488,36,36,0,0,0
494490,281,281,0,0,0
494494,121,121,0,0,0
494500,113,113,0,0,0
494511,128,128,0,0,0
494516,359,359,0,0,0
494527,315,315,0,0,0
494532,120,120,0,0,0
494533,310,310,0,0,0
494544,310,310,0,0,0
494545,313,313,0,0,0
494547,151,151,0,0,0
494563,232,232,0,0,0
494564,306,306,0,0,0
494573,74,74,0,0,0
494576,180,180,0,0,0
494580,56,56,0,0,0
494599,114,114,0,0,0
494604,102,102,0,0,0
494608,255,255,0,0,0
494614,345,345,0,0,0
494625,121,121,0,0,0
494632,113,113,0,0,0
494637,44,44,0,0,0
494654,158,158,0,0,0
494671,281,281,0,0,0
494694,144,144,0,0,0
494697,137,137,0,0,0
494719,315,315,0,0,0
494725,402,402,0,0,0
494729,402,402,0,0,0
494737,306,306,0,0,0
494742,359,359,0,0,0
494748,259,259,0,0,0
494752,281,281,0,0,0
494757,168,168,0,0,0
494760,151,151,0,0,0
494761,151,151,0,0,0
494784,44,44,0,0,0
494798,41,41,0,0,0
494825,63,63,0,0,0
494833,198,198,0,0,0
494847,34,34,0,0,0
494857,113,113,0,0,0
494882,201,201,0,0,0
494888,281,281,0,0,0
494895,77,77,0,0,0
494902,251,251,0,0,0
494916,198,198,0,0,0
494917,246,246,0,0,0
494918,43,43,0,0,0
494936,282,282,0,0,0
494943,87,87,0,0,0
494957,43,43,0,0,0
494963,310,310,0,0,0
494978,85,85,0,0,0
494980,7,7,0,0,0
494987,299,299,0,0,0
494993,50,50,0,0,0
495017,151,151,0,0,0
495018,83,83,0,0,0
495021,251,251,0,0,0
495040,359,359,0,0,0
495058,168,168,0,0,0
495066,313,313,0,0,0
495083,85,85,0,0,0
495114,44,44,0,0,0
495157,402,402,0,0,0
495163,310,310,0,0,0
495166,50,50,0,0,0
495215,128,128,0,0,0
495233,359,359,0,0,0
495241,163,163,0,0,0
495278,167,167,0,0,0
495284,50,50,0,0,0
495299,54,54,0,0,0
495306,44,44,0,0,0
495313,83,83,0,0,0
495328,251,251,0,0,0
495340,232,232,0,0,0
495347,14,14,0,0,0
495354,171,171,0,0,0
495357,171,171,0,0,0
495370,168,168,0,0,0
495388,313,313,0,0,0
495391,72,72,0,0,0
495410,345,345,0,0,0
495416,15,15,0,0,0
495420,359,359,0,0,0
495431,12,12,0,0,0
495468,18,18,0,0,0
495474,131,131,0,0,0
495478,281,281,0,0,0
495479,402,402,0,0,0
495483,299,299,0,0,0
495499,167,167,0,0,0
495504,25,25,0,0,0
495508,252,252,0,0,0
495520,17,17,0,0,0
495523,76,76,0,0,0
495526,345,345,0,0,0
495529,345,345,0,0,0
495570,299,299,0,0,0
495584,120,120,0,0,0
495590,17,17,0,0,0
495598,353,353,0,0,0
495619,114,114,0,0,0
495646,25,25,0,0,0
495665,151,151,0,0,0
495677,131,131,0,0,0
495706,144,144,0,0,0
495707,255,255,0,0,0
495710,15,15,0,0,0
495711,232,232,0,0,0
495713,255,255,0,0,0
495715,201,201,0,0,0
495728,359,359,0,0,0
495730,315,315,0,0,0
495748,152,152,0,0,0
495750,56,56,0,0,0
495754,306,306,0,0,0
495767,353,353,0,0,0
495782,306,306,0,0,0
495785,168,168,0,0,0
495786,315,315,0,0,0
495793,15,15,0,0,0
495807,9,9,0,0,0
495812,282,282,0,0,0
495819,3,3,0,0,0
495824,184,184,0,0,0
495825,359,359,0,0,0
495826,299,299,0,0,0
495836,306,306,0,0,0
495839,131,131,0,0,0
495854,63,63,0,0,0
495869,193,193,0,0,0
495894,306,306,0,0,0
495907,232,232,0,0,0
495928,281,281,0,0,0
495932,180,180,0,0,0
495975,299,299,0,0,0
495980,359,359,0,0,0
495994,306,306,0,0,0
495998,198,198,0,0,0
496017,3,3,0,0,0
496049,56,56,0,0,0
496067,36,36,0,0,0
496079,310,310,0,0,0
496086,306,306,0,0,0
496100,251,251,0,0,0
496101,101,101,0,0,0
496103,259,259,0,0,0
496113,121,121,0,0,0
496118,67,67,0,0,0
496127,128,128,0,0,0
496164,85,85,0,0,0
496171,137,137,0,0,0
496174,25,25,0,0,0
496187,114,114,0,0,0
496188,251,251,0,0,0
496196,310,310,0,0,0
496214,40,40,0,0,0
496223,359,359,0,0,0
496224,50,50,0,0,0
496228,76,76,0,0,0
496249,19,19,0,0,0
496269,114,114,0,0,0
496270,152,152,0,0,0
496292,76,76,0,0,0
496299,74,74,0,0,0
496302,113,113,0,0,0
496303,306,306,0,0,0
496334,310,310,0,0,0
496341,44,44,0,0,0
496342,282,282,0,0,0
496351,121,121,0,0,0
496356,180,180,0,0,0
496365,345,345,0,0,0
496380,18,18,0,0,0
496382,158,158,0,0,0
496414,180,180,0,0,0
496417,184,184,0,0,0
496426,306,306,0,0,0
496429,36,36,0,0,0
496450,359,359,0,0,0
496456,281,281,0,0,0
496474,251,251,0,0,0
496487,201,201,0,0,0
496489,103,103,0,0,0
496498,201,201,0,0,0
496512,121,121,0,0,0
496515,35,35,0,0,0
496524,171,171,0,0,0
496528,12,12,0,0,0
496529,7,7,0,0,0
496566,353,353,0,0,0
496570,306,306,0,0,0
496584,34,34,0,0,0
496589,7,7,0,0,0
496594,281,281,0,0,0
496595,313,313,0,0,0
496597,402,402,0,0,0
496598,251,251,0,0,0
496603,158,158,0,0,0
496613,32,32,0,0,0
496625,25,25,0,0,0
496631,50,50,0,0,0
496663,137,137,0,0,0
496670,282,282,0,0,0
496681,252,252,0,0,0
496690,3,3,0,0,0
496705,281,281,0,0,0
496706,255,255,0,0,0
496713,50,50,0,0,0
496737,128,128,0,0,0
496739,359,359,0,0,0
496743,313,313,0,0,0
496756,198,198,0,0,0
496769,259,259,0,0,0
496812,255,255,0,0,0
496817,184,184,0,0,0
496823,143,143,0,0,0
496826,55,55,0,0,0
496833,158,158,0,0,0
496841,6,6,0,0,0
496856,9,9,0,0,0
496864,137,137,0,0,0
496889,22,22,0,0,0
496896,65,65,0,0,0
496917,16,16,0,0,0
496918,198,198,0,0,0
496922,251,251,0,0,0
496934,30,30,0,0,0
496960,171,171,0,0,0
496978,8,8,0,0,0
496988,103,103,0,0,0
496993,345,345,0,0,0
497001,193,193,0,0,0
497020,44,44,0,0,0
497021,130,130,0,0,0
497046,151,151,0,0,0
497047,14,14,0,0,0
497062,143,143,0,0,0
497065,8,8,0,0,0
497086,353,353,0,0,0
497095,313,313,0,0,0
497097,7,7,0,0,0
497130,306,306,0,0,0
497137,131,131,0,0,0
497165,281,281,0,0,0
497181,299,299,0,0,0
497183,27,27,0,0,0
497186,94,94,0,0,0
497190,50,50,0,0,0
497196,76,76,0,0,0
497204,246,246,0,0,0
497206,6,6,0,0,0
497209,29,29,0,0,0
497266,14,14,0,0,0
497272,102,102,0,0,0
497276,72,72,0,0,0
497283,43,43,0,0,0
497285,24,24,0,0,0
497289,310,310,0,0,0
497314,246,246,0,0,0
497328,306,306,0,0,0
497352,167,167,0,0,0
497357,299,299,0,0,0
497381,184,184,0,0,0
497396,4,4,0,0,0
497433,282,282,0,0,0
497442,255,255,0,0,0
497443,193,193,0,0,0
497451,14,14,0,0,0
497456,144,144,0,0,0
497491,97,97,0,0,0
497500,16,16,0,0,0
497504,306,306,0,0,0
497516,131,131,0,0,0
497517,198,198,0,0,0
497528,315,315,0,0,0
497548,17,17,0,0,0
497554,65,65,0,0,0
497555,67,67,0,0,0
497557,29,29,0,0,0
497564,72,72,0,0,0
497566,130,130,0,0,0
497573,315,315,0,0,0
497583,310,310,0,0,0
497584,345,345,0,0,0
497585,313,313,0,0,0
497601,282,282,0,0,0
497602,163,163,0,0,0
497613,345,345,0,0,0
497653,5,5,0,0,0
497656,402,402,0,0,0
497657,113,113,0,0,0
497659,246,246,0,0,0
497679,102,102,0,0,0
497688,74,74,0,0,0
497698,402,402,0,0,0
497700,168,168,0,0,0
497710,299,299,0,0,0
497718,306,306,0,0,0
497733,74,74,0,0,0
497738,158,158,0,0,0
497752,7,7,0,0,0
497760,34,34,0,0,0
497765,3,3,0,0,0
497772,168,168,0,0,0
497774,71,71,0,0,0
497778,13,13,0,0,0
497792,20,20,0,0,0
497795,101,101,0,0,0
497797,313,313,0,0,0
497811,7,7,0,0,0
497816,114,114,0,0,0
497821,158,158,0,0,0
497835,402,402,0,0,0
497855,121,121,0,0,0
497856,27,27,0,0,0
497858,359,359,0,0,0
497862,313,313,0,0,0
497873,252,252,0,0,0
497881,15,15,0,0,0
497882,255,255,0,0,0
497894,36,36,0,0,0
497929,82,82,0,0,0
497938,171,171,0,0,0
497947,137,137,0,0,0
497956,14,14,0,0,0
497969,232,232,0,0,0
497971,193,193,0,0,0
498001,15,15,0,0,0
498010,114,114,0,0,0
498048,402,402,0,0,0
498049,310,310,0,0,0
498058,345,345,0,0,0
498062,259,259,0,0,0
498069,74,74,0,0,0
498076,259,259,0,0,0
498082,281,281,0,0,0
498089,102,102,0,0,0
498095,133,133,0,0,0
498100,313,313,0,0,0
498120,299,299,0,0,0
498138,201,201,0,0,0
498156,313,313,0,0,0
498164,14,14,0,0,0
498170,353,353,0,0,0
498185,132,132,0,0,0
498191,72,72,0,0,0
498206,25,25,0,0,0
498218,345,345,0,0,0
498223,310,310,0,0,0
498229,281,281,0,0,0
498245,310,310,0,0,0
498281,281,281,0,0,0
498287,20,20,0,0,0
498298,198,198,0,0,0
498308,24,24,0,0,0
498333,232,232,0,0,0
498348,137,137,0,0,0
498355,402,402,0,0,0
498364,130,130,0,0,0
498366,306,306,0,0,0
498371,45,45,0,0,0
498376,18,18,0,0,0
498380,101,101,0,0,0
498392,82,82,0,0,0
498396,359,359,0,0,0
498424,39,39,0,0,0
498430,310,310,0,0,0
498440,70,70,0,0,0
498454,171,171,0,0,0
498468,87,87,0,0,0
498480,193,193,0,0,0
498481,15,15,0,0,0
498497,83,83,0,0,0
498501,246,246,0,0,0
498514,69,69,0,0,0
498527,353,353,0,0,0
498530,4,4,0,0,0
498531,6,6,0,0,0
498552,252,252,0,0,0
498569,180,180,0,0,0
498574,85,85,0,0,0
498577,15,15,0,0,0
498584,133,133,0,0,0
498621,180,180,0,0,0
498640,251,251,0,0,0
498643,16,16,0,0,0
498654,7,7,0,0,0
498661,16,16,0,0,0
498665,345,345,0,0,0
498690,76,76,0,0,0
498702,163,163,0,0,0
498715,43,43,0,0,0
498726,14,14,0,0,0
498732,402,402,0,0,0
498746,44,44,0,0,0
498751,20,20,0,0,0
498753,313,313,0,0,0
498772,353,353,0,0,0
498781,184,184,0,0,0
498782,345,345,0,0,0
498783,299,299,0,0,0
498809,306,306,0,0,0
498815,152,152,0,0,0
498822,144,144,0,0,0
498833,171,171,0,0,0
498837,299,299,0,0,0
498848,359,359,0,0,0
498853,310,310,0,0,0
498859,184,184,0,0,0
498871,87,87,0,0,0
498886,313,313,0,0,0
498897,65,65,0,0,0
498905,402,402,0,0,0
498940,310,310,0,0,0
498965,103,103,0,0,0
498967,143,143,0,0,0
498971,1,1,0,0,0
498979,151,151,0,0,0
499006,133,133,0,0,0
499011,114,114,0,0,0
499026,315,315,0,0,0
499036,246,246,0,0,0
499045,76,76,0,0,0
499074,282,282,0,0,0
499093,70,70,0,0,0
499116,74,74,0,0,0
499117,359,359,0,0,0
499141,56,56,0,0,0
499174,103,103,0,0,0
499191,133,133,0,0,0
499199,353,353,0,0,0
499200,281,281,0,0,0
499208,353,353,0,0,0
499209,282,282,0,0,0
499257,158,158,0,0,0
499267,12,12,0,0,0
499299,16,16,0,0,0
499329,313,313,0,0,0
499337,74,74,0,0,0
499361,34,34,0,0,0
499367,359,359,0,0,0
499371,137,137,0,0,0
499383,66,66,0,0,0
499384,137,137,0,0,0
499418,28,28,0,0,0
499433,5,5,0,0,0
499436,345,345,0,0,0
499443,184,184,0,0,0
499452,102,102,0,0,0
499463,310,310,0,0,0
499466,306,306,0,0,0
499468,163,163,0,0,0
499488,143,143,0,0,0
499510,30,30,0,0,0
499527,65,65,0,0,0
499528,198,198,0,0,0
499532,22,22,0,0,0
499544,12,12,0,0,0
499564,201,201,0,0,0
499584,299,299,0,0,0
499612,13,13,0,0,0
499613,120,120,0,0,0
499631,74,74,0,0,0
499633,158,158,0,0,0
499635,306,306,0,0,0
499636,402,402,0,0,0
499641,345,345,0,0,0
499677,22,22,0,0,0
499682,131,131,0,0,0
499710,299,299,0,0,0
499717,120,120,0,0,0
499722,313,313,0,0,0
499734,13,13,0,0,0
499741,11,11,0,0,0
499743,252,252,0,0,0
499745,3,3,0,0,0
499748,171,171,0,0,0
499754,19,19,0,0,0
499766,255,255,0,0,0
499767,75,75,0,0,0
499777,306,306,0,0,0
499785,65,65,0,0,0
499788,345,345,0,0,0
499792,151,151,0,0,0
499802,12,12,0,0,0
499808,143,143,0,0,0
499822,58,58,0,0,0
499832,252,252,0,0,0
499841,281,281,0,0,0
499853,246,246,0,0,0
499858,299,299,0,0,0
499872,152,152,0,0,0
499873,40,40,0,0,0
499899,359,359,0,0,0
499901,25,25,0,0,0
499906,281,281,0,0,0
499914,82,82,0,0,0
499950,345,345,0,0,0
499951,402,402,0,0,0
499963,44,44,0,0,0
499964,152,152,0,0,0
499983,345,345,0,0,0
499993,54,54,0,0,0
499994,193,193,0,0,0
500002,310,310,0,0,0
500019,168,168,0,0,0
500023,232,232,0,0,0
500033,56,56,0,0,0
500086,137,137,0,0,0
500095,137,137,0,0,0
500100,102,102,0,0,0
500103,193,193,0,0,0
500133,36,36,0,0,0
500134,19,19,0,0,0
500137,7,7,0,0,0
500170,97,97,0,0,0
500179,131,131,0,0,0
500182,66,66,0,0,0
500191,45,45,0,0,0
500207,128,128,0,0,0
500210,246,246,0,0,0
500218,151,151,0,0,0
500241,36,36,0,0,0
500247,252,252,0,0,0
500258,128,128,0,0,0
500269,163,163,0,0,0
500279,2,2,0,0,0
500284,402,402,0,0,0
500321,9,9,0,0,0
500336,137,137,0,0,0
500345,34,34,0,0,0
500347,128,128,0,0,0
500350,71,71,0,0,0
500388,180,180,0,0,0
500405,85,85,0,0,0
500412,36,36,0,0,0
500416,120,120,0,0,0
500418,259,259,0,0,0
500420,252,252,0,0,0
500438,232,232,0,0,0
500440,310,310,0,0,0
500452,198,198,0,0,0
500453,299,299,0,0,0
500472,402,402,0,0,0
500474,282,282,0,0,0
500491,12,12,0,0,0
500539,22,22,0,0,0
500543,158,158,0,0,0
500546,201,201,0,0,0
500558,167,167,0,0,0
500565,345,345,0,0,0
500571,310,310,0,0,0
500574,282,282,0,0,0
500590,17,17,0,0,0
500607,246,246,0,0,0
500612,310,310,0,0,0
500627,7,7,0,0,0
500671,65,65,0,0,0
500676,353,353,0,0,0
500691,144,144,0,0,0
500740,252,252,0,0,0
500744,306,306,0,0,0
500754,252,252,0,0,0
500755,353,353,0,0,0
500757,168,168,0,0,0
500759,114,114,0,0,0
500770,85,85,0,0,0
500808,282,282,0,0,0
500837,345,345,0,0,0
500840,171,171,0,0,0
500842,101,101,0,0,0
500866,97,97,0,0,0
500868,402,402,0,0,0
500870,359,359,0,0,0
500894,259,259,0,0,0
500897,313,313,0,0,0
500909,315,315,0,0,0
500915,102,102,0,0,0
500923,25,25,0,0,0
500944,359,359,0,0,0
500951,313,313,0,0,0
500960,114,114,0,0,0
500962,114,114,0,0,0
500969,158,158,0,0,0
500973,251,251,0,0,0
500991,137,137,0,0,0
500996,8,8,0,0,0
501025,43,43,0,0,0
501027,74,74,0,0,0
501031,282,282,0,0,0
501045,259,259,0,0,0
501052,24,24,0,0,0
501079,402,402,0,0,0
501088,36,36,0,0,0
501111,13,13,0,0,0
501132,193,193,0,0,0
501138,16,16,0,0,0
501179,313,313,0,0,0
501180,193,193,0,0,0
501181,25,25,0,0,0
501184,1,1,0,0,0
501189,281,281,0,0,0
501203,167,167,0,0,0
501204,251,251,0,0,0
501219,82,82,0,0,0
501229,299,299,0,0,0
501239,54,54,0,0,0
501256,158,158,0,0,0
501283,246,246,0,0,0
501293,56,56,0,0,0
501305,74,74,0,0,0
501336,313,313,0,0,0
501338,87,87,0,0,0
501353,102,102,0,0,0
501359,58,58,0,0,0
501372,345,345,0,0,0
501399,4,4,0,0,0
501402,151,151,0,0,0
501403,144,144,0,0,0
501404,402,402,0,0,0
501428,201,201,0,0,0
501435,310,310,0,0,0
501439,163,163,0,0,0
501445,167,167,0,0,0
501459,299,299,0,0,0
501474,252,252,0,0,0
501516,306,306,0,0,0
501517,193,193,0,0,0
501524,345,345,0,0,0
501527,114,114,0,0,0
501528,345,345,0,0,0
501534,55,55,0,0,0
501554,28,28,0,0,0
501563,306,306,0,0,0
501574,282,282,0,0,0
501576,10,10,0,0,0
501622,152,152,0,0,0
501625,29,29,0,0,0
501630,246,246,0,0,0
501642,114,114,0,0,0
501660,246,246,0,0,0
501669,132,132,0,0,0
501716,310,310,0,0,0
501723,121,121,0,0,0
501730,19,19,0,0,0
501731,345,345,0,0,0
501737,201,201,0,0,0
501744,74,74,0,0,0
501753,259,259,0,0,0
501755,158,158,0,0,0
501759,402,402,0,0,0
501763,282,282,0,0,0
501783,402,402,0,0,0
501784,359,359,0,0,0
501786,70,70,0,0,0
501791,133,133,0,0,0
501801,137,137,0,0,0
501806,282,282,0,0,0
501808,28,28,0,0,0
501815,133,133,0,0,0
501829,193,193,0,0,0
501833,27,27,0,0,0
501835,29,29,0,0,0
501837,130,130,0,0,0
501843,299,299,0,0,0
501856,29,29,0,0,0
501859,402,402,0,0,0
501860,252,252,0,0,0
501863,103,103,0,0,0
501887,306,306,0,0,0
501898,70,70,0,0,0
501908,137,137,0,0,0
501931,19,19,0,0,0
501938,74,74,0,0,0
501944,151,151,0,0,0
501945,158,158,0,0,0
501946,4,4,0,0,0
501961,133,133,0,0,0
501965,171,171,0,0,0
501978,58,58,0,0,0
501981,2,2,0,0,0
501999,20,20,0,0,0
502006,11,11,0,0,0
502008,102,102,0,0,0
502014,306,306,0,0,0
502018,3,3,0,0,0
502028,16,16,0,0,0
502030,359,359,0,0,0
502049,359,359,0,0,0
502050,345,345,0,0,0
502065,75,75,0,0,0
502066,70,70,0,0,0
502069,232,232,0,0,0
502079,184,184,0,0,0
502080,313,313,0,0,0
502136,246,246,0,0,0
502144,306,306,0,0,0
502150,76,76,0,0,0
502163,251,251,0,0,0
502164,22,22,0,0,0
502165,19,19,0,0,0
502184,12,12,0,0,0
502195,313,313,0,0,0
502209,12,12,0,0,0
502211,359,359,0,0,0
502219,19,19,0,0,0
502227,180,180,0,0,0
502252,18,18,0,0,0
502265,11,11,0,0,0
502273,34,34,0,0,0
502276,299,299,0,0,0
502285,345,345,0,0,0
502292,246,246,0,0,0
502296,114,114,0,0,0
502301,74,74,0,0,0
502310,25,25,0,0,0
502326,144,144,0,0,0
502347,6,6,0,0,0
502349,24,24,0,0,0
502377,198,198,0,0,0
502386,54,54,0,0,0
502387,44,44,0,0,0
502399,36,36,0,0,0
502402,8,8,0,0,0
502405,315,315,0,0,0
502435,29,29,0,0,0
502438,158,158,0,0,0
502440,299,299,0,0,0
502460,252,252,0,0,0
502473,14,14,0,0,0
502479,133,133,0,0,0
502480,14,14,0,0,0
502484,3,3,0,0,0
502489,97,97,0,0,0
502519,120,120,0,0,0
502521,66,66,0,0,0
502528,71,71,0,0,0
502529,167,167,0,0,0
502539,180,180,0,0,0
502544,310,310,0,0,0
502549,36,36,0,0,0
502551,193,193,0,0,0
502564,402,402,0,0,0
502568,353,353,0,0,0
502588,299,299,0,0,0
502589,184,184,0,0,0
502600,29,29,0,0,0
502619,158,158,0,0,0
502651,36,36,0,0,0
502657,54,54,0,0,0
502660,57,57,0,0,0
502671,306,306,0,0,0
502680,306,306,0,0,0
502681,18,18,0,0,0
502683,252,252,0,0,0
502684,137,137,0,0,0
502690,353,353,0,0,0
502692,168,168,0,0,0
502695,50,50,0,0,0
502711,102,102,0,0,0
502725,168,168,0,0,0
502746,30,30,0,0,0
502750,137,137,0,0,0
502759,56,56,0,0,0
502772,402,402,0,0,0
502775,313,313,0,0,0
502798,281,281,0,0,0
502799,232,232,0,0,0
502803,168,168,0,0,0
502810,184,184,0,0,0
502841,85,85,0,0,0
502858,17,17,0,0,0
502862,120,120,0,0,0
502869,94,94,0,0,0
502873,402,402,0,0,0
502877,171,171,0,0,0
502882,281,281,0,0,0
502904,34,34,0,0,0
502914,163,163,0,0,0
502939,306,306,0,0,0
502967,16,16,0,0,0
502971,299,299,0,0,0
502977,255,255,0,0,0
503008,184,184,0,0,0
503012,315,315,0,0,0
503023,246,246,0,0,0
503048,76,76,0,0,0
503057,137,137,0,0,0
503064,163,163,0,0,0
503087,282,282,0,0,0
503172,310,310,0,0,0
503175,282,282,0,0,0
503189,359,359,0,0,0
503203,34,34,0,0,0
503209,19,19,0,0,0
503210,21,21,0,0,0
503216,5,5,0,0,0
503228,281,281,0,0,0
503241,76,76,0,0,0
503245,20,20,0,0,0
503254,252,252,0,0,0
503283,65,65,0,0,0
503285,1,1,0,0,0
503293,313,313,0,0,0
503294,251,251,0,0,0
503295,184,184,0,0,0
503297,152,152,0,0,0
503302,315,315,0,0,0
503304,12,12,0,0,0
503308,259,259,0,0,0
503311,143,143,0,0,0
503320,402,402,0,0,0
503323,167,167,0,0,0
503329,70,70,0,0,0
503349,171,171,0,0,0
503422,299,299,0,0,0
503440,22,22,0,0,0
503450,353,353,0,0,0
503465,180,180,0,0,0
503475,259,259,0,0,0
503487,103,103,0,0,0
503495,121,121,0,0,0
503538,58,58,0,0,0
503540,77,77,0,0,0
503548,232,232,0,0,0
503554,76,76,0,0,0
503556,102,102,0,0,0
503558,76,76,0,0,0
503592,310,310,0,0,0
503607,16,16,0,0,0
503617,232,232,0,0,0
503634,359,359,0,0,0
503635,306,306,0,0,0
503637,44,44,0,0,0
503644,114,114,0,0,0
503655,94,94,0,0,0
503666,12,12,0,0,0
503683,121,121,0,0,0
503697,137,137,0,0,0
503706,58,58,0,0,0
503712,310,310,0,0,0
503714,132,132,0,0,0
503724,315,315,0,0,0
503725,102,102,0,0,0
503751,232,232,0,0,0
503756,65,65,0,0,0
503780,70,70,0,0,0
503787,299,299,0,0,0
503809,102,102,0,0,0
503814,345,345,0,0,0
503818,30,30,0,0,0
503822,184,184,0,0,0
503834,22,22,0,0,0
503837,137,137,0,0,0
503842,50,50,0,0,0
503859,255,255,0,0,0
503866,45,45,0,0,0
503885,133,133,0,0,0
503903,184,184,0,0,0
503912,152,152,0,0,0
503928,12,12,0,0,0
503946,246,246,0,0,0
503947,306,306,0,0,0
503948,313,313,0,0,0
503951,168,168,0,0,0
503952,282,282,0,0,0
503962,353,353,0,0,0
503964,232,232,0,0,0
503977,259,259,0,0,0
503980,102,102,0,0,0
503981,180,180,0,0,0
503999,128,128,0,0,0
504010,299,299,0,0,0
504021,137,137,0,0,0
504031,171,171,0,0,0
504046,56,56,0,0,0
504056,11,11,0,0,0
504060,299,299,0,0,0
504065,299,299,0,0,0
504093,120,120,0,0,0
504111,345,345,0,0,0
504127,137,137,0,0,0
504133,128,128,0,0,0
504135,56,56,0,0,0
504139,9,9,0,0,0
504142,201,201,0,0,0
504145,310,310,0,0,0
504169,66,66,0,0,0
504173,56,56,0,0,0
504185,137,137,0,0,0
504194,50,50,0,0,0
504195,114,114,0,0,0
504197,17,17,0,0,0
504206,121,121,0,0,0
504213,120,120,0,0,0
504227,158,158,0,0,0
504236,54,54,0,0,0
504250,94,94,0,0,0
504252,353,353,0,0,0
504268,180,180,0,0,0
504276,15,15,0,0,0
504286,353,353,0,0,0
504294,113,113,0,0,0
504325,198,198,0,0,0
504336,246,246,0,0,0
504342,63,63,0,0,0
504344,259,259,0,0,0
504369,193,193,0,0,0
504402,97,97,0,0,0
504404,5,5,0,0,0
504413,67,67,0,0,0
504421,306,306,0,0,0
504424,345,345,0,0,0
504426,345,345,0,0,0
504438,23,23,0,0,0
504445,74,74,0,0,0
504455,306,306,0,0,0
504469,251,251,0,0,0
504484,128,128,0,0,0
504486,35,35,0,0,0
504563,259,259,0,0,0
504596,255,255,0,0,0
504611,76,76,0,0,0
504633,82,82,0,0,0
504635,102,102,0,0,0
504638,246,246,0,0,0
504651,74,74,0,0,0
504671,180,180,0,0,0
504685,184,184,0,0,0
504708,232,232,0,0,0
504734,137,137,0,0,0
504752,315,315,0,0,0
504757,114,114,0,0,0
504761,252,252,0,0,0
504793,281,281,0,0,0
504798,5,5,0,0,0
504812,57,57,0,0,0
504822,353,353,0,0,0
504827,251,251,0,0,0
504833,310,310,0,0,0
504848,255,255,0,0,0
504865,315,315,0,0,0
504871,74,74,0,0,0
504902,252,252,0,0,0
504943,246,246,0,0,0
504952,20,20,0,0,0
504955,40,40,0,0,0
504959,144,144,0,0,0
504985,6,6,0,0,0
504986,3,3,0,0,0
505001,12,12,0,0,0
505006,315,315,0,0,0
505010,114,114,0,0,0
505017,180,180,0,0,0
505020,402,402,0,0,0
505034,282,282,0,0,0
505055,310,310,0,0,0
505085,255,255,0,0,0
505094,282,282,0,0,0
505129,402,402,0,0,0
505135,152,152,0,0,0
505149,58,58,0,0,0
505165,58,58,0,0,0
505166,306,306,0,0,0
505211,310,310,0,0,0
505217,76,76,0,0,0
505218,137,137,0,0,0
505228,69,69,0,0,0
505229,184,184,0,0,0
505235,402,402,0,0,0
505242,163,163,0,0,0
505297,184,184,0,0,0
505309,259,259,0,0,0
505325,36,36,0,0,0
505341,402,402,0,0,0
505356,87,87,0,0,0
505360,306,306,0,0,0
505362,402,402,0,0,0
505368,310,310,0,0,0
505374,102,102,0,0,0
505384,121,121,0,0,0
505393,128,128,0,0,0
505428,54,54,0,0,0
505434,246,246,0,0,0
505445,18,18,0,0,0
505447,359,359,0,0,0
505451,315,315,0,0,0
505453,359,359,0,0,0
505456,34,34,0,0,0
505466,102,102,0,0,0
505489,15,15,0,0,0
505493,35,35,0,0,0
505499,85,85,0,0,0
505509,102,102,0,0,0
505522,9,9,0,0,0
505525,171,171,0,0,0
505526,252,252,0,0,0
505534,251,251,0,0,0
505537,402,402,0,0,0
505541,184,184,0,0,0
505542,359,359,0,0,0
505548,299,299,0,0,0
505572,76,76,0,0,0
505584,121,121,0,0,0
505586,144,144,0,0,0
505589,7,7,0,0,0
505597,113,113,0,0,0
505647,87,87,0,0,0
505673,6,6,0,0,0
505691,315,315,0,0,0
505699,8,8,0,0,0
505712,246,246,0,0,0
505745,35,35,0,0,0
505753,246,246,0,0,0
505764,299,299,0,0,0
505775,310,310,0,0,0
505779,255,255,0,0,0
505780,43,43,0,0,0
505816,36,36,0,0,0
505823,259,259,0,0,0
505829,402,402,0,0,0
505891,306,306,0,0,0
505899,76,76,0,0,0
505919,310,310,0,0,0
505925,72,72,0,0,0
505937,252,252,0,0,0
505947,94,94,0,0,0
505950,70,70,0,0,0
505965,130,130,0,0,0
505972,345,345,0,0,0
505994,137,137,0,0,0
506021,158,158,0,0,0
506027,15,15,0,0,0
506029,251,251,0,0,0
506032,34,34,0,0,0
506035,58,58,0,0,0
506043,114,114,0,0,0
506046,310,310,0,0,0
506051,359,359,0,0,0
506057,19,19,0,0,0
506064,353,353,0,0,0
506069,306,306,0,0,0
506107,152,152,0,0,0
506122,251,251,0,0,0
506132,353,353,0,0,0
506135,163,163,0,0,0
506140,69,69,0,0,0
506145,75,75,0,0,0
506150,36,36,0,0,0
506178,193,193,0,0,0
506179,353,353,0,0,0
506192,70,70,0,0,0
506211,251,251,0,0,0
506215,281,281,0,0,0
506221,198,198,0,0,0
506224,310,310,0,0,0
506247,353,353,0,0,0
506264,114,114,0,0,0
506269,315,315,0,0,0
506303,103,103,0,0,0
506315,121,121,0,0,0
506327,252,252,0,0,0
506343,128,128,0,0,0
506346,50,50,0,0,0
506365,14,14,0,0,0
506376,232,232,0,0,0
506393,251,251,0,0,0
506415,69,69,0,0,0
506447,402,402,0,0,0
506451,44,44,0,0,0
506455,137,137,0,0,0
506459,152,152,0,0,0
506512,97,97,0,0,0
506523,252,252,0,0,0
506550,30,30,0,0,0
506552,133,133,0,0,0
506581,103,103,0,0,0
506611,131,131,0,0,0
506633,359,359,0,0,0
506634,402,402,0,0,0
506648,27,27,0,0,0
506656,359,359,0,0,0
506659,44,44,0,0,0
506696,75,75,0,0,0
506697,198,198,0,0,0
506699,251,251,0,0,0
506726,83,83,0,0,0
506735,259,259,0,0,0
506738,3,3,0,0,0
506751,345,345,0,0,0
506766,402,402,0,0,0
506781,114,114,0,0,0
506784,8,8,0,0,0
506788,131,131,0,0,0
506800,102,102,0,0,0
506814,310,310,0,0,0
506824,120,120,0,0,0
506833,87,87,0,0,0
506851,353,353,0,0,0
506871,17,17,0,0,0
506885,17,17,0,0,0
506899,345,345,0,0,0
506922,282,282,0,0,0
506964,82,82,0,0,0
506969,313,313,0,0,0
506970,315,315,0,0,0
506975,353,353,0,0,0
506976,198,198,0,0,0
506981,27,27,0,0,0
506986,121,121,0,0,0
506990,76,76,0,0,0
506999,143,143,0,0,0
507004,163,163,0,0,0
507022,402,402,0,0,0
507032,345,345,0,0,0
507072,17,17,0,0,0
507074,251,251,0,0,0
507083,29,29,0,0,0
507085,83,83,0,0,0
507091,36,36,0,0,0
507095,353,353,0,0,0
507111,54,54,0,0,0
507137,255,255,0,0,0
507143,20,20,0,0,0
507158,353,353,0,0,0
507161,402,402,0,0,0
507217,232,232,0,0,0
507238,97,97,0,0,0
507273,299,299,0,0,0
507282,259,259,0,0,0
507285,85,85,0,0,0
507295,12,12,0,0,0
507304,137,137,0,0,0
507313,75,75,0,0,0
507333,20,20,0,0,0
507348,11,11,0,0,0
507351,353,353,0,0,0
507354,252,252,0,0,0
507358,77,77,0,0,0
507365,71,71,0,0,0
507377,121,121,0,0,0
507391,74,74,0,0,0
507394,306,306,0,0,0
507401,10,10,0,0,0
507410,16,16,0,0,0
507430,40,40,0,0,0
507434,36,36,0,0,0
507440,102,102,0,0,0
507443,232,232,0,0,0
507449,85,85,0,0,0
507460,306,306,0,0,0
507483,54,54,0,0,0
507528,299,299,0,0,0
507542,85,85,0,0,0
507563,50,50,0,0,0
507569,310,310,0,0,0
507583,17,17,0,0,0
507590,114,114,0,0,0
507599,198,198,0,0,0
507613,3,3,0,0,0
507615,137,137,0,0,0
507632,15,15,0,0,0
507637,76,76,0,0,0
507644,130,130,0,0,0
507645,13,13,0,0,0
507648,29,29,0,0,0
507671,232,232,0,0,0
507687,353,353,0,0,0
507694,44,44,0,0,0
507699,345,345,0,0,0
507704,306,306,0,0,0
507723,54,54,0,0,0
507728,193,193,0,0,0
507749,255,255,0,0,0
507788,151,151,0,0,0
507792,151,151,0,0,0
507819,184,184,0,0,0
507823,144,144,0,0,0
507832,163,163,0,0,0
507837,114,114,0,0,0
507846,180,180,0,0,0
507869,251,251,0,0,0
507877,198,198,0,0,0
507881,66,66,0,0,0
507887,310,310,0,0,0
507889,167,167,0,0,0
507896,76,76,0,0,0
507904,144,144,0,0,0
507923,259,259,0,0,0
507939,180,180,0,0,0
507945,345,345,0,0,0
507973,34,34,0,0,0
507982,282,282,0,0,0
508006,19,19,0,0,0
508015,4,4,0,0,0
508023,121,121,0,0,0
508029,143,143,0,0,0
508049,313,313,0,0,0
508074,167,167,0,0,0
508077,102,102,0,0,0
508082,168,168,0,0,0
508086,158,158,0,0,0
508093,130,130,0,0,0
508094,8,8,0,0,0
508101,82,82,0,0,0
508102,151,151,0,0,0
508116,70,70,0,0,0
508126,45,45,0,0,0
508133,251,251,0,0,0
508151,27,27,0,0,0
508155,83,83,0,0,0
508166,137,137,0,0,0
508167,306,306,0,0,0
508173,315,315,0,0,0
508175,137,137,0,0,0
508176,35,35,0,0,0
508179,180,180,0,0,0
508198,402,402,0,0,0
508208,259,259,0,0,0
508216,299,299,0,0,0
508221,29,29,0,0,0
508224,22,22,0,0,0
508235,45,45,0,0,0
508236,35,35,0,0,0
508257,19,19,0,0,0
508259,171,171,0,0,0
508269,114,114,0,0,0
508270,402,402,0,0,0
508284,345,345,0,0,0
508293,143,143,0,0,0
508298,252,252,0,0,0
508302,402,402,0,0,0
508305,121,121,0,0,0
508320,55,55,0,0,0
508324,232,232,0,0,0
508325,299,299,0,0,0
508339,83,83,0,0,0
508346,151,151,0,0,0
508351,83,83,0,0,0
508362,120,120,0,0,0
508390,359,359,0,0,0
508396,24,24,0,0,0
508422,251,251,0,0,0
508437,34,34,0,0,0
508440,167,167,0,0,0
508452,402,402,0,0,0
508456,114,114,0,0,0
508462,163,163,0,0,0
508476,255,255,0,0,0
508511,198,198,0,0,0
508542,101,101,0,0,0
508554,44,44,0,0,0
508576,201,201,0,0,0
508577,133,133,0,0,0
508630,102,102,0,0,0
508639,12,12,0,0,0
508642,168,168,0,0,0
508685,158,158,0,0,0
508697,7,7,0,0,0
508719,32,32,0,0,0
508721,137,137,0,0,0
508726,345,345,0,0,0
508739,252,252,0,0,0
508758,35,35,0,0,0
508767,168,168,0,0,0
508768,70,70,0,0,0
508776,39,39,0,0,0
508793,18,18,0,0,0
508812,75,75,0,0,0
508851,25,25,0,0,0
508882,23,23,0,0,0
508892,57,57,0,0,0
508896,151,151,0,0,0
508908,353,353,0,0,0
508910,252,252,0,0,0
508945,87,87,0,0,0
508953,17,17,0,0,0
508967,168,168,0,0,0
508976,353,353,0,0,0
508977,50,50,0,0,0
508985,315,315,0,0,0
509001,353,353,0,0,0
509004,143,143,0,0,0
509005,255,255,0,0,0
509024,345,345,0,0,0
509052,310,310,0,0,0
509056,55,55,0,0,0
509059,3,3,0,0,0
509062,82,82,0,0,0
509087,29,29,0,0,0
509088,168,168,0,0,0
509089,313,313,0,0,0
509105,137,137,0,0,0
509126,34,34,0,0,0
509129,16,16,0,0,0
509133,137,137,0,0,0
509144,299,299,0,0,0
509165,34,34,0,0,0
509204,315,315,0,0,0
509211,67,67,0,0,0
509213,152,152,0,0,0
509217,113,113,0,0,0
509218,299,299,0,0,0
509246,102,102,0,0,0
509249,63,63,0,0,0
509257,2,2,0,0,0
509272,313,313,0,0,0
509274,14,14,0,0,0
509282,45,45,0,0,0
509283,201,201,0,0,0
509284,131,131,0,0,0
509298,29,29,0,0,0
509318,137,137,0,0,0
509319,18,18,0,0,0
509321,102,102,0,0,0
509324,246,246,0,0,0
509329,130,130,0,0,0
509375,259,259,0,0,0
509380,131,131,0,0,0
509385,306,306,0,0,0
509394,34,34,0,0,0
509399,359,359,0,0,0
509401,402,402,0,0,0
509404,310,310,0,0,0
509424,402,402,0,0,0
509464,353,353,0,0,0
509471,252,252,0,0,0
509472,345,345,0,0,0
509510,7,7,0,0,0
509540,15,15,0,0,0
509542,168,168,0,0,0
509547,163,163,0,0,0
509548,12,12,0,0,0
509565,201,201,0,0,0
509578,359,359,0,0,0
509599,180,180,0,0,0
509621,282,282,0,0,0
509624,345,345,0,0,0
509646,345,345,0,0,0
509652,76,76,0,0,0
509657,299,299,0,0,0
509659,25,25,0,0,0
509660,137,137,0,0,0
509667,299,299,0,0,0
509673,353,353,0,0,0
509685,251,251,0,0,0
509698,201,201,0,0,0
509706,66,66,0,0,0
509708,246,246,0,0,0
509715,18,18,0,0,0
509723,184,184,0,0,0
509756,180,180,0,0,0
509764,315,315,0,0,0
509770,345,345,0,0,0
509788,246,246,0,0,0
509790,152,152,0,0,0
509802,11,11,0,0,0
509818,345,345,0,0,0
509821,4,4,0,0,0
509833,19,19,0,0,0
509834,114,114,0,0,0
509836,128,128,0,0,0
509848,313,313,0,0,0
509857,121,121,0,0,0
509858,252,252,0,0,0
509860,281,281,0,0,0
509867,137,137,0,0,0
509878,54,54,0,0,0
509902,299,299,0,0,0
509903,184,184,0,0,0
509910,184,184,0,0,0
509911,313,313,0,0,0
509924,281,281,0,0,0
509966,137,137,0,0,0
509976,39,39,0,0,0
509980,345,345,0,0,0
509985,168,168,0,0,0
509994,3,3,0,0,0
509995,65,65,0,0,0
510008,306,306,0,0,0
510016,198,198,0,0,0
510020,193,193,0,0,0
510031,345,345,0,0,0
510040,36,36,0,0,0
510057,158,158,0,0,0
510061,70,70,0,0,0
510067,163,163,0,0,0
510080,8,8,0,0,0
510087,152,152,0,0,0
510094,353,353,0,0,0
510106,151,151,0,0,0
510132,168,168,0,0,0
510140,6,6,0,0,0
510142,44,44,0,0,0
510143,353,353,0,0,0
510160,198,198,0,0,0
510167,63,63,0,0,0
510172,281,281,0,0,0
510175,282,282,0,0,0
510196,299,299,0,0,0
510208,45,45,0,0,0
510248,306,306,0,0,0
510280,76,76,0,0,0
510292,22,22,0,0,0
510301,6,6,0,0,0
510306,69,69,0,0,0
510313,4,4,0,0,0
510314,255,255,0,0,0
510323,252,252,0,0,0
510325,353,353,0,0,0
510356,25,25,0,0,0
510376,306,306,0,0,0
510380,282,282,0,0,0
510387,163,163,0,0,0
510425,12,12,0,0,0
510441,137,137,0,0,0
510462,163,163,0,0,0
510467,101,101,0,0,0
510490,74,74,0,0,0
510500,167,167,0,0,0
510502,232,232,0,0,0
510516,3,3,0,0,0
510530,24,24,0,0,0
510532,114,114,0,0,0
510538,12,12,0,0,0
510541,40,40,0,0,0
510548,359,359,0,0,0
510551,282,282,0,0,0
510563,131,131,0,0,0
510592,402,402,0,0,0
510593,167,167,0,0,0
510595,121,121,0,0,0
510601,345,345,0,0,0
510629,402,402,0,0,0
510640,152,152,0,0,0
510669,345,345,0,0,0
510671,65,65,0,0,0
510681,63,63,0,0,0
510703,353,353,0,0,0
510748,87,87,0,0,0
510756,24,24,0,0,0
510773,315,315,0,0,0
510778,306,306,0,0,0
510788,74,74,0,0,0
510797,22,22,0,0,0
510807,3,3,0,0,0
510814,198,198,0,0,0
510821,57,57,0,0,0
510834,313,313,0,0,0
510837,167,167,0,0,0
510871,137,137,0,0,0
510878,151,151,0,0,0
510886,75,75,0,0,0
510891,184,184,0,0,0
510927,137,137,0,0,0
510952,65,65,0,0,0
510959,65,65,0,0,0
510967,180,180,0,0,0
510973,310,310,0,0,0
510977,184,184,0,0,0
510979,103,103,0,0,0
510998,10,10,0,0,0
511021,310,310,0,0,0
511026,72,72,0,0,0
511029,353,353,0,0,0
511037,24,24,0,0,0
511080,281,281,0,0,0
511081,359,359,0,0,0
511094,40,40,0,0,0
511103,345,345,0,0,0
511114,345,345,0,0,0
511149,151,151,0,0,0
511169,313,313,0,0,0
511178,168,168,0,0,0
511193,359,359,0,0,0
511194,281,281,0,0,0
511202,74,74,0,0,0
511212,102,102,0,0,0
511214,44,44,0,0,0
511218,353,353,0,0,0
511223,198,198,0,0,0
511229,85,85,0,0,0
511230,299,299,0,0,0
511261,5,5,0,0,0
511265,281,281,0,0,0
511266,103,103,0,0,0
511270,75,75,0,0,0
511271,120,120,0,0,0
511282,345,345,0,0,0
511294,75,75,0,0,0
511303,65,65,0,0,0
511308,24,24,0,0,0
511312,282,282,0,0,0
511332,313,313,0,0,0
511338,34,34,0,0,0
511349,281,281,0,0,0
511360,151,151,0,0,0
511362,121,121,0,0,0
511379,121,121,0,0,0
511392,103,103,0,0,0
511397,315,315,0,0,0
511398,74,74,0,0,0
511407,315,315,0,0,0
511415,76,76,0,0,0
511416,158,158,0,0,0
511441,24,24,0,0,0
511445,50,50,0,0,0
511447,137,137,0,0,0
511450,251,251,0,0,0
511451,6,6,0,0,0
511465,137,137,0,0,0
511474,50,50,0,0,0
511481,353,353,0,0,0
511498,66,66,0,0,0
511500,20,20,0,0,0
511528,359,359,0,0,0
511530,35,35,0,0,0
511545,313,313,0,0,0
511554,281,281,0,0,0
511557,251,251,0,0,0
511561,345,345,0,0,0
511566,144,144,0,0,0
511580,315,315,0,0,0
511586,9,9,0,0,0
511587,85,85,0,0,0
511611,77,77,0,0,0
511615,282,282,0,0,0
511635,299,299,0,0,0
511650,76,76,0,0,0
511652,345,345,0,0,0
511670,35,35,0,0,0
511671,14,14,0,0,0
511674,402,402,0,0,0
511677,306,306,0,0,0
511693,120,120,0,0,0
511700,313,313,0,0,0
511706,281,281,0,0,0
511716,121,121,0,0,0
511729,101,101,0,0,0
511736,29,29,0,0,0
511768,299,299,0,0,0
511769,9,9,0,0,0
511775,30,30,0,0,0
511776,121,121,0,0,0
511782,102,102,0,0,0
511787,102,102,0,0,0
511790,193,193,0,0,0
511799,171,171,0,0,0
511804,345,345,0,0,0
511818,167,167,0,0,0
511824,255,255,0,0,0
511825,102,102,0,0,0
511858,121,121,0,0,0
511888,36,36,0,0,0
511900,97,97,0,0,0
511917,184,184,0,0,0
511925,306,306,0,0,0
511933,144,144,0,0,0
511946,76,76,0,0,0
511953,310,310,0,0,0
511964,67,67,0,0,0
511982,50,50,0,0,0
511991,184,184,0,0,0
511998,85,85,0,0,0
512018,315,315,0,0,0
512019,121,121,0,0,0
512032,193,193,0,0,0
512042,193,193,0,0,0
512044,345,345,0,0,0
512059,281,281,0,0,0
512063,201,201,0,0,0
512064,345,345,0,0,0
512084,251,251,0,0,0
512091,281,281,0,0,0
512102,353,353,0,0,0
512116,306,306,0,0,0
512120,345,345,0,0,0
512122,251,251,0,0,0
512137,313,313,0,0,0
512139,168,168,0,0,0
512149,252,252,0,0,0
512155,299,299,0,0,0
512183,259,259,0,0,0
512186,259,259,0,0,0
512228,151,151,0,0,0
512231,76,76,0,0,0
512255,5,5,0,0,0
512265,76,76,0,0,0
512286,251,251,0,0,0
512299,8,8,0,0,0
512313,315,315,0,0,0
512324,94,94,0,0,0
512341,168,168,0,0,0
512342,143,143,0,0,0
512421,75,75,0,0,0
512437,252,252,0,0,0
512444,74,74,0,0,0
512464,198,198,0,0,0
512466,152,152,0,0,0
512505,282,282,0,0,0
512526,143,143,0,0,0
512532,306,306,0,0,0
512534,171,171,0,0,0
512571,171,171,0,0,0
512574,252,252,0,0,0
512580,359,359,0,0,0
512584,29,29,0,0,0
512593,137,137,0,0,0
512599,128,128,0,0,0
512600,251,251,0,0,0
512605,24,24,0,0,0
512609,193,193,0,0,0
512626,32,32,0,0,0
512628,315,315,0,0,0
512635,353,353,0,0,0
512660,14,14,0,0,0
512663,85,85,0,0,0
512668,57,57,0,0,0
512673,74,74,0,0,0
512677,137,137,0,0,0
512695,315,315,0,0,0
512698,345,345,0,0,0
512714,306,306,0,0,0
512718,143,143,0,0,0
512730,34,34,0,0,0
512739,114,114,0,0,0
512745,143,143,0,0,0
512752,144,144,0,0,0
512754,121,121,0,0,0
512757,282,282,0,0,0
512762,282,282,0,0,0
512767,70,70,0,0,0
512770,255,255,0,0,0
512772,102,102,0,0,0
512801,2,2,0,0,0
512805,131,131,0,0,0
512815,128,128,0,0,0
512818,72,72,0,0,0
512828,353,353,0,0,0
512840,252,252,0,0,0
512852,128,128,0,0,0
512857,299,299,0,0,0
512863,22,22,0,0,0
512881,306,306,0,0,0
512895,143,143,0,0,0
512904,7,7,0,0,0
512908,306,306,0,0,0
512912,113,113,0,0,0
512915,143,143,0,0,0
512924,246,246,0,0,0
512935,180,180,0,0,0
512938,315,315,0,0,0
512940,76,76,0,0,0
512944,345,345,0,0,0
512959,25,25,0,0,0
513007,345,345,0,0,0
513010,168,168,0,0,0
513011,158,158,0,0,0
513024,167,167,0,0,0
513025,83,83,0,0,0
513028,8,8,0,0,0
513040,259,259,0,0,0
513055,259,259,0,0,0
513061,72,72,0,0,0
513092,102,102,0,0,0
513103,306,306,0,0,0
513115,55,55,0,0,0
513128,17,17,0,0,0
513130,306,306,0,0,0
513135,63,63,0,0,0
513139,87,87,0,0,0
513146,28,28,0,0,0
513159,345,345,0,0,0
513181,21,21,0,0,0
513193,152,152,0,0,0
513197,255,255,0,0,0
513253,198,198,0,0,0
513265,24,24,0,0,0
513267,402,402,0,0,0
513268,4,4,0,0,0
513272,402,402,0,0,0
513281,2,2,0,0,0
513303,74,74,0,0,0
513319,128,128,0,0,0
513343,282,282,0,0,0
513350,163,163,0,0,0
513374,27,27,0,0,0
513375,144,144,0,0,0
513405,10,10,0,0,0
513407,101,101,0,0,0
513414,201,201,0,0,0
513418,120,120,0,0,0
513422,281,281,0,0,0
513423,232,232,0,0,0
513434,158,158,0,0,0
513473,3,3,0,0,0
513481,128,128,0,0,0
513497,83,83,0,0,0
513498,133,133,0,0,0
513503,246,246,0,0,0
513509,299,299,0,0,0
513513,120,120,0,0,0
513514,32,32,0,0,0
513518,193,193,0,0,0
513528,255,255,0,0,0
513559,198,198,0,0,0
513562,259,259,0,0,0
513563,282,282,0,0,0
513611,313,313,0,0,0
513620,402,402,0,0,0
513634,63,63,0,0,0
513636,44,44,0,0,0
513660,251,251,0,0,0
513661,259,259,0,0,0
513669,281,281,0,0,0
513693,251,251,0,0,0
513720,102,102,0,0,0
513723,198,198,0,0,0
513726,82,82,0,0,0
513729,310,310,0,0,0
513738,306,306,0,0,0
513740,34,34,0,0,0
513761,71,71,0,0,0
513765,232,232,0,0,0
513768,11,11,0,0,0
513771,76,76,0,0,0
513782,15,15,0,0,0
513787,201,201,0,0,0
513791,102,102,0,0,0
513795,5,5,0,0,0
513801,137,137,0,0,0
513839,299,299,0,0,0
513842,353,353,0,0,0
513866,70,70,0,0,0
513880,9,9,0,0,0
513888,310,310,0,0,0
513890,353,353,0,0,0
513951,63,63,0,0,0
513954,168,168,0,0,0
513966,97,97,0,0,0
513973,201,201,0,0,0
513977,43,43,0,0,0
513998,315,315,0,0,0
514002,57,57,0,0,0
514009,2,2,0,0,0
514010,12,12,0,0,0
514015,359,359,0,0,0
514029,255,255,0,0,0
514077,310,310,0,0,0
514082,70,70,0,0,0
514083,102,102,0,0,0
514101,133,133,0,0,0
514122,143,143,0,0,0
514125,282,282,0,0,0
514149,345,345,0,0,0
514156,299,299,0,0,0
514166,131,131,0,0,0
514177,63,63,0,0,0
514195,198,198,0,0,0
514214,83,83,0,0,0
514217,180,180,0,0,0
514228,151,151,0,0,0
514231,10,10,0,0,0
514233,282,282,0,0,0
514241,255,255,0,0,0
514254,353,353,0,0,0
514255,58,58,0,0,0
514262,353,353,0,0,0
514266,310,310,0,0,0
514297,36,36,0,0,0
514299,94,94,0,0,0
514315,82,82,0,0,0
514328,163,163,0,0,0
514335,282,282,0,0,0
514336,71,71,0,0,0
514342,310,310,0,0,0
514345,130,130,0,0,0
514354,359,359,0,0,0
514364,94,94,0,0,0
514381,102,102,0,0,0
514407,359,359,0,0,0
514437,8,8,0,0,0
514445,171,171,0,0,0
514447,198,198,0,0,0
514449,310,310,0,0,0
514463,71,71,0,0,0
514469,299,299,0,0,0
514472,299,299,0,0,0
514488,353,353,0,0,0
514494,63,63,0,0,0
514501,101,101,0,0,0
514505,252,252,0,0,0
514511,152,152,0,0,0
514514,281,281,0,0,0
514527,281,281,0,0,0
514531,21,21,0,0,0
514543,345,345,0,0,0
514554,281,281,0,0,0
514574,35,35,0,0,0
514584,103,103,0,0,0
514597,144,144,0,0,0
514603,65,65,0,0,0
514604,131,131,0,0,0
514621,359,359,0,0,0
514643,14,14,0,0,0
514647,102,102,0,0,0
514651,12,12,0,0,0
514658,44,44,0,0,0
514664,402,402,0,0,0
514675,163,163,0,0,0
514677,121,121,0,0,0
514680,232,232,0,0,0
514681,97,97,0,0,0
514694,259,259,0,0,0
514720,315,315,0,0,0
514721,345,345,0,0,0
514727,246,246,0,0,0
514742,193,193,0,0,0
514753,180,180,0,0,0
514760,353,353,0,0,0
514785,315,315,0,0,0
514796,57,57,0,0,0
514827,1,1,0,0,0
514829,137,137,0,0,0
514865,359,359,0,0,0
514877,36,36,0,0,0
514887,251,251,0,0,0
514892,345,345,0,0,0
514895,359,359,0,0,0
514919,8,8,0,0,0
514924,85,85,0,0,0
514942,345,345,0,0,0
514952,137,137,0,0,0
514960,310,310,0,0,0
514964,66,66,0,0,0
514976,184,184,0,0,0
514980,232,232,0,0,0
514987,246,246,0,0,0
514992,171,171,0,0,0
515001,171,171,0,0,0
515005,252,252,0,0,0
515008,171,171,0,0,0
515011,24,24,0,0,0
515021,1,1,0,0,0
515030,50,50,0,0,0
515043,1,1,0,0,0
515045,30,30,0,0,0
515070,201,201,0,0,0
515100,259,259,0,0,0
515116,71,71,0,0,0
515129,11,11,0,0,0
515138,151,151,0,0,0
515141,14,14,0,0,0
515151,74,74,0,0,0
515164,13,13,0,0,0
515187,252,252,0,0,0
515195,34,34,0,0,0
515198,252,252,0,0,0
515211,246,246,0,0,0
515218,315,315,0,0,0
515237,17,17,0,0,0
515243,87,87,0,0,0
515247,402,402,0,0,0
515251,255,255,0,0,0
515266,74,74,0,0,0
515274,50,50,0,0,0
515299,281,281,0,0,0
515307,70,70,0,0,0
515312,281,281,0,0,0
515332,310,310,0,0,0
515338,232,232,0,0,0
515404,251,251,0,0,0
515412,143,143,0,0,0
515429,6,6,0,0,0
515450,232,232,0,0,0
515451,251,251,0,0,0
515459,246,246,0,0,0
515461,74,74,0,0,0
515467,180,180,0,0,0
515510,259,259,0,0,0
515513,306,306,0,0,0
515526,184,184,0,0,0
515532,8,8,0,0,0
515574,313,313,0,0,0
515575,83,83,0,0,0
515587,9,9,0,0,0
515595,315,315,0,0,0
515600,82,82,0,0,0
515610,251,251,0,0,0
515614,345,345,0,0,0
515617,193,193,0,0,0
515622,232,232,0,0,0
515644,3,3,0,0,0
515651,299,299,0,0,0
515669,143,143,0,0,0
515671,69,69,0,0,0
515687,158,158,0,0,0
515711,77,77,0,0,0
515741,97,97,0,0,0
515746,71,71,0,0,0
515749,56,56,0,0,0
515758,151,151,0,0,0
515760,58,58,0,0,0
515787,310,310,0,0,0
515796,299,299,0,0,0
515801,16,16,0,0,0
515807,57,57,0,0,0
515816,171,171,0,0,0
515859,103,103,0,0,0
515860,137,137,0,0,0
515868,102,102,0,0,0
515869,114,114,0,0,0
515892,193,193,0,0,0
515899,251,251,0,0,0
515908,8,8,0,0,0
515912,281,281,0,0,0
515917,55,55,0,0,0
515935,345,345,0,0,0
515940,167,167,0,0,0
515942,87,87,0,0,0
515964,102,102,0,0,0
515974,310,310,0,0,0
515982,299,299,0,0,0
515992,9,9,0,0,0
516015,255,255,0,0,0
516020,201,201,0,0,0
516052,114,114,0,0,0
516055,94,94,0,0,0
516060,315,315,0,0,0
516066,299,299,0,0,0
516075,70,70,0,0,0
516080,281,281,0,0,0
516085,151,151,0,0,0
516090,299,299,0,0,0
516094,299,299,0,0,0
516099,315,315,0,0,0
516112,259,259,0,0,0
516125,359,359,0,0,0
516128,121,121,0,0,0
516130,2,2,0,0,0
516140,281,281,0,0,0
516147,151,151,0,0,0
516154,102,102,0,0,0
516168,299,299,0,0,0
516172,94,94,0,0,0
516179,299,299,0,0,0
516186,63,63,0,0,0
516192,168,168,0,0,0
516195,23,23,0,0,0
516202,102,102,0,0,0
516225,74,74,0,0,0
516274,19,19,0,0,0
516286,151,151,0,0,0
516292,201,201,0,0,0
516297,299,299,0,0,0
516313,101,101,0,0,0
516322,255,255,0,0,0
516323,128,128,0,0,0
516365,36,36,0,0,0
516366,25,25,0,0,0
516374,15,15,0,0,0
516381,251,251,0,0,0
516389,310,310,0,0,0
516396,151,151,0,0,0
516402,144,144,0,0,0
516403,29,29,0,0,0
516417,251,251,0,0,0
516446,246,246,0,0,0
516450,121,121,0,0,0
516451,201,201,0,0,0
516460,310,310,0,0,0
516472,8,8,0,0,0
516499,76,76,0,0,0
516523,315,315,0,0,0
516528,313,313,0,0,0
516538,198,198,0,0,0
516539,232,232,0,0,0
516548,103,103,0,0,0
516551,306,306,0,0,0
516554,282,282,0,0,0
516559,7,7,0,0,0
516564,87,87,0,0,0
516591,23,23,0,0,0
516596,71,71,0,0,0
516601,255,255,0,0,0
516605,66,66,0,0,0
516622,163,163,0,0,0
516623,131,131,0,0,0
516644,167,167,0,0,0
516646,353,353,0,0,0
516663,310,310,0,0,0
516672,259,259,0,0,0
516677,74,74,0,0,0
516680,133,133,0,0,0
516681,2,2,0,0,0
516693,353,353,0,0,0
516702,39,39,0,0,0
516704,143,143,0,0,0
516705,315,315,0,0,0
516748,35,35,0,0,0
516759,282,282,0,0,0
516769,167,167,0,0,0
516789,198,198,0,0,0
516805,25,25,0,0,0
516815,151,151,0,0,0
516831,77,77,0,0,0
516844,6,6,0,0,0
516851,133,133,0,0,0
516858,70,70,0,0,0
516870,402,402,0,0,0
516872,310,310,0,0,0
516879,74,74,0,0,0
516880,151,151,0,0,0
516899,143,143,0,0,0
516906,310,310,0,0,0
516911,71,71,0,0,0
516914,143,143,0,0,0
516918,163,163,0,0,0
516941,310,310,0,0,0
516952,255,255,0,0,0
516953,36,36,0,0,0
516962,353,353,0,0,0
516976,255,255,0,0,0
516996,82,82,0,0,0
517004,232,232,0,0,0
517009,128,128,0,0,0
517040,131,131,0,0,0
517042,97,97,0,0,0
517054,252,252,0,0,0
517082,359,359,0,0,0
517107,102,102,0,0,0
517120,255,255,0,0,0
517122,252,252,0,0,0
517128,74,74,0,0,0
517141,168,168,0,0,0
517148,255,255,0,0,0
517149,306,306,0,0,0
517151,201,201,0,0,0
517153,102,102,0,0,0
517169,17,17,0,0,0
517170,152,152,0,0,0
517173,315,315,0,0,0
517174,168,168,0,0,0
517177,246,246,0,0,0
517234,45,45,0,0,0
517241,24,24,0,0,0
517249,75,75,0,0,0
517265,32,32,0,0,0
517274,251,251,0,0,0
517282,120,120,0,0,0
517283,1,1,0,0,0
517285,17,17,0,0,0
517294,168,168,0,0,0
517323,94,94,0,0,0
517353,168,168,0,0,0
517359,310,310,0,0,0
517361,282,282,0,0,0
517369,18,18,0,0,0
517382,402,402,0,0,0
517407,313,313,0,0,0
517417,255,255,0,0,0
517427,137,137,0,0,0
517440,152,152,0,0,0
517443,17,17,0,0,0
517515,120,120,0,0,0
517516,171,171,0,0,0
517527,121,121,0,0,0
517528,25,25,0,0,0
517544,252,252,0,0,0
517556,168,168,0,0,0
517565,402,402,0,0,0
517599,18,18,0,0,0
517618,144,144,0,0,0
517620,8,8,0,0,0
517647,282,282,0,0,0
517658,255,255,0,0,0
517669,34,34,0,0,0
517684,232,232,0,0,0
517716,306,306,0,0,0
517731,252,252,0,0,0
517734,198,198,0,0,0
517738,282,282,0,0,0
517746,167,167,0,0,0
517751,158,158,0,0,0
517760,198,198,0,0,0
517765,184,184,0,0,0
517771,359,359,0,0,0
517793,232,232,0,0,0
517808,50,50,0,0,0
517813,259,259,0,0,0
517847,246,246,0,0,0
517863,87,87,0,0,0
517898,15,15,0,0,0
517922,193,193,0,0,0
517936,85,85,0,0,0
517968,114,114,0,0,0
518008,133,133,0,0,0
518016,102,102,0,0,0
518022,29,29,0,0,0
518023,246,246,0,0,0
518051,74,74,0,0,0
518059,168,168,0,0,0
518088,12,12,0,0,0
518120,66,66,0,0,0
518132,77,77,0,0,0
518156,19,19,0,0,0
518161,94,94,0,0,0
518171,20,20,0,0,0
518198,402,402,0,0,0
518229,23,23,0,0,0
518231,281,281,0,0,0
518247,345,345,0,0,0
518274,201,201,0,0,0
518282,11,11,0,0,0
518287,44,44,0,0,0
518304,315,315,0,0,0
518308,246,246,0,0,0
518310,167,167,0,0,0
518318,180,180,0,0,0
518323,402,402,0,0,0
518393,152,152,0,0,0
518400,76,76,0,0,0
518401,251,251,0,0,0
518412,7,7,0,0,0
518416,180,180,0,0,0
518417,137,137,0,0,0
518427,359,359,0,0,0
518432,359,359,0,0,0
518435,27,27,0,0,0
518437,310,310,0,0,0
518443,310,310,0,0,0
518455,70,70,0,0,0
518460,180,180,0,0,0
518490,168,168,0,0,0
518494,121,121,0,0,0
518514,102,102,0,0,0
518535,101,101,0,0,0
518539,353,353,0,0,0
518543,137,137,0,0,0
518548,36,36,0,0,0
518570,359,359,0,0,0
518587,137,137,0,0,0
518608,76,76,0,0,0
518612,143,143,0,0,0
518614,143,143,0,0,0
518633,255,255,0,0,0
518653,232,232,0,0,0
518660,137,137,0,0,0
518667,306,306,0,0,0
518668,232,232,0,0,0
518682,171,171,0,0,0
518685,128,128,0,0,0
518705,102,102,0,0,0
518708,40,40,0,0,0
518717,193,193,0,0,0
518723,184,184,0,0,0
518737,113,113,0,0,0
518747,65,65,0,0,0
518749,128,128,0,0,0
518755,180,180,0,0,0
518771,158,158,0,0,0
518778,168,168,0,0,0
518780,246,246,0,0,0
518801,152,152,0,0,0
518830,19,19,0,0,0
518837,152,152,0,0,0
518845,306,306,0,0,0
518858,152,152,0,0,0
518861,345,345,0,0,0
518868,74,74,0,0,0
518898,131,131,0,0,0
518916,34,34,0,0,0
518923,77,77,0,0,0
518929,130,130,0,0,0
518930,281,281,0,0,0
518934,102,102,0,0,0
518957,158,158,0,0,0
518971,102,102,0,0,0
519032,143,143,0,0,0
519052,130,130,0,0,0
519055,171,171,0,0,0
519062,114,114,0,0,0
519068,65,65,0,0,0
519077,345,345,0,0,0
519082,113,113,0,0,0
519094,12,12,0,0,0
519144,299,299,0,0,0
519154,76,76,0,0,0
519163,56,56,0,0,0
519180,306,306,0,0,0
519213,345,345,0,0,0
519232,97,97,0,0,0
519237,255,255,0,0,0
519239,43,43,0,0,0
519250,306,306,0,0,0
519252,315,315,0,0,0
519271,17,17,0,0,0
519278,137,137,0,0,0
519286,27,27,0,0,0
519289,114,114,0,0,0
519306,151,151,0,0,0
519320,85,85,0,0,0
519338,310,310,0,0,0
519349,345,345,0,0,0
519350,70,70,0,0,0
519361,299,299,0,0,0
519373,76,76,0,0,0
519403,102,102,0,0,0
519422,345,345,0,0,0
519423,102,102,0,0,0
519424,313,313,0,0,0
519433,32,32,0,0,0
519437,130,130,0,0,0
519454,252,252,0,0,0
519459,16,16,0,0,0
519468,259,259,0,0,0
519476,76,76,0,0,0
519520,58,58,0,0,0
519540,65,65,0,0,0
519541,34,34,0,0,0
519543,102,102,0,0,0
519555,19,19,0,0,0
519568,171,171,0,0,0
519575,74,74,0,0,0
519613,87,87,0,0,0
519624,121,121,0,0,0
519640,246,246,0,0,0
519668,402,402,0,0,0
519705,180,180,0,0,0
519709,16,16,0,0,0
519728,246,246,0,0,0
519734,315,315,0,0,0
519753,282,282,0,0,0
519759,281,281,0,0,0
519760,255,255,0,0,0
519774,315,315,0,0,0
519792,143,143,0,0,0
519800,120,120,0,0,0
519805,130,130,0,0,0
519809,25,25,0,0,0
519812,103,103,0,0,0
519829,313,313,0,0,0
519835,77,77,0,0,0
519839,158,158,0,0,0
519842,168,168,0,0,0
519859,246,246,0,0,0
519865,130,130,0,0,0
519869,15,15,0,0,0
519877,345,345,0,0,0
519891,103,103,0,0,0
519900,74,74,0,0,0
519902,151,151,0,0,0
519916,9,9,0,0,0
519925,193,193,0,0,0
519954,201,201,0,0,0
519958,184,184,0,0,0
519960,70,70,0,0,0
519962,83,83,0,0,0
519981,8,8,0,0,0
519985,315,315,0,0,0
520009,359,359,0,0,0
520012,193,193,0,0,0
520013,71,71,0,0,0
520018,246,246,0,0,0
520021,8,8,0,0,0
520040,36,36,0,0,0
520074,359,359,0,0,0
520081,35,35,0,0,0
520097,43,43,0,0,0
520109,313,313,0,0,0
520117,282,282,0,0,0
520123,306,306,0,0,0
520126,43,43,0,0,0
520130,345,345,0,0,0
520134,5,5,0,0,0
520159,7,7,0,0,0
520160,315,315,0,0,0
520167,151,151,0,0,0
520177,184,184,0,0,0
520182,66,66,0,0,0
520188,282,282,0,0,0
520192,163,163,0,0,0
520201,163,163,0,0,0
520205,34,34,0,0,0
520218,251,251,0,0,0
520226,10,10,0,0,0
520234,282,282,0,0,0
520241,246,246,0,0,0
520253,2,2,0,0,0
520265,167,167,0,0,0
520271,345,345,0,0,0
520280,345,345,0,0,0
520292,252,252,0,0,0
520308,121,121,0,0,0
520318,251,251,0,0,0
520325,402,402,0,0,0
520330,306,306,0,0,0
520357,252,252,0,0,0
520358,198,198,0,0,0
520364,101,101,0,0,0
520368,102,102,0,0,0
520369,184,184,0,0,0
520372,18,18,0,0,0
520373,17,17,0,0,0
520379,315,315,0,0,0
520382,85,85,0,0,0
520397,9,9,0,0,0
520400,71,71,0,0,0
520430,113,113,0,0,0
520459,6,6,0,0,0
520468,259,259,0,0,0
520473,184,184,0,0,0
520475,313,313,0,0,0
520476,315,315,0,0,0
520484,152,152,0,0,0
520495,232,232,0,0,0
520500,74,74,0,0,0
520510,345,345,0,0,0
520521,130,130,0,0,0
520543,97,97,0,0,0
520548,16,16,0,0,0
520562,282,282,0,0,0
520590,87,87,0,0,0
520596,402,402,0,0,0
520598,310,310,0,0,0
520628,259,259,0,0,0
520632,402,402,0,0,0
520633,180,180,0,0,0
520637,167,167,0,0,0
520649,299,299,0,0,0
520651,345,345,0,0,0
520652,152,152,0,0,0
520666,40,40,0,0,0
520672,259,259,0,0,0
520684,22,22,0,0,0
520690,121,121,0,0,0
520692,102,102,0,0,0
520696,168,168,0,0,0
520710,315,315,0,0,0
520728,114,114,0,0,0
520729,306,306,0,0,0
520737,306,306,0,0,0
520738,40,40,0,0,0
520755,255,255,0,0,0
520762,168,168,0,0,0
520786,246,246,0,0,0
520797,193,193,0,0,0
520811,232,232,0,0,0
520837,201,201,0,0,0
520841,74,74,0,0,0
520845,10,10,0,0,0
520853,299,299,0,0,0
520858,65,65,0,0,0
520882,44,44,0,0,0
520902,44,44,0,0,0
520913,310,310,0,0,0
520945,299,299,0,0,0
520956,29,29,0,0,0
520985,345,345,0,0,0
520999,15,15,0,0,0
521007,121,121,0,0,0
521013,163,163,0,0,0
521033,158,158,0,0,0
521048,144,144,0,0,0
521059,252,252,0,0,0
521084,201,201,0,0,0
521103,313,313,0,0,0
521113,65,65,0,0,0
521124,101,101,0,0,0
521159,402,402,0,0,0
521165,299,299,0,0,0
521172,310,310,0,0,0
521179,163,163,0,0,0
521186,315,315,0,0,0
521193,11,11,0,0,0
521206,359,359,0,0,0
521231,3,3,0,0,0
521247,299,299,0,0,0
521248,74,74,0,0,0
521251,402,402,0,0,0
521258,151,151,0,0,0
521260,171,171,0,0,0
521264,27,27,0,0,0
521267,252,252,0,0,0
521292,359,359,0,0,0
521299,40,40,0,0,0
521302,9,9,0,0,0
521304,251,251,0,0,0
521312,137,137,0,0,0
521324,65,65,0,0,0
521343,128,128,0,0,0
521356,40,40,0,0,0
521372,3,3,0,0,0
521374,232,232,0,0,0
521377,359,359,0,0,0
521398,87,87,0,0,0
521427,14,14,0,0,0
521428,137,137,0,0,0
521435,19,19,0,0,0
521439,113,113,0,0,0
521462,102,102,0,0,0
521469,102,102,0,0,0
521475,259,259,0,0,0
521485,251,251,0,0,0
521502,143,143,0,0,0
521530,168,168,0,0,0
521541,50,50,0,0,0
521553,13,13,0,0,0
521566,359,359,0,0,0
521625,359,359,0,0,0
521640,56,56,0,0,0
521644,299,299,0,0,0
521652,193,193,0,0,0
521662,246,246,0,0,0
521664,255,255,0,0,0
521674,232,232,0,0,0
521679,246,246,0,0,0
521720,6,6,0,0,0
521741,76,76,0,0,0
521745,180,180,0,0,0
521769,167,167,0,0,0
521770,315,315,0,0,0
521775,75,75,0,0,0
521776,16,16,0,0,0
521787,306,306,0,0,0
521790,102,102,0,0,0
521793,7,7,0,0,0
521797,15,15,0,0,0
521801,152,152,0,0,0
521822,353,353,0,0,0
521832,1,1,0,0,0
521841,71,71,0,0,0
521843,82,82,0,0,0
521851,27,27,0,0,0
521853,152,152,0,0,0
521855,132,132,0,0,0
521883,75,75,0,0,0
521903,151,151,0,0,0
521908,246,246,0,0,0
521928,29,29,0,0,0
521934,22,22,0,0,0
521938,63,63,0,0,0
521954,259,259,0,0,0
521970,359,359,0,0,0
521988,20,20,0,0,0
522019,281,281,0,0,0
522031,85,85,0,0,0
522037,402,402,0,0,0
522045,8,8,0,0,0
522047,198,198,0,0,0
522062,255,255,0,0,0
522089,152,152,0,0,0
522092,171,171,0,0,0
522119,353,353,0,0,0
522136,83,83,0,0,0
522146,7,7,0,0,0
522147,2,2,0,0,0
522163,12,12,0,0,0
522185,15,15,0,0,0
522191,121,121,0,0,0
522193,131,131,0,0,0
522194,137,137,0,0,0
522196,259,259,0,0,0
522199,315,315,0,0,0
522202,7,7,0,0,0
522218,359,359,0,0,0
522221,359,359,0,0,0
522241,359,359,0,0,0
522250,143,143,0,0,0
522259,83,83,0,0,0
522284,246,246,0,0,0
522303,5,5,0,0,0
522309,121,121,0,0,0
522324,114,114,0,0,0
522327,13,13,0,0,0
522356,77,77,0,0,0
522359,101,101,0,0,0
522368,313,313,0,0,0
522380,133,133,0,0,0
522381,57,57,0,0,0
522384,255,255,0,0,0
522405,180,180,0,0,0
522409,158,158,0,0,0
522411,345,345,0,0,0
522419,72,72,0,0,0
522422,121,121,0,0,0
522428,163,163,0,0,0
522435,281,281,0,0,0
522444,315,315,0,0,0
522446,76,76,0,0,0
522448,345,345,0,0,0
522480,143,143,0,0,0
522483,259,259,0,0,0
522488,259,259,0,0,0
522499,193,193,0,0,0
522509,313,313,0,0,0
522511,8,8,0,0,0
522512,114,114,0,0,0
522533,5,5,0,0,0
522539,282,282,0,0,0
522557,163,163,0,0,0
522571,193,193,0,0,0
522580,102,102,0,0,0
522582,282,282,0,0,0
522607,306,306,0,0,0
522610,359,359,0,0,0
522613,167,167,0,0,0
522619,20,20,0,0,0
522652,101,101,0,0,0
522655,131,131,0,0,0
522678,65,65,0,0,0
522682,282,282,0,0,0
522698,8,8,0,0,0
522700,77,77,0,0,0
522704,402,402,0,0,0
522715,132,132,0,0,0
522726,152,152,0,0,0
522727,299,299,0,0,0
522739,345,345,0,0,0
522764,70,70,0,0,0
522831,255,255,0,0,0
522846,281,281,0,0,0
522848,184,184,0,0,0
522854,232,232,0,0,0
522857,10,10,0,0,0
522862,101,101,0,0,0
522867,345,345,0,0,0
522928,50,50,0,0,0
522944,163,163,0,0,0
522952,18,18,0,0,0
522958,281,281,0,0,0
522959,23,23,0,0,0
522962,353,353,0,0,0
522963,74,74,0,0,0
522985,69,69,0,0,0
522987,246,246,0,0,0
522996,103,103,0,0,0
523013,402,402,0,0,0
523017,180,180,0,0,0
523024,184,184,0,0,0
523035,85,85,0,0,0
523037,151,151,0,0,0
523055,152,152,0,0,0
523061,121,121,0,0,0
523071,114,114,0,0,0
523075,281,281,0,0,0
523087,313,313,0,0,0
523095,144,144,0,0,0
523099,402,402,0,0,0
523107,14,14,0,0,0
523110,251,251,0,0,0
523121,65,65,0,0,0
523128,16,16,0,0,0
523133,143,143,0,0,0
523147,180,180,0,0,0
523152,43,43,0,0,0
523156,35,35,0,0,0
523176,345,345,0,0,0
523182,310,310,0,0,0
523198,310,310,0,0,0
523202,13,13,0,0,0
523215,313,313,0,0,0
523221,137,137,0,0,0
523242,353,353,0,0,0
523250,75,75,0,0,0
523307,180,180,0,0,0
523319,29,29,0,0,0
523334,13,13,0,0,0
523346,35,35,0,0,0
523352,281,281,0,0,0
523359,167,167,0,0,0
523361,306,306,0,0,0
523367,39,39,0,0,0
523372,246,246,0,0,0
523375,306,306,0,0,0
523378,259,259,0,0,0
523380,143,143,0,0,0
523382,102,102,0,0,0
523394,353,353,0,0,0
523428,71,71,0,0,0
523444,2,2,0,0,0
523452,255,255,0,0,0
523453,310,310,0,0,0
523455,402,402,0,0,0
523469,102,102,0,0,0
523478,75,75,0,0,0
523479,184,184,0,0,0
523490,16,16,0,0,0
523507,97,97,0,0,0
523514,121,121,0,0,0
523580,345,345,0,0,0
523584,76,76,0,0,0
523603,282,282,0,0,0
523625,121,121,0,0,0
523627,15,15,0,0,0
523632,232,232,0,0,0
523689,171,171,0,0,0
523704,353,353,0,0,0
523761,87,87,0,0,0
523764,315,315,0,0,0
523774,313,313,0,0,0
523801,128,128,0,0,0
523810,299,299,0,0,0
523817,75,75,0,0,0
523830,246,246,0,0,0
523835,167,167,0,0,0
523842,70,70,0,0,0
523865,114,114,0,0,0
523867,102,102,0,0,0
523871,70,70,0,0,0
523882,74,74,0,0,0
523890,20,20,0,0,0
523896,152,152,0,0,0
523940,306,306,0,0,0
523953,102,102,0,0,0
523962,252,252,0,0,0
523971,313,313,0,0,0
523974,121,121,0,0,0
523989,50,50,0,0,0
523995,128,128,0,0,0
524013,39,39,0,0,0
524016,11,11,0,0,0
524021,345,345,0,0,0
524024,6,6,0,0,0
524028,193,193,0,0,0
524039,143,143,0,0,0
524040,19,19,0,0,0
524052,128,128,0,0,0
524073,152,152,0,0,0
524096,180,180,0,0,0
524113,76,76,0,0,0
524120,232,232,0,0,0
524138,14,14,0,0,0
524145,353,353,0,0,0
524163,310,310,0,0,0
524170,167,167,0,0,0
524189,74,74,0,0,0
524196,251,251,0,0,0
524202,102,102,0,0,0
524206,402,402,0,0,0
524213,252,252,0,0,0
524219,144,144,0,0,0
524223,5,5,0,0,0
524247,58,58,0,0,0
524252,151,151,0,0,0
524254,310,310,0,0,0
524255,152,152,0,0,0
524264,246,246,0,0,0
524286,255,255,0,0,0
524291,7,7,0,0,0
524293,137,137,0,0,0
524323,299,299,0,0,0
524348,101,101,0,0,0
524350,15,15,0,0,0
524352,299,299,0,0,0
524383,353,353,0,0,0
524388,7,7,0,0,0
524406,259,259,0,0,0
524407,7,7,0,0,0
524410,315,315,0,0,0
524413,184,184,0,0,0
524419,22,22,0,0,0
524421,313,313,0,0,0
524448,201,201,0,0,0
524449,76,76,0,0,0
524457,252,252,0,0,0
524460,87,87,0,0,0
524466,152,152,0,0,0
524467,5,5,0,0,0
524480,102,102,0,0,0
524492,131,131,0,0,0
524495,163,163,0,0,0
524497,315,315,0,0,0
524509,121,121,0,0,0
524512,19,19,0,0,0
524522,281,281,0,0,0
524524,15,15,0,0,0
524525,17,17,0,0,0
524527,184,184,0,0,0
524540,94,94,0,0,0
524556,87,87,0,0,0
524557,58,58,0,0,0
524564,102,102,0,0,0
524568,310,310,0,0,0
524601,25,25,0,0,0
524609,171,171,0,0,0
524638,171,171,0,0,0
524657,299,299,0,0,0
524668,184,184,0,0,0
524669,67,67,0,0,0
524701,281,281,0,0,0
524702,402,402,0,0,0
524705,402,402,0,0,0
524716,184,184,0,0,0
524720,121,121,0,0,0
524734,77,77,0,0,0
524738,251,251,0,0,0
524745,359,359,0,0,0
524753,29,29,0,0,0
524787,255,255,0,0,0
524790,87,87,0,0,0
524799,184,184,0,0,0
524805,29,29,0,0,0
524808,282,282,0,0,0
524811,251,251,0,0,0
524830,43,43,0,0,0
524837,281,281,0,0,0
524845,25,25,0,0,0
524846,201,201,0,0,0
524862,102,102,0,0,0
524878,232,232,0,0,0
524882,113,113,0,0,0
524894,232,232,0,0,0
524895,252,252,0,0,0
524907,50,50,0,0,0
524947,143,143,0,0,0
524963,5,5,0,0,0
524978,353,353,0,0,0
524987,353,353,0,0,0
524991,74,74,0,0,0
525003,131,131,0,0,0
525015,3,3,0,0,0
525032,193,193,0,0,0
525033,114,114,0,0,0
525056,152,152,0,0,0
525063,12,12,0,0,0
525068,313,313,0,0,0
525081,25,25,0,0,0
525084,310,310,0,0,0
525086,313,313,0,0,0
525087,232,232,0,0,0
525094,315,315,0,0,0
525118,151,151,0,0,0
525133,121,121,0,0,0
525136,133,133,0,0,0
525148,255,255,0,0,0
525149,12,12,0,0,0
525150,193,193,0,0,0
525157,171,171,0,0,0
525160,2,2,0,0,0
525163,180,180,0,0,0
525171,128,128,0,0,0
525187,55,55,0,0,0
525210,44,44,0,0,0
525212,251,251,0,0,0
525226,113,113,0,0,0
525255,359,359,0,0,0
525256,69,69,0,0,0
525258,168,168,0,0,0
525282,402,402,0,0,0
525290,22,22,0,0,0
525295,137,137,0,0,0
525316,24,24,0,0,0
525317,87,87,0,0,0
525328,72,72,0,0,0
525334,15,15,0,0,0
525345,113,113,0,0,0
525360,85,85,0,0,0
525368,67,67,0,0,0
525376,120,120,0,0,0
525383,184,184,0,0,0
525386,66,66,0,0,0
525395,9,9,0,0,0
525400,25,25,0,0,0
525420,168,168,0,0,0
525444,63,63,0,0,0
525449,184,184,0,0,0
525452,130,130,0,0,0
525466,259,259,0,0,0
525478,167,167,0,0,0
525480,281,281,0,0,0
525493,198,198,0,0,0
525502,143,143,0,0,0
525506,184,184,0,0,0
525509,353,353,0,0,0
525513,310,310,0,0,0
525547,252,252,0,0,0
525551,345,345,0,0,0
525620,282,282,0,0,0
525625,353,353,0,0,0
525630,251,251,0,0,0
525654,114,114,0,0,0
525660,143,143,0,0,0
525669,133,133,0,0,0
525676,353,353,0,0,0
525713,251,251,0,0,0
525716,40,40,0,0,0
525717,101,101,0,0,0
525723,114,114,0,0,0
525725,353,353,0,0,0
525731,12,12,0,0,0
525739,281,281,0,0,0
525741,232,232,0,0,0
525744,151,151,0,0,0
525752,25,25,0,0,0
525761,167,167,0,0,0
525770,313,313,0,0,0
525772,137,137,0,0,0
525775,158,158,0,0,0
525782,75,75,0,0,0
525783,1,1,0,0,0
525812,13,13,0,0,0
525813,137,137,0,0,0
525817,252,252,0,0,0
525844,70,70,0,0,0
525845,44,44,0,0,0
525851,113,113,0,0,0
525868,19,19,0,0,0
525871,281,281,0,0,0
525890,56,56,0,0,0
525904,232,232,0,0,0
525909,29,29,0,0,0
525912,282,282,0,0,0
525923,27,27,0,0,0
525929,180,180,0,0,0
525933,131,131,0,0,0
525938,76,76,0,0,0
525950,29,29,0,0,0
525957,77,77,0,0,0
525963,114,114,0,0,0
525973,252,252,0,0,0
525978,310,310,0,0,0
525981,18,18,0,0,0
525988,102,102,0,0,0
526022,259,259,0,0,0
526028,128,128,0,0,0
526047,102,102,0,0,0
526067,168,168,0,0,0
526088,193,193,0,0,0
526096,282,282,0,0,0
526114,198,198,0,0,0
526124,313,313,0,0,0
526150,306,306,0,0,0
526157,315,315,0,0,0
526175,359,359,0,0,0
526187,121,121,0,0,0
526208,246,246,0,0,0
526218,281,281,0,0,0
526221,299,299,0,0,0
526225,402,402,0,0,0
526229,85,85,0,0,0
526238,74,74,0,0,0
526246,299,299,0,0,0
526247,163,163,0,0,0
526262,184,184,0,0,0
526269,180,180,0,0,0
526278,313,313,0,0,0
526279,259,259,0,0,0
526296,193,193,0,0,0
526312,82,82,0,0,0
526317,15,15,0,0,0
526322,345,345,0,0,0
526324,71,71,0,0,0
526333,57,57,0,0,0
526373,43,43,0,0,0
526381,120,120,0,0,0
526384,34,34,0,0,0
526389,171,171,0,0,0
526439,3,3,0,0,0
526458,12,12,0,0,0
526465,66,66,0,0,0
526473,282,282,0,0,0
526503,44,44,0,0,0
526504,18,18,0,0,0
526522,11,11,0,0,0
526529,54,54,0,0,0
526534,310,310,0,0,0
526543,359,359,0,0,0
526549,3,3,0,0,0
526557,232,232,0,0,0
526562,71,71,0,0,0
526563,402,402,0,0,0
526568,132,132,0,0,0
526574,310,310,0,0,0
526586,128,128,0,0,0
526605,114,114,0,0,0
526639,151,151,0,0,0
526644,201,201,0,0,0
526658,353,353,0,0,0
526659,94,94,0,0,0
526672,43,43,0,0,0
526681,313,313,0,0,0
526682,353,353,0,0,0
526708,168,168,0,0,0
526724,251,251,0,0,0
526747,281,281,0,0,0
526755,121,121,0,0,0
526756,198,198,0,0,0
526781,353,353,0,0,0
526792,22,22,0,0,0
526815,76,76,0,0,0
526832,30,30,0,0,0
526834,198,198,0,0,0
526862,114,114,0,0,0
526865,345,345,0,0,0
526867,71,71,0,0,0
526872,74,74,0,0,0
526897,232,232,0,0,0
526928,251,251,0,0,0
526931,255,255,0,0,0
526972,128,128,0,0,0
526980,345,345,0,0,0
526981,65,65,0,0,0
526991,310,310,0,0,0
527013,252,252,0,0,0
527020,313,313,0,0,0
527023,29,29,0,0,0
527031,151,151,0,0,0
527034,251,251,0,0,0
527063,359,359,0,0,0
527080,56,56,0,0,0
527103,167,167,0,0,0
527109,158,158,0,0,0
527115,27,27,0,0,0
527119,167,167,0,0,0
527122,63,63,0,0,0
527200,133,133,0,0,0
527209,345,345,0,0,0
527214,198,198,0,0,0
527224,402,402,0,0,0
527229,41,41,0,0,0
527233,137,137,0,0,0
527248,74,74,0,0,0
527265,102,102,0,0,0
527272,251,251,0,0,0
527273,3,3,0,0,0
527293,144,144,0,0,0
527294,24,24,0,0,0
527297,34,34,0,0,0
527302,56,56,0,0,0
527341,144,144,0,0,0
527367,306,306,0,0,0
527368,306,306,0,0,0
527370,5,5,0,0,0
527374,402,402,0,0,0
527377,232,232,0,0,0
527383,72,72,0,0,0
527394,255,255,0,0,0
527413,76,76,0,0,0
527421,5,5,0,0,0
527430,299,299,0,0,0
527431,94,94,0,0,0
527451,94,94,0,0,0
527456,168,168,0,0,0
527462,281,281,0,0,0
527463,281,281,0,0,0
527468,353,353,0,0,0
527482,114,114,0,0,0
527484,180,180,0,0,0
527486,402,402,0,0,0
527494,94,94,0,0,0
527518,3,3,0,0,0
527527,102,102,0,0,0
527528,27,27,0,0,0
527550,306,306,0,0,0
527571,76,76,0,0,0
527574,34,34,0,0,0
527601,184,184,0,0,0
527620,18,18,0,0,0
527625,310,310,0,0,0
527636,259,259,0,0,0
527644,101,101,0,0,0
527655,74,74,0,0,0
527669,345,345,0,0,0
527673,77,77,0,0,0
527681,76,76,0,0,0
527693,65,65,0,0,0
527713,282,282,0,0,0
527758,152,152,0,0,0
527761,19,19,0,0,0
527772,163,163,0,0,0
527774,102,102,0,0,0
527781,41,41,0,0,0
527796,70,70,0,0,0
527807,353,353,0,0,0
527817,50,50,0,0,0
527843,58,58,0,0,0
527844,198,198,0,0,0
527849,5,5,0,0,0
527853,70,70,0,0,0
527862,137,137,0,0,0
527872,35,35,0,0,0
527878,198,198,0,0,0
527891,402,402,0,0,0
527898,69,69,0,0,0
527902,103,103,0,0,0
527906,359,359,0,0,0
527911,281,281,0,0,0
527919,144,144,0,0,0
527925,281,281,0,0,0
527934,19,19,0,0,0
527936,158,158,0,0,0
527949,402,402,0,0,0
527963,57,57,0,0,0
527995,402,402,0,0,0
528005,137,137,0,0,0
528021,252,252,0,0,0
528028,72,72,0,0,0
528039,353,353,0,0,0
528040,74,74,0,0,0
528070,120,120,0,0,0
528075,310,310,0,0,0
528080,24,24,0,0,0
528094,17,17,0,0,0
528104,299,299,0,0,0
528105,83,83,0,0,0
528120,137,137,0,0,0
528121,198,198,0,0,0
528122,359,359,0,0,0
528126,56,56,0,0,0
528132,6,6,0,0,0
528181,167,167,0,0,0
528184,50,50,0,0,0
528185,72,72,0,0,0
528189,402,402,0,0,0
528198,310,310,0,0,0
528202,94,94,0,0,0
528209,143,143,0,0,0
528211,255,255,0,0,0
528214,102,102,0,0,0
528243,232,232,0,0,0
528245,313,313,0,0,0
528248,402,402,0,0,0
528253,201,201,0,0,0
528260,255,255,0,0,0
528280,158,158,0,0,0
528284,193,193,0,0,0
528306,345,345,0,0,0
528334,198,198,0,0,0
528367,143,143,0,0,0
528381,201,201,0,0,0
528401,131,131,0,0,0
528443,163,163,0,0,0
528460,128,128,0,0,0
528461,77,77,0,0,0
528463,282,282,0,0,0
528470,158,158,0,0,0
528473,353,353,0,0,0
528474,151,151,0,0,0
528493,44,44,0,0,0
528497,8,8,0,0,0
528498,54,54,0,0,0
528505,151,151,0,0,0
528509,25,25,0,0,0
528519,180,180,0,0,0
528526,345,345,0,0,0
528529,315,315,0,0,0
528532,167,167,0,0,0
528538,143,143,0,0,0
528541,131,131,0,0,0
528546,10,10,0,0,0
528549,246,246,0,0,0
528550,402,402,0,0,0
528568,167,167,0,0,0
528583,143,143,0,0,0
528586,21,21,0,0,0
528590,310,310,0,0,0
528594,313,313,0,0,0
528605,6,6,0,0,0
528628,35,35,0,0,0
528646,13,13,0,0,0
528647,74,74,0,0,0
528656,56,56,0,0,0
528690,310,310,0,0,0
528693,251,251,0,0,0
528703,9,9,0,0,0
528712,137,137,0,0,0
528725,77,77,0,0,0
528732,167,167,0,0,0
528764,131,131,0,0,0
528773,5,5,0,0,0
528781,12,12,0,0,0
528784,27,27,0,0,0
528798,76,76,0,0,0
528817,259,259,0,0,0
528826,252,252,0,0,0
528829,74,74,0,0,0
528842,114,114,0,0,0
528852,281,281,0,0,0
528867,252,252,0,0,0
528876,353,353,0,0,0
528880,36,36,0,0,0
528926,158,158,0,0,0
528942,359,359,0,0,0
528943,282,282,0,0,0
528950,128,128,0,0,0
528958,114,114,0,0,0
528977,184,184,0,0,0
528978,11,11,0,0,0
528980,137,137,0,0,0
528983,17,17,0,0,0
528990,232,232,0,0,0
529003,315,315,0,0,0
529008,56,56,0,0,0
529010,36,36,0,0,0
529027,121,121,0,0,0
529029,345,345,0,0,0
529048,40,40,0,0,0
529071,103,103,0,0,0
529078,313,313,0,0,0
529083,72,72,0,0,0
529085,299,299,0,0,0
529093,54,54,0,0,0
529130,246,246,0,0,0
529157,402,402,0,0,0
529159,97,97,0,0,0
529192,232,232,0,0,0
529205,306,306,0,0,0
529214,201,201,0,0,0
529228,76,76,0,0,0
529239,299,299,0,0,0
529258,180,180,0,0,0
529262,82,82,0,0,0
529270,144,144,0,0,0
529272,198,198,0,0,0
529279,168,168,0,0,0
529297,58,58,0,0,0
529301,306,306,0,0,0
529324,281,281,0,0,0
529328,39,39,0,0,0
529337,345,345,0,0,0
529338,76,76,0,0,0
529347,102,102,0,0,0
529348,251,251,0,0,0
529351,299,299,0,0,0
529368,101,101,0,0,0
529370,198,198,0,0,0
529378,252,252,0,0,0
529380,259,259,0,0,0
529393,152,152,0,0,0
529396,30,30,0,0,0
529404,27,27,0,0,0
529422,306,306,0,0,0
529424,345,345,0,0,0
529432,151,151,0,0,0
529435,306,306,0,0,0
529446,299,299,0,0,0
529478,121,121,0,0,0
529494,97,97,0,0,0
529495,133,133,0,0,0
529496,184,184,0,0,0
529498,101,101,0,0,0
529499,306,306,0,0,0
529516,74,74,0,0,0
529529,97,97,0,0,0
529534,193,193,0,0,0
529535,45,45,0,0,0
529536,27,27,0,0,0
529541,310,310,0,0,0
529548,345,345,0,0,0
529597,1,1,0,0,0
529619,114,114,0,0,0
529622,168,168,0,0,0
529625,201,201,0,0,0
529635,282,282,0,0,0
529649,152,152,0,0,0
529663,299,299,0,0,0
529666,252,252,0,0,0
529672,313,313,0,0,0
529681,402,402,0,0,0
529685,167,167,0,0,0
529707,353,353,0,0,0
529708,255,255,0,0,0
529716,4,4,0,0,0
529737,121,121,0,0,0
529739,10,10,0,0,0
529759,232,232,0,0,0
529760,232,232,0,0,0
529762,402,402,0,0,0
529768,43,43,0,0,0
529782,306,306,0,0,0
529799,143,143,0,0,0
529801,74,74,0,0,0
529804,193,193,0,0,0
529805,313,313,0,0,0
529811,313,313,0,0,0
529817,246,246,0,0,0
529821,281,281,0,0,0
529826,281,281,0,0,0
529836,281,281,0,0,0
529841,5,5,0,0,0
529842,171,171,0,0,0
529852,299,299,0,0,0
529857,50,50,0,0,0
529860,45,45,0,0,0
529869,128,128,0,0,0
529870,198,198,0,0,0
529872,144,144,0,0,0
529906,252,252,0,0,0
529942,20,20,0,0,0
529946,402,402,0,0,0
529956,281,281,0,0,0
529981,359,359,0,0,0
530006,402,402,0,0,0
530043,232,232,0,0,0
530051,299,299,0,0,0
530066,282,282,0,0,0
530074,94,94,0,0,0
530100,143,143,0,0,0
530116,137,137,0,0,0
530132,306,306,0,0,0
530133,57,57,0,0,0
530154,259,259,0,0,0
530173,121,121,0,0,0
530179,2,2,0,0,0
530182,137,137,0,0,0
530190,10,10,0,0,0
530193,198,198,0,0,0
530205,6,6,0,0,0
530223,76,76,0,0,0
530232,76,76,0,0,0
530234,315,315,0,0,0
530242,402,402,0,0,0
530261,353,353,0,0,0
530303,25,25,0,0,0
530309,167,167,0,0,0
530349,17,17,0,0,0
530350,55,55,0,0,0
530356,3,3,0,0,0
530381,198,198,0,0,0
530386,252,252,0,0,0
530395,313,313,0,0,0
530404,402,402,0,0,0
530405,345,345,0,0,0
530408,402,402,0,0,0
530438,402,402,0,0,0
530456,65,65,0,0,0
530458,163,163,0,0,0
530467,35,35,0,0,0
530477,252,252,0,0,0
530481,259,259,0,0,0
530496,345,345,0,0,0
530501,281,281,0,0,0
530521,29,29,0,0,0
530532,151,151,0,0,0
530538,232,232,0,0,0
530547,121,121,0,0,0
530553,137,137,0,0,0
530559,30,30,0,0,0
530561,131,131,0,0,0
530572,359,359,0,0,0
530575,17,17,0,0,0
530578,313,313,0,0,0
530598,143,143,0,0,0
530616,259,259,0,0,0
530619,120,120,0,0,0
530624,299,299,0,0,0
530627,252,252,0,0,0
530650,232,232,0,0,0
530656,137,137,0,0,0
530665,18,18,0,0,0
530681,9,9,0,0,0
530684,7,7,0,0,0
530686,20,20,0,0,0
530687,168,168,0,0,0
530698,76,76,0,0,0
530702,94,94,0,0,0
530705,15,15,0,0,0
530706,71,71,0,0,0
530717,65,65,0,0,0
530720,101,101,0,0,0
530728,281,281,0,0,0
530738,76,76,0,0,0
530799,76,76,0,0,0
530817,255,255,0,0,0
530822,232,232,0,0,0
530826,255,255,0,0,0
530831,69,69,0,0,0
530841,19,19,0,0,0
530858,193,193,0,0,0
530880,152,152,0,0,0
530891,299,299,0,0,0
530894,57,57,0,0,0
530900,232,232,0,0,0
530901,55,55,0,0,0
530913,168,168,0,0,0
530918,359,359,0,0,0
530942,70,70,0,0,0
530944,6,6,0,0,0
530948,15,15,0,0,0
530959,232,232,0,0,0
530962,43,43,0,0,0
530999,315,315,0,0,0
531033,4,4,0,0,0
531041,76,76,0,0,0
531051,359,359,0,0,0
531056,55,55,0,0,0
531131,310,310,0,0,0
531135,184,184,0,0,0
531153,158,158,0,0,0
531171,299,299,0,0,0
531179,345,345,0,0,0
531185,1,1,0,0,0
531191,299,299,0,0,0
531196,69,69,0,0,0
531206,255,255,0,0,0
531212,281,281,0,0,0
531221,315,315,0,0,0
531233,114,114,0,0,0
531237,87,87,0,0,0
531239,27,27,0,0,0
531262,184,184,0,0,0
531269,299,299,0,0,0
531284,251,251,0,0,0
531287,167,167,0,0,0
531291,85,85,0,0,0
531303,359,359,0,0,0
531320,101,101,0,0,0
531326,67,67,0,0,0
531343,201,201,0,0,0
531366,168,168,0,0,0
531378,184,184,0,0,0
531382,121,121,0,0,0
531395,74,74,0,0,0
531404,152,152,0,0,0
531407,3,3,0,0,0
531408,131,131,0,0,0
531410,184,184,0,0,0
531456,8,8,0,0,0
531459,114,114,0,0,0
531466,359,359,0,0,0
531470,353,353,0,0,0
531495,74,74,0,0,0
531519,259,259,0,0,0
531520,251,251,0,0,0
531527,114,114,0,0,0
531535,102,102,0,0,0
531555,252,252,0,0,0
531575,313,313,0,0,0
531580,94,94,0,0,0
531582,70,70,0,0,0
531584,313,313,0,0,0
531600,255,255,0,0,0
531602,168,168,0,0,0
531610,232,232,0,0,0
531616,252,252,0,0,0
531625,251,251,0,0,0
531652,102,102,0,0,0
531676,17,17,0,0,0
531696,168,168,0,0,0
531700,65,65,0,0,0
531707,101,101,0,0,0
531713,345,345,0,0,0
531717,102,102,0,0,0
531724,74,74,0,0,0
531726,345,345,0,0,0
531783,310,310,0,0,0
531790,251,251,0,0,0
531809,76,76,0,0,0
531823,246,246,0,0,0
531830,255,255,0,0,0
531842,232,232,0,0,0
531843,29,29,0,0,0
531847,130,130,0,0,0
531869,180,180,0,0,0
531875,5,5,0,0,0
531884,36,36,0,0,0
531885,306,306,0,0,0
531896,345,345,0,0,0
531901,359,359,0,0,0
531910,359,359,0,0,0
531941,306,306,0,0,0
531968,151,151,0,0,0
531980,251,251,0,0,0
531987,85,85,0,0,0
531992,36,36,0,0,0
531998,54,54,0,0,0
532040,168,168,0,0,0
532047,313,313,0,0,0
532055,151,151,0,0,0
532061,299,299,0,0,0
532065,67,67,0,0,0
532086,58,58,0,0,0
532117,259,259,0,0,0
532118,67,67,0,0,0
532129,198,198,0,0,0
532130,131,131,0,0,0
532133,315,315,0,0,0
532136,94,94,0,0,0
532139,7,7,0,0,0
532147,255,255,0,0,0
532158,345,345,0,0,0
532162,259,259,0,0,0
532169,306,306,0,0,0
532176,144,144,0,0,0
532186,132,132,0,0,0
532190,315,315,0,0,0
532192,345,345,0,0,0
532211,168,168,0,0,0
532215,353,353,0,0,0
532220,44,44,0,0,0
532222,246,246,0,0,0
532230,58,58,0,0,0
532232,102,102,0,0,0
532268,5,5,0,0,0
532275,313,313,0,0,0
532284,137,137,0,0,0
532309,9,9,0,0,0
532318,19,19,0,0,0
532322,151,151,0,0,0
532323,402,402,0,0,0
532338,34,34,0,0,0
532339,20,20,0,0,0
532341,69,69,0,0,0
532350,152,152,0,0,0
532352,201,201,0,0,0
532386,113,113,0,0,0
532397,45,45,0,0,0
532410,232,232,0,0,0
532415,144,144,0,0,0
532417,299,299,0,0,0
532454,402,402,0,0,0
532461,201,201,0,0,0
532462,252,252,0,0,0
532473,12,12,0,0,0
532476,201,201,0,0,0
532477,143,143,0,0,0
532488,57,57,0,0,0
532493,184,184,0,0,0
532511,353,353,0,0,0
532525,36,36,0,0,0
532530,282,282,0,0,0
532532,27,27,0,0,0
532540,70,70,0,0,0
532554,259,259,0,0,0
532555,184,184,0,0,0
532562,163,163,0,0,0
532573,16,16,0,0,0
532579,83,83,0,0,0
532581,251,251,0,0,0
532591,232,232,0,0,0
532594,158,158,0,0,0
532606,102,102,0,0,0
532611,39,39,0,0,0
532615,87,87,0,0,0
532632,85,85,0,0,0
532633,143,143,0,0,0
532650,128,128,0,0,0
532660,130,130,0,0,0
532673,28,28,0,0,0
532676,259,259,0,0,0
532683,131,131,0,0,0
532684,359,359,0,0,0
532695,144,144,0,0,0
532705,345,345,0,0,0
532707,13,13,0,0,0
532719,9,9,0,0,0
532739,121,121,0,0,0
532755,21,21,0,0,0
532758,76,76,0,0,0
532777,12,12,0,0,0
532778,232,232,0,0,0
532784,132,132,0,0,0
532793,67,67,0,0,0
532821,313,313,0,0,0
532830,310,310,0,0,0
532836,72,72,0,0,0
532844,353,353,0,0,0
532845,50,50,0,0,0
532847,152,152,0,0,0
532855,306,306,0,0,0
532863,251,251,0,0,0
532865,6,6,0,0,0
532868,77,77,0,0,0
532872,63,63,0,0,0
532874,310,310,0,0,0
532900,69,69,0,0,0
532909,306,306,0,0,0
532913,152,152,0,0,0
532930,310,310,0,0,0
532953,75,75,0,0,0
532973,45,45,0,0,0
532992,201,201,0,0,0
533003,310,310,0,0,0
533015,69,69,0,0,0
533030,306,306,0,0,0
533038,143,143,0,0,0
533040,11,11,0,0,0
533042,137,137,0,0,0
533045,313,313,0,0,0
533051,69,69,0,0,0
533057,3,3,0,0,0
533077,198,198,0,0,0
533082,184,184,0,0,0
533095,114,114,0,0,0
533114,198,198,0,0,0
533119,252,252,0,0,0
533121,201,201,0,0,0
533132,76,76,0,0,0
533140,198,198,0,0,0
533167,163,163,0,0,0
533176,246,246,0,0,0
533179,313,313,0,0,0
533226,158,158,0,0,0
533237,133,133,0,0,0
533242,25,25,0,0,0
533248,131,131,0,0,0
533252,39,39,0,0,0
533257,5,5,0,0,0
533266,353,353,0,0,0
533277,310,310,0,0,0
533303,4,4,0,0,0
533319,299,299,0,0,0
533320,2,2,0,0,0
533331,6,6,0,0,0
533336,158,158,0,0,0
533383,313,313,0,0,0
533387,281,281,0,0,0
533394,35,35,0,0,0
533402,74,74,0,0,0
533409,101,101,0,0,0
533410,27,27,0,0,0
533434,143,143,0,0,0
533467,252,252,0,0,0
533471,25,25,0,0,0
533476,402,402,0,0,0
533479,163,163,0,0,0
533492,313,313,0,0,0
533500,44,44,0,0,0
533511,282,282,0,0,0
533513,34,34,0,0,0
533515,152,152,0,0,0
533517,137,137,0,0,0
533560,313,313,0,0,0
533569,70,70,0,0,0
533573,152,152,0,0,0
533576,39,39,0,0,0
533583,201,201,0,0,0
533585,315,315,0,0,0
533618,11,11,0,0,0
533636,353,353,0,0,0
533652,251,251,0,0,0
533660,101,101,0,0,0
533699,402,402,0,0,0
533701,54,54,0,0,0
533710,252,252,0,0,0
533714,184,184,0,0,0
533721,232,232,0,0,0
533732,310,310,0,0,0
533741,34,34,0,0,0
533768,259,259,0,0,0
533769,18,18,0,0,0
533771,306,306,0,0,0
533780,121,121,0,0,0
533792,163,163,0,0,0
533817,120,120,0,0,0
533818,201,201,0,0,0
533820,85,85,0,0,0
533828,193,193,0,0,0
533851,39,39,0,0,0
533901,22,22,0,0,0
533929,114,114,0,0,0
533944,198,198,0,0,0
533949,12,12,0,0,0
533965,35,35,0,0,0
533966,171,171,0,0,0
533976,94,94,0,0,0
533980,4,4,0,0,0
534018,246,246,0,0,0
534029,315,315,0,0,0
534035,158,158,0,0,0
534045,151,151,0,0,0
534046,306,306,0,0,0
534051,34,34,0,0,0
534056,45,45,0,0,0
534060,255,255,0,0,0
534063,313,313,0,0,0
534094,102,102,0,0,0
534115,39,39,0,0,0
534116,18,18,0,0,0
534117,21,21,0,0,0
534134,281,281,0,0,0
534145,255,255,0,0,0
534146,345,345,0,0,0
534149,246,246,0,0,0
534170,232,232,0,0,0
534182,70,70,0,0,0
534187,114,114,0,0,0
534188,83,83,0,0,0
534210,67,67,0,0,0
534223,39,39,0,0,0
534240,315,315,0,0,0
534266,313,313,0,0,0
534273,299,299,0,0,0
534282,353,353,0,0,0
534290,7,7,0,0,0
534291,251,251,0,0,0
534306,353,353,0,0,0
534319,102,102,0,0,0
534320,15,15,0,0,0
534324,102,102,0,0,0
534326,246,246,0,0,0
534340,158,158,0,0,0
534341,63,63,0,0,0
534345,9,9,0,0,0
534349,39,39,0,0,0
534360,67,67,0,0,0
534369,10,10,0,0,0
534372,35,35,0,0,0
534376,16,16,0,0,0
534378,114,114,0,0,0
534387,14,14,0,0,0
534389,102,102,0,0,0
534407,102,102,0,0,0
534414,5,5,0,0,0
534464,152,152,0,0,0
534474,67,67,0,0,0
534476,246,246,0,0,0
534489,152,152,0,0,0
534500,18,18,0,0,0
534510,36,36,0,0,0
534543,18,18,0,0,0
534579,306,306,0,0,0
534591,193,193,0,0,0
534600,184,184,0,0,0
534610,85,85,0,0,0
534616,120,120,0,0,0
534623,163,163,0,0,0
534637,251,251,0,0,0
534644,15,15,0,0,0
534646,2,2,0,0,0
534651,163,163,0,0,0
534682,77,77,0,0,0
534691,56,56,0,0,0
534735,65,65,0,0,0
534736,402,402,0,0,0
534738,281,281,0,0,0
534770,152,152,0,0,0
534771,402,402,0,0,0
534781,402,402,0,0,0
534826,163,163,0,0,0
534827,18,18,0,0,0
534829,103,103,0,0,0
534846,232,232,0,0,0
534848,281,281,0,0,0
534859,259,259,0,0,0
534864,27,27,0,0,0
534866,163,163,0,0,0
534873,163,163,0,0,0
534882,359,359,0,0,0
534904,252,252,0,0,0
534919,167,167,0,0,0
534923,74,74,0,0,0
534924,97,97,0,0,0
534967,102,102,0,0,0
534978,15,15,0,0,0
534991,45,45,0,0,0
534993,163,163,0,0,0
535015,255,255,0,0,0
535018,168,168,0,0,0
535020,43,43,0,0,0
535041,310,310,0,0,0
535075,5,5,0,0,0
535080,306,306,0,0,0
535087,281,281,0,0,0
535093,121,121,0,0,0
535097,102,102,0,0,0
535102,11,11,0,0,0
535106,131,131,0,0,0
535109,77,77,0,0,0
535116,14,14,0,0,0
535117,72,72,0,0,0
535132,345,345,0,0,0
535138,345,345,0,0,0
535171,5,5,0,0,0
535172,94,94,0,0,0
535179,30,30,0,0,0
535188,171,171,0,0,0
535196,184,184,0,0,0
535226,310,310,0,0,0
535246,144,144,0,0,0
535249,77,77,0,0,0
535297,39,39,0,0,0
535309,36,36,0,0,0
535341,163,163,0,0,0
535343,71,71,0,0,0
535351,167,167,0,0,0
535352,137,137,0,0,0
535353,16,16,0,0,0
535374,29,29,0,0,0
535381,151,151,0,0,0
535385,97,97,0,0,0
535386,163,163,0,0,0
535387,3,3,0,0,0
535401,171,171,0,0,0
535418,299,299,0,0,0
535442,252,252,0,0,0
535465,259,259,0,0,0
535479,29,29,0,0,0
535480,306,306,0,0,0
535490,54,54,0,0,0
535501,193,193,0,0,0
535513,56,56,0,0,0
535524,306,306,0,0,0
535528,259,259,0,0,0
535540,315,315,0,0,0
535558,168,168,0,0,0
535563,345,345,0,0,0
535572,130,130,0,0,0
535573,34,34,0,0,0
535578,259,259,0,0,0
535584,180,180,0,0,0
535610,5,5,0,0,0
535618,143,143,0,0,0
535622,282,282,0,0,0
535634,310,310,0,0,0
535636,232,232,0,0,0
535647,121,121,0,0,0
535666,29,29,0,0,0
535676,30,30,0,0,0
535707,359,359,0,0,0
535710,102,102,0,0,0
535732,152,152,0,0,0
535738,6,6,0,0,0
535743,143,143,0,0,0
535748,70,70,0,0,0
535764,232,232,0,0,0
535767,77,77,0,0,0
535793,70,70,0,0,0
535797,402,402,0,0,0
535806,184,184,0,0,0
535812,56,56,0,0,0
535825,359,359,0,0,0
535827,133,133,0,0,0
535833,310,310,0,0,0
535836,232,232,0,0,0
535837,102,102,0,0,0
535839,232,232,0,0,0
535846,167,167,0,0,0
535854,75,75,0,0,0
535864,151,151,0,0,0
535871,76,76,0,0,0
535892,143,143,0,0,0
535895,281,281,0,0,0
535904,201,201,0,0,0
535909,232,232,0,0,0
535919,313,313,0,0,0
535926,128,128,0,0,0
535937,114,114,0,0,0
535940,259,259,0,0,0
535983,29,29,0,0,0
535993,359,359,0,0,0
536007,151,151,0,0,0
536026,10,10,0,0,0
536039,120,120,0,0,0
536041,281,281,0,0,0
536045,184,184,0,0,0
536057,131,131,0,0,0
536063,34,34,0,0,0
536084,168,168,0,0,0
536089,313,313,0,0,0
536107,255,255,0,0,0
536110,120,120,0,0,0
536112,315,315,0,0,0
536114,193,193,0,0,0
536125,131,131,0,0,0
536129,114,114,0,0,0
536141,315,315,0,0,0
536148,345,345,0,0,0
536159,27,27,0,0,0
536164,345,345,0,0,0
536168,71,71,0,0,0
536173,54,54,0,0,0
536189,103,103,0,0,0
536193,10,10,0,0,0
536196,102,102,0,0,0
536204,70,70,0,0,0
536207,299,299,0,0,0
536225,282,282,0,0,0
536238,113,113,0,0,0
536246,345,345,0,0,0
536247,144,144,0,0,0
536249,282,282,0,0,0
536251,151,151,0,0,0
536264,353,353,0,0,0
536270,83,83,0,0,0
536271,310,310,0,0,0
536305,35,35,0,0,0
536312,259,259,0,0,0
536314,310,310,0,0,0
536322,299,299,0,0,0
536350,359,359,0,0,0
536357,310,310,0,0,0
536379,3,3,0,0,0
536404,251,251,0,0,0
536431,168,168,0,0,0
536437,252,252,0,0,0
536440,137,137,0,0,0
536444,353,353,0,0,0
536467,13,13,0,0,0
536478,255,255,0,0,0
536481,402,402,0,0,0
536484,299,299,0,0,0
536495,402,402,0,0,0
536505,313,313,0,0,0
536510,101,101,0,0,0
536529,137,137,0,0,0
536543,66,66,0,0,0
536545,313,313,0,0,0
536571,251,251,0,0,0
536577,255,255,0,0,0
536578,74,74,0,0,0
536579,102,102,0,0,0
536582,131,131,0,0,0
536594,151,151,0,0,0
536604,44,44,0,0,0
536612,353,353,0,0,0
536619,306,306,0,0,0
536629,70,70,0,0,0
536637,313,313,0,0,0
536642,281,281,0,0,0
536647,353,353,0,0,0
536654,163,163,0,0,0
536680,45,45,0,0,0
536703,102,102,0,0,0
536709,180,180,0,0,0
536712,102,102,0,0,0
536721,158,158,0,0,0
536777,75,75,0,0,0
536788,55,55,0,0,0
536808,282,282,0,0,0
536820,44,44,0,0,0
536861,69,69,0,0,0
536873,67,67,0,0,0
536877,120,120,0,0,0
536882,76,76,0,0,0
536888,315,315,0,0,0
536892,359,359,0,0,0
536912,232,232,0,0,0
536913,353,353,0,0,0
536918,71,71,0,0,0
536932,167,167,0,0,0
536941,402,402,0,0,0
536944,22,22,0,0,0
536946,232,232,0,0,0
536948,121,121,0,0,0
536950,251,251,0,0,0
536951,310,310,0,0,0
536954,151,151,0,0,0
536969,167,167,0,0,0
536977,255,255,0,0,0
536993,102,102,0,0,0
537000,198,198,0,0,0
537002,29,29,0,0,0
537013,184,184,0,0,0
537015,184,184,0,0,0
537022,402,402,0,0,0
537027,315,315,0,0,0
537033,232,232,0,0,0
537035,22,22,0,0,0
537043,15,15,0,0,0
537046,171,171,0,0,0
537057,7,7,0,0,0
537059,246,246,0,0,0
537081,83,83,0,0,0
537092,133,133,0,0,0
537093,121,121,0,0,0
537094,151,151,0,0,0
537099,131,131,0,0,0
537118,114,114,0,0,0
537131,232,232,0,0,0
537134,345,345,0,0,0
537135,76,76,0,0,0
537140,82,82,0,0,0
537149,13,13,0,0,0
537189,17,17,0,0,0
537192,76,76,0,0,0
537218,15,15,0,0,0
537223,5,5,0,0,0
537259,180,180,0,0,0
537272,11,11,0,0,0
537279,151,151,0,0,0
537295,281,281,0,0,0
537302,345,345,0,0,0
537311,14,14,0,0,0
537330,5,5,0,0,0
537332,143,143,0,0,0
537336,143,143,0,0,0
537338,259,259,0,0,0
537369,12,12,0,0,0
537371,114,114,0,0,0
537376,359,359,0,0,0
537391,121,121,0,0,0
537395,54,54,0,0,0
537397,137,137,0,0,0
537399,13,13,0,0,0
537408,152,152,0,0,0
537410,10,10,0,0,0
537413,359,359,0,0,0
537414,85,85,0,0,0
537418,402,402,0,0,0
537419,56,56,0,0,0
537423,402,402,0,0,0
537432,6,6,0,0,0
537433,259,259,0,0,0
537439,71,71,0,0,0
537441,137,137,0,0,0
537457,131,131,0,0,0
537464,359,359,0,0,0
537466,193,193,0,0,0
537515,133,133,0,0,0
537524,83,83,0,0,0
537533,299,299,0,0,0
537536,120,120,0,0,0
537543,29,29,0,0,0
537546,30,30,0,0,0
537556,310,310,0,0,0
537578,130,130,0,0,0
537596,34,34,0,0,0
537611,198,198,0,0,0
537619,50,50,0,0,0
537633,30,30,0,0,0
537634,259,259,0,0,0
537637,13,13,0,0,0
537675,306,306,0,0,0
537691,259,259,0,0,0
537692,57,57,0,0,0
537696,180,180,0,0,0
537700,15,15,0,0,0
537716,58,58,0,0,0
537731,359,359,0,0,0
537732,113,113,0,0,0
537764,171,171,0,0,0
537765,345,345,0,0,0
537770,144,144,0,0,0
537781,255,255,0,0,0
537794,299,299,0,0,0
537807,114,114,0,0,0
537809,359,359,0,0,0
537813,74,74,0,0,0
537822,353,353,0,0,0
537831,76,76,0,0,0
537833,282,282,0,0,0
537847,137,137,0,0,0
537874,252,252,0,0,0
537898,306,306,0,0,0
537899,10,10,0,0,0
537908,34,34,0,0,0
537912,299,299,0,0,0
537939,76,76,0,0,0
537976,193,193,0,0,0
537981,25,25,0,0,0
537990,121,121,0,0,0
538020,251,251,0,0,0
538041,22,22,0,0,0
538043,281,281,0,0,0
538048,7,7,0,0,0
538055,121,121,0,0,0
538073,180,180,0,0,0
538075,82,82,0,0,0
538080,40,40,0,0,0
538081,3,3,0,0,0
538094,9,9,0,0,0
538096,75,75,0,0,0
538134,102,102,0,0,0
538141,246,246,0,0,0
538148,359,359,0,0,0
538150,313,313,0,0,0
538161,184,184,0,0,0
538170,167,167,0,0,0
538184,97,97,0,0,0
538214,76,76,0,0,0
538215,359,359,0,0,0
538216,43,43,0,0,0
538225,345,345,0,0,0
538226,133,133,0,0,0
538237,25,25,0,0,0
538240,65,65,0,0,0
538248,24,24,0,0,0
538287,20,20,0,0,0
538294,353,353,0,0,0
538297,281,281,0,0,0
538322,55,55,0,0,0
538329,252,252,0,0,0
538332,251,251,0,0,0
538342,121,121,0,0,0
538349,252,252,0,0,0
538355,102,102,0,0,0
538369,137,137,0,0,0
538383,5,5,0,0,0
538386,345,345,0,0,0
538399,180,180,0,0,0
538433,246,246,0,0,0
538440,353,353,0,0,0
538449,345,345,0,0,0
538463,34,34,0,0,0
538474,45,45,0,0,0
538485,19,19,0,0,0
538508,6,6,0,0,0
538515,23,23,0,0,0
538525,24,24,0,0,0
538529,198,198,0,0,0
538532,131,131,0,0,0
538536,34,34,0,0,0
538541,8,8,0,0,0
538545,193,193,0,0,0
538552,281,281,0,0,0
538574,137,137,0,0,0
538582,151,151,0,0,0
538597,54,54,0,0,0
538636,69,69,0,0,0
538649,50,50,0,0,0
538661,16,16,0,0,0
538676,82,82,0,0,0
538677,353,353,0,0,0
538697,102,102,0,0,0
538700,121,121,0,0,0
538710,193,193,0,0,0
538721,114,114,0,0,0
538730,345,345,0,0,0
538741,133,133,0,0,0
538742,87,87,0,0,0
538750,282,282,0,0,0
538756,306,306,0,0,0
538762,137,137,0,0,0
538768,5,5,0,0,0
538774,282,282,0,0,0
538782,313,313,0,0,0
538786,359,359,0,0,0
538809,9,9,0,0,0
538830,102,102,0,0,0
538834,313,313,0,0,0
538852,6,6,0,0,0
538853,310,310,0,0,0
538855,281,281,0,0,0
538880,24,24,0,0,0
538895,66,66,0,0,0
538908,63,63,0,0,0
538912,232,232,0,0,0
538933,151,151,0,0,0
538947,310,310,0,0,0
538952,144,144,0,0,0
538980,11,11,0,0,0
538981,201,201,0,0,0
539003,180,180,0,0,0
539005,281,281,0,0,0
539014,2,2,0,0,0
539016,144,144,0,0,0
539017,143,143,0,0,0
539018,281,281,0,0,0
539026,310,310,0,0,0
539027,40,40,0,0,0
539032,259,259,0,0,0
539039,402,402,0,0,0
539042,345,345,0,0,0
539058,13,13,0,0,0
539087,74,74,0,0,0
539098,130,130,0,0,0
539111,167,167,0,0,0
539114,252,252,0,0,0
539122,251,251,0,0,0
539150,71,71,0,0,0
539214,144,144,0,0,0
539216,246,246,0,0,0
539218,232,232,0,0,0
539223,353,353,0,0,0
539224,151,151,0,0,0
539225,353,353,0,0,0
539256,69,69,0,0,0
539283,402,402,0,0,0
539292,144,144,0,0,0
539311,299,299,0,0,0
539312,402,402,0,0,0
539333,114,114,0,0,0
539374,54,54,0,0,0
539400,252,252,0,0,0
539437,201,201,0,0,0
539440,70,70,0,0,0
539449,114,114,0,0,0
539461,17,17,0,0,0
539479,29,29,0,0,0
539508,281,281,0,0,0
539524,74,74,0,0,0
539525,9,9,0,0,0
539545,56,56,0,0,0
539551,184,184,0,0,0
539563,83,83,0,0,0
539566,359,359,0,0,0
539573,128,128,0,0,0
539577,281,281,0,0,0
539582,54,54,0,0,0
539606,114,114,0,0,0
539622,402,402,0,0,0
539638,36,36,0,0,0
539641,201,201,0,0,0
539666,255,255,0,0,0
539708,55,55,0,0,0
539713,232,232,0,0,0
539731,252,252,0,0,0
539740,114,114,0,0,0
539742,29,29,0,0,0
539756,251,251,0,0,0
539760,345,345,0,0,0
539767,72,72,0,0,0
539769,22,22,0,0,0
539777,232,232,0,0,0
539779,180,180,0,0,0
539785,75,75,0,0,0
539792,306,306,0,0,0
539804,310,310,0,0,0
539847,19,19,0,0,0
539854,251,251,0,0,0
539880,133,133,0,0,0
539883,114,114,0,0,0
539888,101,101,0,0,0
539914,255,255,0,0,0
539932,313,313,0,0,0
539944,2,2,0,0,0
539947,5,5,0,0,0
539951,281,281,0,0,0
539952,353,353,0,0,0
539958,32,32,0,0,0
539964,14,14,0,0,0
539976,56,56,0,0,0
539981,56,56,0,0,0
539989,102,102,0,0,0
540015,87,87,0,0,0
540031,299,299,0,0,0
540047,74,74,0,0,0
540068,281,281,0,0,0
540074,114,114,0,0,0
540076,27,27,0,0,0
540130,151,151,0,0,0
540136,143,143,0,0,0
540141,50,50,0,0,0
540154,5,5,0,0,0
540158,255,255,0,0,0
540164,402,402,0,0,0
540191,359,359,0,0,0
540194,121,121,0,0,0
540208,143,143,0,0,0
540218,77,77,0,0,0
540231,193,193,0,0,0
540233,180,180,0,0,0
540234,6,6,0,0,0
540256,28,28,0,0,0
540266,36,36,0,0,0
540277,83,83,0,0,0
540288,41,41,0,0,0
540304,281,281,0,0,0
540314,58,58,0,0,0
540331,168,168,0,0,0
540332,22,22,0,0,0
540351,29,29,0,0,0
540357,66,66,0,0,0
540377,152,152,0,0,0
540380,121,121,0,0,0
540393,345,345,0,0,0
540399,282,282,0,0,0
540404,97,97,0,0,0
540406,306,306,0,0,0
540408,10,10,0,0,0
540415,282,282,0,0,0
540419,198,198,0,0,0
540422,152,152,0,0,0
540425,50,50,0,0,0
540426,77,77,0,0,0
540436,102,102,0,0,0
540444,20,20,0,0,0
540445,29,29,0,0,0
540448,255,255,0,0,0
540449,143,143,0,0,0
540464,121,121,0,0,0
540488,54,54,0,0,0
540505,137,137,0,0,0
540539,67,67,0,0,0
540550,76,76,0,0,0
540554,83,83,0,0,0
540566,232,232,0,0,0
540572,3,3,0,0,0
540573,180,180,0,0,0
540574,15,15,0,0,0
540581,20,20,0,0,0
540586,11,11,0,0,0
540589,63,63,0,0,0
540594,25,25,0,0,0
540601,94,94,0,0,0
540603,22,22,0,0,0
540620,198,198,0,0,0
540638,29,29,0,0,0
540661,201,201,0,0,0
540671,63,63,0,0,0
540691,281,281,0,0,0
540701,8,8,0,0,0
540708,70,70,0,0,0
540709,246,246,0,0,0
540722,12,12,0,0,0
540725,10,10,0,0,0
540727,19,19,0,0,0
540740,201,201,0,0,0
540752,15,15,0,0,0
540772,27,27,0,0,0
540799,345,345,0,0,0
540808,180,180,0,0,0
540815,259,259,0,0,0
540823,353,353,0,0,0
540829,171,171,0,0,0
540846,310,310,0,0,0
540851,232,232,0,0,0
540854,310,310,0,0,0
540857,282,282,0,0,0
540858,315,315,0,0,0
540870,402,402,0,0,0
540872,45,45,0,0,0
540907,74,74,0,0,0
540909,12,12,0,0,0
540911,83,83,0,0,0
540914,94,94,0,0,0
540928,97,97,0,0,0
540969,315,315,0,0,0
540998,40,40,0,0,0
541002,282,282,0,0,0
541008,251,251,0,0,0
541013,102,102,0,0,0
541019,251,251,0,0,0
541020,282,282,0,0,0
541035,402,402,0,0,0
541041,29,29,0,0,0
541047,281,281,0,0,0
541056,251,251,0,0,0
541057,63,63,0,0,0
541109,97,97,0,0,0
541124,281,281,0,0,0
541160,54,54,0,0,0
541162,29,29,0,0,0
541190,39,39,0,0,0
541214,193,193,0,0,0
541219,102,102,0,0,0
541227,402,402,0,0,0
541244,232,232,0,0,0
541245,103,103,0,0,0
541254,97,97,0,0,0
541257,8,8,0,0,0
541260,17,17,0,0,0
541285,29,29,0,0,0
541290,14,14,0,0,0
541293,113,113,0,0,0
541302,56,56,0,0,0
541305,359,359,0,0,0
541315,130,130,0,0,0
541318,184,184,0,0,0
541323,282,282,0,0,0
541328,152,152,0,0,0
541331,102,102,0,0,0
541339,232,232,0,0,0
541341,71,71,0,0,0
541352,252,252,0,0,0
541365,299,299,0,0,0
541366,402,402,0,0,0
541370,45,45,0,0,0
541386,17,17,0,0,0
541390,137,137,0,0,0
541395,251,251,0,0,0
541407,313,313,0,0,0
541420,252,252,0,0,0
541430,353,353,0,0,0
541435,201,201,0,0,0
541437,70,70,0,0,0
541447,306,306,0,0,0
541462,353,353,0,0,0
541466,76,76,0,0,0
541520,171,171,0,0,0
541526,113,113,0,0,0
541546,167,167,0,0,0
541568,255,255,0,0,0
541569,259,259,0,0,0
541591,103,103,0,0,0
541595,310,310,0,0,0
541596,259,259,0,0,0
541601,402,402,0,0,0
541626,32,32,0,0,0
541627,2,2,0,0,0
541630,315,315,0,0,0
541642,158,158,0,0,0
541645,133,133,0,0,0
541647,94,94,0,0,0
541650,158,158,0,0,0
541654,121,121,0,0,0
541659,282,282,0,0,0
541665,251,251,0,0,0
541668,353,353,0,0,0
541674,315,315,0,0,0
541675,39,39,0,0,0
541738,40,40,0,0,0
541771,121,121,0,0,0
541781,299,299,0,0,0
541782,144,144,0,0,0
541783,5,5,0,0,0
541790,2,2,0,0,0
541798,137,137,0,0,0
541812,152,152,0,0,0
541828,66,66,0,0,0
541842,158,158,0,0,0
541844,130,130,0,0,0
541858,19,19,0,0,0
541859,168,168,0,0,0
541866,43,43,0,0,0
541874,402,402,0,0,0
541883,50,50,0,0,0
541887,152,152,0,0,0
541896,12,12,0,0,0
541900,180,180,0,0,0
541902,83,83,0,0,0
541907,12,12,0,0,0
541914,252,252,0,0,0
541923,128,128,0,0,0
541928,345,345,0,0,0
541976,102,102,0,0,0
541994,167,167,0,0,0
541999,137,137,0,0,0
542010,252,252,0,0,0
542022,255,255,0,0,0
542064,359,359,0,0,0
542072,163,163,0,0,0
542074,246,246,0,0,0
542077,313,313,0,0,0
542083,76,76,0,0,0
542087,299,299,0,0,0
542099,151,151,0,0,0
542106,246,246,0,0,0
542136,246,246,0,0,0
542138,103,103,0,0,0
542143,167,167,0,0,0
542157,77,77,0,0,0
542197,306,306,0,0,0
542221,66,66,0,0,0
542231,102,102,0,0,0
542232,102,102,0,0,0
542243,201,201,0,0,0
542263,184,184,0,0,0
542264,180,180,0,0,0
542322,102,102,0,0,0
542324,7,7,0,0,0
542338,184,184,0,0,0
542343,137,137,0,0,0
542347,50,50,0,0,0
542359,75,75,0,0,0
542360,18,18,0,0,0
542378,101,101,0,0,0
542384,310,310,0,0,0
542406,299,299,0,0,0
542425,345,345,0,0,0
542450,299,299,0,0,0
542459,299,299,0,0,0
542460,85,85,0,0,0
542475,9,9,0,0,0
542480,184,184,0,0,0
542482,345,345,0,0,0
542490,44,44,0,0,0
542500,43,43,0,0,0
542501,130,130,0,0,0
542509,83,83,0,0,0
542519,121,121,0,0,0
542525,310,310,0,0,0
542536,137,137,0,0,0
542573,359,359,0,0,0
542589,299,299,0,0,0
542590,19,19,0,0,0
542620,4,4,0,0,0
542627,50,50,0,0,0
542629,130,130,0,0,0
542647,25,25,0,0,0
542652,44,44,0,0,0
542660,168,168,0,0,0
542681,16,16,0,0,0
542685,144,144,0,0,0
542688,67,67,0,0,0
542736,402,402,0,0,0
542752,345,345,0,0,0
542755,3,3,0,0,0
542763,102,102,0,0,0
542767,56,56,0,0,0
542781,83,83,0,0,0
542790,10,10,0,0,0
542814,232,232,0,0,0
542819,128,128,0,0,0
542827,17,17,0,0,0
542848,114,114,0,0,0
542873,8,8,0,0,0
542875,167,167,0,0,0
542878,345,345,0,0,0
542889,246,246,0,0,0
542892,57,57,0,0,0
542939,246,246,0,0,0
542963,34,34,0,0,0
542964,69,69,0,0,0
542975,113,113,0,0,0
542976,24,24,0,0,0
542982,163,163,0,0,0
543002,56,56,0,0,0
543010,144,144,0,0,0
543016,201,201,0,0,0
543047,16,16,0,0,0
543066,130,130,0,0,0
543073,313,313,0,0,0
543074,18,18,0,0,0
543078,299,299,0,0,0
543082,171,171,0,0,0
543085,133,133,0,0,0
543087,76,76,0,0,0
543095,70,70,0,0,0
543100,315,315,0,0,0
543107,50,50,0,0,0
543119,259,259,0,0,0
543128,17,17,0,0,0
543137,402,402,0,0,0
543146,201,201,0,0,0
543151,18,18,0,0,0
543155,16,16,0,0,0
543158,43,43,0,0,0
543161,259,259,0,0,0
543163,402,402,0,0,0
543175,313,313,0,0,0
543197,359,359,0,0,0
543199,17,17,0,0,0
543200,359,359,0,0,0
543203,39,39,0,0,0
543214,310,310,0,0,0
543219,137,137,0,0,0
543238,299,299,0,0,0
543239,6,6,0,0,0
543252,152,152,0,0,0
543280,3,3,0,0,0
543300,43,43,0,0,0
543321,255,255,0,0,0
543326,163,163,0,0,0
543337,402,402,0,0,0
543340,133,133,0,0,0
543364,315,315,0,0,0
543365,259,259,0,0,0
543372,10,10,0,0,0
543396,359,359,0,0,0
543405,251,251,0,0,0
543426,114,114,0,0,0
543427,35,35,0,0,0
543433,121,121,0,0,0
543435,69,69,0,0,0
543441,97,97,0,0,0
543454,255,255,0,0,0
543467,255,255,0,0,0
543475,246,246,0,0,0
543483,180,180,0,0,0
543503,232,232,0,0,0
543506,402,402,0,0,0
543516,121,121,0,0,0
543526,128,128,0,0,0
543530,359,359,0,0,0
543532,158,158,0,0,0
543550,345,345,0,0,0
543567,128,128,0,0,0
543571,299,299,0,0,0
543583,72,72,0,0,0
543603,255,255,0,0,0
543612,20,20,0,0,0
543618,281,281,0,0,0
543648,101,101,0,0,0
543651,251,251,0,0,0
543654,353,353,0,0,0
543658,87,87,0,0,0
543673,232,232,0,0,0
543675,76,76,0,0,0
543678,121,121,0,0,0
543691,259,259,0,0,0
543694,121,121,0,0,0
543708,102,102,0,0,0
543715,4,4,0,0,0
543742,402,402,0,0,0
543754,251,251,0,0,0
543762,7,7,0,0,0
543791,232,232,0,0,0
543798,255,255,0,0,0
543806,198,198,0,0,0
543820,171,171,0,0,0
543830,345,345,0,0,0
543853,82,82,0,0,0
543864,82,82,0,0,0
543868,201,201,0,0,0
543875,94,94,0,0,0
543912,353,353,0,0,0
543929,299,299,0,0,0
543930,163,163,0,0,0
543966,281,281,0,0,0
543967,114,114,0,0,0
543968,359,359,0,0,0
543980,353,353,0,0,0
544001,402,402,0,0,0
544002,201,201,0,0,0
544004,345,345,0,0,0
544028,22,22,0,0,0
544031,113,113,0,0,0
544033,252,252,0,0,0
544041,313,313,0,0,0
544080,255,255,0,0,0
544082,359,359,0,0,0
544088,315,315,0,0,0
544100,402,402,0,0,0
544110,14,14,0,0,0
544120,29,29,0,0,0
544140,137,137,0,0,0
544176,184,184,0,0,0
544182,5,5,0,0,0
544184,252,252,0,0,0
544221,255,255,0,0,0
544227,121,121,0,0,0
544233,152,152,0,0,0
544246,281,281,0,0,0
544268,252,252,0,0,0
544280,66,66,0,0,0
544291,71,71,0,0,0
544300,255,255,0,0,0
544305,232,232,0,0,0
544326,12,12,0,0,0
544375,167,167,0,0,0
544392,402,402,0,0,0
544396,137,137,0,0,0
544405,75,75,0,0,0
544409,63,63,0,0,0
544419,315,315,0,0,0
544438,121,121,0,0,0
544441,29,29,0,0,0
544447,251,251,0,0,0
544448,259,259,0,0,0
544451,137,137,0,0,0
544461,66,66,0,0,0
544471,22,22,0,0,0
544482,306,306,0,0,0
544520,144,144,0,0,0
544526,15,15,0,0,0
544546,102,102,0,0,0
544550,232,232,0,0,0
544563,131,131,0,0,0
544564,137,137,0,0,0
544571,152,152,0,0,0
544574,35,35,0,0,0
544579,143,143,0,0,0
544607,20,20,0,0,0
544624,121,121,0,0,0
544627,252,252,0,0,0
544637,168,168,0,0,0
544639,152,152,0,0,0
544648,259,259,0,0,0
544649,313,313,0,0,0
544651,101,101,0,0,0
544653,345,345,0,0,0
544711,1,1,0,0,0
544721,168,168,0,0,0
544723,101,101,0,0,0
544732,102,102,0,0,0
544755,313,313,0,0,0
544784,76,76,0,0,0
544785,353,353,0,0,0
544788,251,251,0,0,0
544802,63,63,0,0,0
544825,120,120,0,0,0
544852,121,121,0,0,0
544855,29,29,0,0,0
544857,259,259,0,0,0
544882,128,128,0,0,0
544891,359,359,0,0,0
544917,252,252,0,0,0
544923,201,201,0,0,0
544927,72,72,0,0,0
544937,25,25,0,0,0
544940,315,315,0,0,0
544972,310,310,0,0,0
544980,50,50,0,0,0
545004,7,7,0,0,0
545031,55,55,0,0,0
545038,315,315,0,0,0
545042,345,345,0,0,0
545046,32,32,0,0,0
545053,7,7,0,0,0
545060,113,113,0,0,0
545071,24,24,0,0,0
545076,130,130,0,0,0
545078,4,4,0,0,0
545080,19,19,0,0,0
545082,259,259,0,0,0
545085,306,306,0,0,0
545098,402,402,0,0,0
545099,114,114,0,0,0
545113,76,76,0,0,0
545126,120,120,0,0,0
545158,402,402,0,0,0
545198,193,193,0,0,0
545218,35,35,0,0,0
545221,246,246,0,0,0
545226,232,232,0,0,0
545241,281,281,0,0,0
545243,299,299,0,0,0
545257,14,14,0,0,0
545263,50,50,0,0,0
545272,359,359,0,0,0
545284,128,128,0,0,0
545300,402,402,0,0,0
545317,65,65,0,0,0
545338,16,16,0,0,0
545341,114,114,0,0,0
545342,306,306,0,0,0
545378,345,345,0,0,0
545385,180,180,0,0,0
545398,3,3,0,0,0
545402,282,282,0,0,0
545414,310,310,0,0,0
545416,120,120,0,0,0
545446,114,114,0,0,0
545452,168,168,0,0,0
545458,306,306,0,0,0
545462,282,282,0,0,0
545464,345,345,0,0,0
545474,402,402,0,0,0
545508,87,87,0,0,0
545513,22,22,0,0,0
545514,251,251,0,0,0
545540,345,345,0,0,0
545563,232,232,0,0,0
545564,101,101,0,0,0
545584,252,252,0,0,0
545588,130,130,0,0,0
545596,180,180,0,0,0
545604,102,102,0,0,0
545607,133,133,0,0,0
545610,17,17,0,0,0
545624,102,102,0,0,0
545631,252,252,0,0,0
545634,402,402,0,0,0
545640,310,310,0,0,0
545647,12,12,0,0,0
545652,259,259,0,0,0
545659,310,310,0,0,0
545702,281,281,0,0,0
545714,306,306,0,0,0
545721,252,252,0,0,0
545762,345,345,0,0,0
545777,36,36,0,0,0
545784,75,75,0,0,0
545789,121,121,0,0,0
545790,144,144,0,0,0
545793,193,193,0,0,0
545801,66,66,0,0,0
545810,299,299,0,0,0
545813,313,313,0,0,0
545822,87,87,0,0,0
545826,345,345,0,0,0
545840,282,282,0,0,0
545847,131,131,0,0,0
545869,131,131,0,0,0
545875,76,76,0,0,0
545886,137,137,0,0,0
545898,102,102,0,0,0
545905,232,232,0,0,0
545908,87,87,0,0,0
545910,71,71,0,0,0
545924,252,252,0,0,0
545927,36,36,0,0,0
545934,402,402,0,0,0
545943,10,10,0,0,0
545944,144,144,0,0,0
545967,259,259,0,0,0
545993,232,232,0,0,0
545999,58,58,0,0,0
546002,168,168,0,0,0
546015,1,1,0,0,0
546020,299,299,0,0,0
546057,3,3,0,0,0
546103,359,359,0,0,0
546151,121,121,0,0,0
546158,251,251,0,0,0
546169,171,171,0,0,0
546190,143,143,0,0,0
546220,251,251,0,0,0
546249,310,310,0,0,0
546262,402,402,0,0,0
546279,201,201,0,0,0
546280,35,35,0,0,0
546304,345,345,0,0,0
546305,121,121,0,0,0
546340,35,35,0,0,0
546341,402,402,0,0,0
546348,152,152,0,0,0
546358,70,70,0,0,0
546374,251,251,0,0,0
546391,198,198,0,0,0
546398,25,25,0,0,0
546417,9,9,0,0,0
546443,16,16,0,0,0
546448,184,184,0,0,0
546458,66,66,0,0,0
546468,158,158,0,0,0
546473,282,282,0,0,0
546476,299,299,0,0,0
546481,345,345,0,0,0
546502,101,101,0,0,0
546503,402,402,0,0,0
546508,402,402,0,0,0
546524,121,121,0,0,0
546542,353,353,0,0,0
546563,36,36,0,0,0
546593,281,281,0,0,0
546594,152,152,0,0,0
546598,7,7,0,0,0
546600,310,310,0,0,0
546619,184,184,0,0,0
546622,180,180,0,0,0
546623,133,133,0,0,0
546644,282,282,0,0,0
546656,402,402,0,0,0
546667,168,168,0,0,0
546671,24,24,0,0,0
546688,315,315,0,0,0
546701,57,57,0,0,0
546727,353,353,0,0,0
546733,69,69,0,0,0
546739,18,18,0,0,0
546742,137,137,0,0,0
546756,306,306,0,0,0
546758,168,168,0,0,0
546789,24,24,0,0,0
546795,36,36,0,0,0
546803,75,75,0,0,0
546812,232,232,0,0,0
546821,113,113,0,0,0
546824,158,158,0,0,0
546835,171,171,0,0,0
546860,114,114,0,0,0
546867,299,299,0,0,0
546884,163,163,0,0,0
546887,71,71,0,0,0
546891,34,34,0,0,0
546895,201,201,0,0,0
546906,133,133,0,0,0
546907,76,76,0,0,0
546938,402,402,0,0,0
546951,102,102,0,0,0
546961,12,12,0,0,0
546971,69,69,0,0,0
546973,2,2,0,0,0
546987,259,259,0,0,0
546998,315,315,0,0,0
547004,2,2,0,0,0
547005,168,168,0,0,0
547011,345,345,0,0,0
547012,282,282,0,0,0
547033,232,232,0,0,0
547035,359,359,0,0,0
547041,313,313,0,0,0
547048,133,133,0,0,0
547051,246,246,0,0,0
547057,180,180,0,0,0
547059,94,94,0,0,0
547065,184,184,0,0,0
547083,121,121,0,0,0
547086,85,85,0,0,0
547088,193,193,0,0,0
547090,87,87,0,0,0
547105,359,359,0,0,0
547107,131,131,0,0,0
547125,10,10,0,0,0
547131,299,299,0,0,0
547137,198,198,0,0,0
547141,27,27,0,0,0
547142,313,313,0,0,0
547145,313,313,0,0,0
547147,19,19,0,0,0
547170,255,255,0,0,0
547174,201,201,0,0,0
547204,29,29,0,0,0
547215,94,94,0,0,0
547219,103,103,0,0,0
547228,14,14,0,0,0
547241,252,252,0,0,0
547246,171,171,0,0,0
547254,72,72,0,0,0
547260,281,281,0,0,0
547262,12,12,0,0,0
547279,315,315,0,0,0
547280,29,29,0,0,0
547282,121,121,0,0,0
547286,2,2,0,0,0
547287,359,359,0,0,0
547299,402,402,0,0,0
547303,24,24,0,0,0
547310,198,198,0,0,0
547348,34,34,0,0,0
547357,168,168,0,0,0
547358,299,299,0,0,0
547365,359,359,0,0,0
547368,180,180,0,0,0
547372,402,402,0,0,0
547395,70,70,0,0,0
547402,310,310,0,0,0
547404,353,353,0,0,0
547409,8,8,0,0,0
547414,251,251,0,0,0
547416,281,281,0,0,0
547422,71,71,0,0,0
547425,102,102,0,0,0
547440,201,201,0,0,0
547442,310,310,0,0,0
547452,30,30,0,0,0
547459,5,5,0,0,0
547471,121,121,0,0,0
547481,251,251,0,0,0
547484,17,17,0,0,0
547486,246,246,0,0,0
547557,144,144,0,0,0
547576,152,152,0,0,0
547581,299,299,0,0,0
547587,184,184,0,0,0
547595,353,353,0,0,0
547606,101,101,0,0,0
547609,19,19,0,0,0
547616,19,19,0,0,0
547625,56,56,0,0,0
547633,55,55,0,0,0
547654,32,32,0,0,0
547658,29,29,0,0,0
547679,310,310,0,0,0
547700,198,198,0,0,0
547704,74,74,0,0,0
547712,121,121,0,0,0
547718,259,259,0,0,0
547741,11,11,0,0,0
547748,353,353,0,0,0
547751,180,180,0,0,0
547755,251,251,0,0,0
547791,345,345,0,0,0
547812,402,402,0,0,0
547817,158,158,0,0,0
547819,97,97,0,0,0
547825,281,281,0,0,0
547835,15,15,0,0,0
547846,167,167,0,0,0
547858,102,102,0,0,0
547863,345,345,0,0,0
547898,315,315,0,0,0
547908,103,103,0,0,0
547920,310,310,0,0,0
547921,167,167,0,0,0
547926,313,313,0,0,0
547927,25,25,0,0,0
547935,353,353,0,0,0
547943,193,193,0,0,0
547944,313,313,0,0,0
547947,54,54,0,0,0
547978,18,18,0,0,0
547985,20,20,0,0,0
547988,168,168,0,0,0
548009,34,34,0,0,0
548021,4,4,0,0,0
548028,353,353,0,0,0
548047,310,310,0,0,0
548055,359,359,0,0,0
548059,128,128,0,0,0
548065,306,306,0,0,0
548066,8,8,0,0,0
548067,193,193,0,0,0
548073,345,345,0,0,0
548102,246,246,0,0,0
548117,56,56,0,0,0
548119,313,313,0,0,0
548134,158,158,0,0,0
548146,65,65,0,0,0
548169,14,14,0,0,0
548173,36,36,0,0,0
548206,114,114,0,0,0
548217,255,255,0,0,0
548222,3,3,0,0,0
548241,6,6,0,0,0
548255,137,137,0,0,0
548269,11,11,0,0,0
548273,252,252,0,0,0
548288,36,36,0,0,0
548307,299,299,0,0,0
548308,74,74,0,0,0
548321,282,282,0,0,0
548328,151,151,0,0,0
548336,180,180,0,0,0
548345,130,130,0,0,0
548348,130,130,0,0,0
548354,143,143,0,0,0
548355,8,8,0,0,0
548362,29,29,0,0,0
548387,201,201,0,0,0
548394,359,359,0,0,0
548427,114,114,0,0,0
548434,353,353,0,0,0
548440,171,171,0,0,0
548445,67,67,0,0,0
548447,102,102,0,0,0
548452,83,83,0,0,0
548476,30,30,0,0,0
548478,121,121,0,0,0
548481,19,19,0,0,0
548482,29,29,0,0,0
548491,359,359,0,0,0
548500,158,158,0,0,0
548523,282,282,0,0,0
548524,128,128,0,0,0
548543,102,102,0,0,0
548545,201,201,0,0,0
548550,144,144,0,0,0
548559,152,152,0,0,0
548566,143,143,0,0,0
548575,180,180,0,0,0
548576,25,25,0,0,0
548588,82,82,0,0,0
548600,97,97,0,0,0
548602,168,168,0,0,0
548605,345,345,0,0,0
548610,5,5,0,0,0
548620,255,255,0,0,0
548631,315,315,0,0,0
548634,353,353,0,0,0
548650,114,114,0,0,0
548665,144,144,0,0,0
548688,315,315,0,0,0
548700,56,56,0,0,0
548709,113,113,0,0,0
548722,137,137,0,0,0
548729,201,201,0,0,0
548746,402,402,0,0,0
548753,251,251,0,0,0
548756,43,43,0,0,0
548765,353,353,0,0,0
548794,2,2,0,0,0
548802,85,85,0,0,0
548813,306,306,0,0,0
548814,20,20,0,0,0
548829,252,252,0,0,0
548832,121,121,0,0,0
548844,232,232,0,0,0
548851,306,306,0,0,0
548862,19,19,0,0,0
548869,22,22,0,0,0
548885,402,402,0,0,0
548888,255,255,0,0,0
548890,137,137,0,0,0
548891,102,102,0,0,0
548893,353,353,0,0,0
548901,12,12,0,0,0
548911,27,27,0,0,0
548949,201,201,0,0,0
548954,24,24,0,0,0
548990,402,402,0,0,0
548995,232,232,0,0,0
549009,281,281,0,0,0
549013,310,310,0,0,0
549036,198,198,0,0,0
549041,30,30,0,0,0
549046,299,299,0,0,0
549050,8,8,0,0,0
549068,12,12,0,0,0
549073,163,163,0,0,0
549075,252,252,0,0,0
549102,282,282,0,0,0
549123,5,5,0,0,0
549127,74,74,0,0,0
549129,246,246,0,0,0
549135,50,50,0,0,0
549144,113,113,0,0,0
549158,69,69,0,0,0
549165,299,299,0,0,0
549170,36,36,0,0,0
549180,299,299,0,0,0
549188,259,259,0,0,0
549206,20,20,0,0,0
549222,114,114,0,0,0
549246,56,56,0,0,0
549254,306,306,0,0,0
549279,310,310,0,0,0
549304,281,281,0,0,0
549309,180,180,0,0,0
549323,133,133,0,0,0
549324,252,252,0,0,0
549349,29,29,0,0,0
549359,313,313,0,0,0
549379,67,67,0,0,0
549384,102,102,0,0,0
549389,8,8,0,0,0
549398,72,72,0,0,0
549404,255,255,0,0,0
549405,20,20,0,0,0
549408,402,402,0,0,0
549423,9,9,0,0,0
549445,137,137,0,0,0
549446,193,193,0,0,0
549449,359,359,0,0,0
549472,252,252,0,0,0
549477,282,282,0,0,0
549487,120,120,0,0,0
549492,24,24,0,0,0
549503,306,306,0,0,0
549505,151,151,0,0,0
549526,201,201,0,0,0
549529,74,74,0,0,0
549533,76,76,0,0,0
549534,7,7,0,0,0
549536,353,353,0,0,0
549542,54,54,0,0,0
549548,94,94,0,0,0
549551,402,402,0,0,0
549555,4,4,0,0,0
549571,402,402,0,0,0
549590,259,259,0,0,0
549591,43,43,0,0,0
549619,137,137,0,0,0
549635,282,282,0,0,0
549642,20,20,0,0,0
549655,255,255,0,0,0
549656,299,299,0,0,0
549664,402,402,0,0,0
549688,7,7,0,0,0
549690,143,143,0,0,0
549694,82,82,0,0,0
549746,43,43,0,0,0
549747,310,310,0,0,0
549761,27,27,0,0,0
549789,17,17,0,0,0
549804,306,306,0,0,0
549807,8,8,0,0,0
549819,402,402,0,0,0
549820,50,50,0,0,0
549823,65,65,0,0,0
549834,70,70,0,0,0
549843,131,131,0,0,0
549845,158,158,0,0,0
549893,87,87,0,0,0
549908,306,306,0,0,0
549914,310,310,0,0,0
549921,17,17,0,0,0
549927,359,359,0,0,0
549932,87,87,0,0,0
549940,94,94,0,0,0
549953,57,57,0,0,0
549969,306,306,0,0,0
549974,306,306,0,0,0
549988,25,25,0,0,0
550000,41,41,0,0,0
550014,72,72,0,0,0
550032,128,128,0,0,0
550037,85,85,0,0,0
550050,72,72,0,0,0
550059,97,97,0,0,0
550067,20,20,0,0,0
550090,167,167,0,0,0
550102,74,74,0,0,0
550143,198,198,0,0,0
550160,315,315,0,0,0
550165,32,32,0,0,0
550186,167,167,0,0,0
550192,171,171,0,0,0
550213,152,152,0,0,0
550215,131,131,0,0,0
550216,35,35,0,0,0
550224,8,8,0,0,0
550226,36,36,0,0,0
550239,143,143,0,0,0
550243,41,41,0,0,0
550262,167,167,0,0,0
550267,40,40,0,0,0
550284,137,137,0,0,0
550286,255,255,0,0,0
550288,281,281,0,0,0
550296,359,359,0,0,0
550305,45,45,0,0,0
550317,14,14,0,0,0
550325,315,315,0,0,0
550340,193,193,0,0,0
550346,402,402,0,0,0
550359,17,17,0,0,0
550373,133,133,0,0,0
550386,282,282,0,0,0
550398,246,246,0,0,0
550399,158,158,0,0,0
550400,65,65,0,0,0
550415,168,168,0,0,0
550427,359,359,0,0,0
550430,133,133,0,0,0
550431,9,9,0,0,0
550432,34,34,0,0,0
550451,168,168,0,0,0
550456,50,50,0,0,0
550459,67,67,0,0,0
550469,102,102,0,0,0
550474,232,232,0,0,0
550493,8,8,0,0,0
550510,102,102,0,0,0
550511,315,315,0,0,0
550537,306,306,0,0,0
550542,121,121,0,0,0
550543,94,94,0,0,0
550558,130,130,0,0,0
550566,313,313,0,0,0
550567,402,402,0,0,0
550569,128,128,0,0,0
550573,359,359,0,0,0
550581,44,44,0,0,0
550584,232,232,0,0,0
550585,345,345,0,0,0
550586,353,353,0,0,0
550591,74,74,0,0,0
550605,102,102,0,0,0
550629,198,198,0,0,0
550636,71,71,0,0,0
550647,2,2,0,0,0
550649,299,299,0,0,0
550675,143,143,0,0,0
550677,359,359,0,0,0
550688,1,1,0,0,0
550694,310,310,0,0,0
550698,282,282,0,0,0
550699,75,75,0,0,0
550721,130,130,0,0,0
550727,34,34,0,0,0
550728,12,12,0,0,0
550745,232,232,0,0,0
550757,2,2,0,0,0
550768,198,198,0,0,0
550792,299,299,0,0,0
550810,87,87,0,0,0
550822,131,131,0,0,0
550845,70,70,0,0,0
550848,359,359,0,0,0
550868,133,133,0,0,0
550871,315,315,0,0,0
550891,158,158,0,0,0
550903,74,74,0,0,0
550917,313,313,0,0,0
550927,310,310,0,0,0
550930,345,345,0,0,0
550931,246,246,0,0,0
550964,12,12,0,0,0
550965,45,45,0,0,0
550967,198,198,0,0,0
550968,7,7,0,0,0
550981,94,94,0,0,0
550992,55,55,0,0,0
551004,121,121,0,0,0
551013,252,252,0,0,0
551030,345,345,0,0,0
551058,34,34,0,0,0
551080,85,85,0,0,0
551112,282,282,0,0,0
551137,255,255,0,0,0
551144,345,345,0,0,0
551149,4,4,0,0,0
551151,315,315,0,0,0
551163,299,299,0,0,0
551164,402,402,0,0,0
551178,54,54,0,0,0
551180,144,144,0,0,0
551202,77,77,0,0,0
551210,36,36,0,0,0
551227,66,66,0,0,0
551256,359,359,0,0,0
551264,97,97,0,0,0
551277,114,114,0,0,0
551286,353,353,0,0,0
551288,310,310,0,0,0
551300,315,315,0,0,0
551301,102,102,0,0,0
551302,97,97,0,0,0
551305,114,114,0,0,0
551343,251,251,0,0,0
551345,87,87,0,0,0
551353,299,299,0,0,0
551354,29,29,0,0,0
551371,252,252,0,0,0
551373,39,39,0,0,0
551380,402,402,0,0,0
551387,74,74,0,0,0
551390,168,168,0,0,0
551407,281,281,0,0,0
551426,94,94,0,0,0
551449,74,74,0,0,0
551488,152,152,0,0,0
551489,246,246,0,0,0
551490,353,353,0,0,0
551495,251,251,0,0,0
551505,315,315,0,0,0
551508,310,310,0,0,0
551512,315,315,0,0,0
551517,76,76,0,0,0
551526,251,251,0,0,0
551556,310,310,0,0,0
551558,137,137,0,0,0
551563,102,102,0,0,0
551577,315,315,0,0,0
551579,282,282,0,0,0
551581,201,201,0,0,0
551589,102,102,0,0,0
551615,198,198,0,0,0
551616,29,29,0,0,0
551618,133,133,0,0,0
551621,114,114,0,0,0
551625,102,102,0,0,0
551644,193,193,0,0,0
551673,102,102,0,0,0
551676,402,402,0,0,0
551678,168,168,0,0,0
551682,259,259,0,0,0
551685,310,310,0,0,0
551699,313,313,0,0,0
551705,282,282,0,0,0
551707,255,255,0,0,0
551719,255,255,0,0,0
551721,9,9,0,0,0
551722,281,281,0,0,0
551726,282,282,0,0,0
551733,315,315,0,0,0
551734,130,130,0,0,0
551738,43,43,0,0,0
551772,76,76,0,0,0
551786,75,75,0,0,0
551792,299,299,0,0,0
551795,66,66,0,0,0
551797,282,282,0,0,0
551809,144,144,0,0,0
551813,171,171,0,0,0
551835,345,345,0,0,0
551844,198,198,0,0,0
551875,313,313,0,0,0
551878,313,313,0,0,0
551906,158,158,0,0,0
551908,77,77,0,0,0
551910,21,21,0,0,0
551916,24,24,0,0,0
551924,168,168,0,0,0
551928,65,65,0,0,0
551931,114,114,0,0,0
551956,345,345,0,0,0
551961,299,299,0,0,0
551966,310,310,0,0,0
551975,74,74,0,0,0
551979,85,85,0,0,0
551983,72,72,0,0,0
551993,76,76,0,0,0
551994,121,121,0,0,0
552000,152,152,0,0,0
552003,5,5,0,0,0
552018,359,359,0,0,0
552029,168,168,0,0,0
552047,193,193,0,0,0
552061,306,306,0,0,0
552065,232,232,0,0,0
552074,180,180,0,0,0
552076,75,75,0,0,0
552080,315,315,0,0,0
552084,198,198,0,0,0
552095,313,313,0,0,0
552110,306,306,0,0,0
552117,259,259,0,0,0
552151,180,180,0,0,0
552163,133,133,0,0,0
552173,315,315,0,0,0
552182,144,144,0,0,0
552191,168,168,0,0,0
552211,171,171,0,0,0
552212,144,144,0,0,0
552215,87,87,0,0,0
552225,151,151,0,0,0
552231,57,57,0,0,0
552233,251,251,0,0,0
552238,102,102,0,0,0
552260,255,255,0,0,0
552279,299,299,0,0,0
552280,345,345,0,0,0
552287,144,144,0,0,0
552289,167,167,0,0,0
552296,232,232,0,0,0
552306,144,144,0,0,0
552321,299,299,0,0,0
552352,251,251,0,0,0
552376,353,353,0,0,0
552378,45,45,0,0,0
552382,128,128,0,0,0
552418,201,201,0,0,0
552424,15,15,0,0,0
552426,24,24,0,0,0
552447,167,167,0,0,0
552470,345,345,0,0,0
552477,359,359,0,0,0
552488,97,97,0,0,0
552495,70,70,0,0,0
552526,158,158,0,0,0
552534,168,168,0,0,0
552543,151,151,0,0,0
552550,25,25,0,0,0
552558,45,45,0,0,0
552563,345,345,0,0,0
552580,76,76,0,0,0
552584,16,16,0,0,0
552611,158,158,0,0,0
552612,4,4,0,0,0
552613,133,133,0,0,0
552625,359,359,0,0,0
552629,121,121,0,0,0
552645,180,180,0,0,0
552646,74,74,0,0,0
552647,359,359,0,0,0
552659,8,8,0,0,0
552666,184,184,0,0,0
552672,193,193,0,0,0
552678,35,35,0,0,0
552682,130,130,0,0,0
552689,131,131,0,0,0
552694,151,151,0,0,0
552711,251,251,0,0,0
552712,359,359,0,0,0
552732,171,171,0,0,0
552735,252,252,0,0,0
552742,345,345,0,0,0
552775,251,251,0,0,0
552779,255,255,0,0,0
552813,55,55,0,0,0
552814,171,171,0,0,0
552820,345,345,0,0,0
552835,41,41,0,0,0
552843,359,359,0,0,0
552849,168,168,0,0,0
552850,259,259,0,0,0
552874,133,133,0,0,0
552878,36,36,0,0,0
552883,345,345,0,0,0
552888,299,299,0,0,0
552909,171,171,0,0,0
552920,180,180,0,0,0
552921,402,402,0,0,0
552928,72,72,0,0,0
552935,130,130,0,0,0
552976,158,158,0,0,0
552990,180,180,0,0,0
553030,5,5,0,0,0
553040,252,252,0,0,0
553042,180,180,0,0,0
553058,50,50,0,0,0
553060,56,56,0,0,0
553064,180,180,0,0,0
553095,3,3,0,0,0
553099,63,63,0,0,0
553102,102,102,0,0,0
553109,345,345,0,0,0
553115,259,259,0,0,0
553131,43,43,0,0,0
553134,16,16,0,0,0
553150,66,66,0,0,0
553173,101,101,0,0,0
553185,63,63,0,0,0
553187,167,167,0,0,0
553206,184,184,0,0,0
553219,353,353,0,0,0
553230,85,85,0,0,0
553237,114,114,0,0,0
553240,306,306,0,0,0
553248,29,29,0,0,0
553257,121,121,0,0,0
553258,282,282,0,0,0
553267,353,353,0,0,0
553273,353,353,0,0,0
553275,299,299,0,0,0
553285,252,252,0,0,0
553291,121,121,0,0,0
553296,171,171,0,0,0
553299,66,66,0,0,0
553324,313,313,0,0,0
553332,87,87,0,0,0
553362,201,201,0,0,0
553374,94,94,0,0,0
553381,255,255,0,0,0
553388,35,35,0,0,0
553397,315,315,0,0,0
553405,180,180,0,0,0
553418,232,232,0,0,0
553431,252,252,0,0,0
553434,313,313,0,0,0
553450,27,27,0,0,0
553451,27,27,0,0,0
553453,163,163,0,0,0
553466,201,201,0,0,0
553478,201,201,0,0,0
553514,232,232,0,0,0
553550,281,281,0,0,0
553585,25,25,0,0,0
553591,184,184,0,0,0
553593,345,345,0,0,0
553603,315,315,0,0,0
553620,143,143,0,0,0
553630,14,14,0,0,0
553645,259,259,0,0,0
553646,114,114,0,0,0
553670,132,132,0,0,0
553676,97,97,0,0,0
553683,345,345,0,0,0
553695,87,87,0,0,0
553710,18,18,0,0,0
553712,114,114,0,0,0
553713,232,232,0,0,0
553729,306,306,0,0,0
553734,11,11,0,0,0
553738,306,306,0,0,0
553756,402,402,0,0,0
553765,102,102,0,0,0
553766,25,25,0,0,0
553777,345,345,0,0,0
553785,131,131,0,0,0
553804,359,359,0,0,0
553806,121,121,0,0,0
553819,402,402,0,0,0
553845,50,50,0,0,0
553864,41,41,0,0,0
553868,167,167,0,0,0
553873,345,345,0,0,0
553899,167,167,0,0,0
553903,15,15,0,0,0
553906,345,345,0,0,0
553912,158,158,0,0,0
553927,30,30,0,0,0
553936,76,76,0,0,0
553940,18,18,0,0,0
553972,25,25,0,0,0
553987,281,281,0,0,0
554010,184,184,0,0,0
554011,102,102,0,0,0
554018,198,198,0,0,0
554024,114,114,0,0,0
554046,128,128,0,0,0
554058,7,7,0,0,0
554063,353,353,0,0,0
554083,255,255,0,0,0
554099,180,180,0,0,0
554105,259,259,0,0,0
554119,345,345,0,0,0
554129,12,12,0,0,0
554135,255,255,0,0,0
554161,39,39,0,0,0
554164,232,232,0,0,0
554172,281,281,0,0,0
554192,299,299,0,0,0
554194,65,65,0,0,0
554225,310,310,0,0,0
554244,310,310,0,0,0
554252,163,163,0,0,0
554258,87,87,0,0,0
554276,255,255,0,0,0
554305,313,313,0,0,0
554317,103,103,0,0,0
554318,402,402,0,0,0
554325,39,39,0,0,0
554327,180,180,0,0,0
554348,171,171,0,0,0
554394,152,152,0,0,0
554399,6,6,0,0,0
554402,151,151,0,0,0
554443,143,143,0,0,0
554448,102,102,0,0,0
554488,76,76,0,0,0
554497,313,313,0,0,0
554517,101,101,0,0,0
554551,282,282,0,0,0
554552,102,102,0,0,0
554559,345,345,0,0,0
554610,29,29,0,0,0
554611,310,310,0,0,0
554625,345,345,0,0,0
554633,56,56,0,0,0
554635,13,13,0,0,0
554657,402,402,0,0,0
554666,299,299,0,0,0
554679,299,299,0,0,0
554680,158,158,0,0,0
554705,345,345,0,0,0
554706,313,313,0,0,0
554716,259,259,0,0,0
554719,353,353,0,0,0
554724,313,313,0,0,0
554758,15,15,0,0,0
554790,310,310,0,0,0
554816,77,77,0,0,0
554838,76,76,0,0,0
554839,56,56,0,0,0
554846,167,167,0,0,0
554851,402,402,0,0,0
554869,65,65,0,0,0
554881,232,232,0,0,0
554889,14,14,0,0,0
554900,25,25,0,0,0
554902,171,171,0,0,0
554923,201,201,0,0,0
554926,87,87,0,0,0
554929,143,143,0,0,0
554944,39,39,0,0,0
554948,345,345,0,0,0
554952,11,11,0,0,0
554953,281,281,0,0,0
554957,402,402,0,0,0
554961,70,70,0,0,0
554973,353,353,0,0,0
554974,103,103,0,0,0
555017,252,252,0,0,0
555035,359,359,0,0,0
555044,198,198,0,0,0
555057,44,44,0,0,0
555063,77,77,0,0,0
555073,102,102,0,0,0
555078,252,252,0,0,0
555083,255,255,0,0,0
555090,137,137,0,0,0
555112,24,24,0,0,0
555122,158,158,0,0,0
555141,167,167,0,0,0
555155,359,359,0,0,0
555166,137,137,0,0,0
555179,102,102,0,0,0
555212,87,87,0,0,0
555217,39,39,0,0,0
555218,13,13,0,0,0
555220,137,137,0,0,0
555233,24,24,0,0,0
555250,299,299,0,0,0
555255,151,151,0,0,0
555264,50,50,0,0,0
555274,97,97,0,0,0
555287,102,102,0,0,0
555290,82,82,0,0,0
555299,102,102,0,0,0
555301,282,282,0,0,0
555305,345,345,0,0,0
555326,87,87,0,0,0
555339,7,7,0,0,0
555349,114,114,0,0,0
555371,10,10,0,0,0
555376,71,71,0,0,0
555378,130,130,0,0,0
555389,143,143,0,0,0
555393,281,281,0,0,0
555397,121,121,0,0,0
555399,69,69,0,0,0
555407,143,143,0,0,0
555454,85,85,0,0,0
555483,22,22,0,0,0
555485,313,313,0,0,0
555489,18,18,0,0,0
555525,281,281,0,0,0
555544,131,131,0,0,0
555553,20,20,0,0,0
555558,299,299,0,0,0
555568,1,1,0,0,0
555581,57,57,0,0,0
555585,193,193,0,0,0
555598,76,76,0,0,0
555602,43,43,0,0,0
555617,353,353,0,0,0
555625,313,313,0,0,0
555630,313,313,0,0,0
555633,3,3,0,0,0
555638,94,94,0,0,0
555646,282,282,0,0,0
555653,310,310,0,0,0
555700,198,198,0,0,0
555740,246,246,0,0,0
555748,76,76,0,0,0
555780,201,201,0,0,0
555785,30,30,0,0,0
555788,25,25,0,0,0
555828,193,193,0,0,0
555831,313,313,0,0,0
555838,43,43,0,0,0
555851,82,82,0,0,0
555863,306,306,0,0,0
555869,50,50,0,0,0
555881,2,2,0,0,0
555882,40,40,0,0,0
555892,315,315,0,0,0
555915,74,74,0,0,0
555937,103,103,0,0,0
555948,82,82,0,0,0
555950,255,255,0,0,0
555952,251,251,0,0,0
556006,114,114,0,0,0
556007,103,103,0,0,0
556035,315,315,0,0,0
556039,345,345,0,0,0
556049,259,259,0,0,0
556051,171,171,0,0,0
556053,35,35,0,0,0
556076,45,45,0,0,0
556091,13,13,0,0,0
556105,198,198,0,0,0
556107,402,402,0,0,0
556116,18,18,0,0,0
556162,402,402,0,0,0
556177,252,252,0,0,0
556180,133,133,0,0,0
556190,246,246,0,0,0
556191,11,11,0,0,0
556214,259,259,0,0,0
556230,345,345,0,0,0
556243,137,137,0,0,0
556260,163,163,0,0,0
556289,102,102,0,0,0
556301,201,201,0,0,0
556308,12,12,0,0,0
556311,82,82,0,0,0
556319,168,168,0,0,0
556325,12,12,0,0,0
556339,5,5,0,0,0
556359,353,353,0,0,0
556363,120,120,0,0,0
556367,69,69,0,0,0
556402,76,76,0,0,0
556403,17,17,0,0,0
556406,198,198,0,0,0
556435,232,232,0,0,0
556444,74,74,0,0,0
556445,25,25,0,0,0
556451,310,310,0,0,0
556454,144,144,0,0,0
556456,67,67,0,0,0
556457,282,282,0,0,0
556461,345,345,0,0,0
556492,50,50,0,0,0
556500,306,306,0,0,0
556522,34,34,0,0,0
556524,402,402,0,0,0
556525,24,24,0,0,0
556543,71,71,0,0,0
556557,114,114,0,0,0
556561,14,14,0,0,0
556568,67,67,0,0,0
556569,72,72,0,0,0
556574,152,152,0,0,0
556607,6,6,0,0,0
556611,151,151,0,0,0
556622,402,402,0,0,0
556638,7,7,0,0,0
556652,359,359,0,0,0
556654,180,180,0,0,0
556678,281,281,0,0,0
556718,151,151,0,0,0
556724,114,114,0,0,0
556738,402,402,0,0,0
556743,65,65,0,0,0
556755,70,70,0,0,0
556757,163,163,0,0,0
556759,252,252,0,0,0
556781,313,313,0,0,0
556787,259,259,0,0,0
556795,402,402,0,0,0
556799,137,137,0,0,0
556833,232,232,0,0,0
556841,71,71,0,0,0
556843,101,101,0,0,0
556855,137,137,0,0,0
556860,144,144,0,0,0
556867,310,310,0,0,0
556868,193,193,0,0,0
556873,232,232,0,0,0
556876,252,252,0,0,0
556877,359,359,0,0,0
556878,359,359,0,0,0
556909,353,353,0,0,0
556913,167,167,0,0,0
556925,402,402,0,0,0
556929,252,252,0,0,0
556937,131,131,0,0,0
556940,18,18,0,0,0
556952,251,251,0,0,0
556961,315,315,0,0,0
556989,246,246,0,0,0
556995,130,130,0,0,0
556996,359,359,0,0,0
556999,94,94,0,0,0
557006,4,4,0,0,0
557050,167,167,0,0,0
557060,71,71,0,0,0
557092,83,83,0,0,0
557113,353,353,0,0,0
557121,151,151,0,0,0
557125,152,152,0,0,0
557135,102,102,0,0,0
557147,103,103,0,0,0
557148,55,55,0,0,0
557162,255,255,0,0,0
557168,40,40,0,0,0
557172,313,313,0,0,0
557175,306,306,0,0,0
557185,3,3,0,0,0
557190,310,310,0,0,0
557205,66,66,0,0,0
557210,18,18,0,0,0
557213,56,56,0,0,0
557222,1,1,0,0,0
557226,133,133,0,0,0
557234,402,402,0,0,0
557239,113,113,0,0,0
557247,255,255,0,0,0
557253,144,144,0,0,0
557264,281,281,0,0,0
557272,184,184,0,0,0
557274,198,198,0,0,0
557294,252,252,0,0,0
557303,137,137,0,0,0
557307,315,315,0,0,0
557320,315,315,0,0,0
557322,315,315,0,0,0
557323,29,29,0,0,0
557327,87,87,0,0,0
557350,74,74,0,0,0
557351,144,144,0,0,0
557367,83,83,0,0,0
557411,246,246,0,0,0
557423,58,58,0,0,0
557436,45,45,0,0,0
557442,25,25,0,0,0
557469,8,8,0,0,0
557477,402,402,0,0,0
557481,130,130,0,0,0
557482,345,345,0,0,0
557491,313,313,0,0,0
557499,353,353,0,0,0
557503,76,76,0,0,0
557505,306,306,0,0,0
557524,12,12,0,0,0
557527,345,345,0,0,0
557532,121,121,0,0,0
557540,151,151,0,0,0
557547,255,255,0,0,0
557550,36,36,0,0,0
557585,144,144,0,0,0
557608,77,77,0,0,0
557626,152,152,0,0,0
557640,77,77,0,0,0
557669,180,180,0,0,0
557677,113,113,0,0,0
557683,14,14,0,0,0
557701,83,83,0,0,0
557706,137,137,0,0,0
557717,7,7,0,0,0
557719,353,353,0,0,0
557726,9,9,0,0,0
557734,402,402,0,0,0
557736,130,130,0,0,0
557751,163,163,0,0,0
557760,66,66,0,0,0
557763,20,20,0,0,0
557772,402,402,0,0,0
557781,55,55,0,0,0
557782,144,144,0,0,0
557797,252,252,0,0,0
557800,70,70,0,0,0
557815,310,310,0,0,0
557824,252,252,0,0,0
557831,130,130,0,0,0
557846,167,167,0,0,0
557852,11,11,0,0,0
557860,76,76,0,0,0
557895,310,310,0,0,0
557916,315,315,0,0,0
557957,16,16,0,0,0
557961,103,103,0,0,0
557971,131,131,0,0,0
557988,299,299,0,0,0
557995,102,102,0,0,0
557997,310,310,0,0,0
558000,121,121,0,0,0
558008,4,4,0,0,0
558011,310,310,0,0,0
558017,201,201,0,0,0
558019,353,353,0,0,0
558030,102,102,0,0,0
558047,246,246,0,0,0
558054,40,40,0,0,0
558055,184,184,0,0,0
558064,282,282,0,0,0
558086,345,345,0,0,0
558098,22,22,0,0,0
558103,143,143,0,0,0
558109,158,158,0,0,0
558116,315,315,0,0,0
558121,184,184,0,0,0
558124,198,198,0,0,0
558139,120,120,0,0,0
558148,184,184,0,0,0
558162,4,4,0,0,0
558175,121,121,0,0,0
558193,20,20,0,0,0
558197,163,163,0,0,0
558213,151,151,0,0,0
558218,1,1,0,0,0
558227,315,315,0,0,0
558248,281,281,0,0,0
558250,133,133,0,0,0
558260,359,359,0,0,0
558261,151,151,0,0,0
558272,232,232,0,0,0
558284,313,313,0,0,0
558287,313,313,0,0,0
558291,14,14,0,0,0
558299,102,102,0,0,0
558302,168,168,0,0,0
558312,83,83,0,0,0
558319,252,252,0,0,0
558346,114,114,0,0,0
558351,70,70,0,0,0
558354,402,402,0,0,0
558361,10,10,0,0,0
558379,120,120,0,0,0
558413,171,171,0,0,0
558414,10,10,0,0,0
558415,402,402,0,0,0
558429,282,282,0,0,0
558438,19,19,0,0,0
558441,14,14,0,0,0
558468,23,23,0,0,0
558484,299,299,0,0,0
558486,29,29,0,0,0
558490,24,24,0,0,0
558509,70,70,0,0,0
558540,131,131,0,0,0
558562,315,315,0,0,0
558572,69,69,0,0,0
558587,50,50,0,0,0
558621,45,45,0,0,0
558622,56,56,0,0,0
558633,43,43,0,0,0
558639,251,251,0,0,0
558651,56,56,0,0,0
558657,353,353,0,0,0
558664,19,19,0,0,0
558675,66,66,0,0,0
558691,56,56,0,0,0
558692,359,359,0,0,0
558709,281,281,0,0,0
558714,359,359,0,0,0
558722,75,75,0,0,0
558771,353,353,0,0,0
558839,130,130,0,0,0
558842,251,251,0,0,0
558875,246,246,0,0,0
558893,310,310,0,0,0
558904,353,353,0,0,0
558919,359,359,0,0,0
558942,130,130,0,0,0
558947,251,251,0,0,0
558965,313,313,0,0,0
559006,35,35,0,0,0
559019,14,14,0,0,0
559029,144,144,0,0,0
559038,36,36,0,0,0
559040,167,167,0,0,0
559049,282,282,0,0,0
559060,281,281,0,0,0
559085,259,259,0,0,0
559093,252,252,0,0,0
559105,15,15,0,0,0
559108,128,128,0,0,0
559128,72,72,0,0,0
559134,345,345,0,0,0
559143,128,128,0,0,0
559147,57,57,0,0,0
559150,184,184,0,0,0
559157,36,36,0,0,0
559181,167,167,0,0,0
559190,198,198,0,0,0
559206,83,83,0,0,0
559222,3,3,0,0,0
559226,402,402,0,0,0
559253,402,402,0,0,0
559262,259,259,0,0,0
559267,120,120,0,0,0
559270,101,101,0,0,0
559280,137,137,0,0,0
559288,232,232,0,0,0
559307,82,82,0,0,0
559323,97,97,0,0,0
559330,21,21,0,0,0
559345,306,306,0,0,0
559379,167,167,0,0,0
559380,19,19,0,0,0
559386,114,114,0,0,0
559389,29,29,0,0,0
559410,353,353,0,0,0
559434,121,121,0,0,0
559436,72,72,0,0,0
559442,180,180,0,0,0
559443,168,168,0,0,0
559457,143,143,0,0,0
559461,158,158,0,0,0
559468,34,34,0,0,0
559486,63,63,0,0,0
559490,75,75,0,0,0
559502,83,83,0,0,0
559521,171,171,0,0,0
559554,345,345,0,0,0
559556,232,232,0,0,0
559563,45,45,0,0,0
559569,255,255,0,0,0
559584,121,121,0,0,0
559589,35,35,0,0,0
559593,3,3,0,0,0
559621,158,158,0,0,0
559623,97,97,0,0,0
559639,168,168,0,0,0
559692,143,143,0,0,0
559705,282,282,0,0,0
559707,94,94,0,0,0
559708,306,306,0,0,0
559712,128,128,0,0,0
559726,11,11,0,0,0
559732,402,402,0,0,0
559735,54,54,0,0,0
559765,24,24,0,0,0
559772,359,359,0,0,0
559777,71,71,0,0,0
559792,201,201,0,0,0
559793,143,143,0,0,0
559800,345,345,0,0,0
559804,299,299,0,0,0
559805,133,133,0,0,0
559824,102,102,0,0,0
559830,232,232,0,0,0
559834,359,359,0,0,0
559843,306,306,0,0,0
559855,151,151,0,0,0
559868,114,114,0,0,0
559872,114,114,0,0,0
559879,353,353,0,0,0
559888,102,102,0,0,0
559897,184,184,0,0,0
559918,168,168,0,0,0
559928,359,359,0,0,0
559930,70,70,0,0,0
559944,315,315,0,0,0
559951,74,74,0,0,0
559964,103,103,0,0,0
559991,315,315,0,0,0
559997,10,10,0,0,0
560015,353,353,0,0,0
560022,168,168,0,0,0
560027,114,114,0,0,0
560034,299,299,0,0,0
560036,83,83,0,0,0
560070,20,20,0,0,0
560078,76,76,0,0,0
560099,34,34,0,0,0
560106,152,152,0,0,0
560118,310,310,0,0,0
560121,251,251,0,0,0
560135,75,75,0,0,0
560148,171,171,0,0,0
560150,306,306,0,0,0
560166,102,102,0,0,0
560173,8,8,0,0,0
560182,102,102,0,0,0
560183,184,184,0,0,0
560202,43,43,0,0,0
560204,45,45,0,0,0
560206,359,359,0,0,0
560220,13,13,0,0,0
560232,137,137,0,0,0
560238,8,8,0,0,0
560249,74,74,0,0,0
560255,315,315,0,0,0
560256,232,232,0,0,0
560258,252,252,0,0,0
560264,113,113,0,0,0
560266,21,21,0,0,0
560296,24,24,0,0,0
560316,13,13,0,0,0
560322,359,359,0,0,0
560336,306,306,0,0,0
560338,22,22,0,0,0
560362,9,9,0,0,0
560363,158,158,0,0,0
560364,144,144,0,0,0
560368,83,83,0,0,0
560373,137,137,0,0,0
560379,171,171,0,0,0
560389,167,167,0,0,0
560390,113,113,0,0,0
560391,171,171,0,0,0
560392,306,306,0,0,0
560394,120,120,0,0,0
560399,87,87,0,0,0
560423,74,74,0,0,0
560426,17,17,0,0,0
560444,402,402,0,0,0
560445,345,345,0,0,0
560447,282,282,0,0,0
560452,281,281,0,0,0
560476,20,20,0,0,0
560484,144,144,0,0,0
560533,7,7,0,0,0
560538,167,167,0,0,0
560544,72,72,0,0,0
560569,345,345,0,0,0
560575,315,315,0,0,0
560584,114,114,0,0,0
560596,168,168,0,0,0
560599,252,252,0,0,0
560604,171,171,0,0,0
560606,20,20,0,0,0
560620,121,121,0,0,0
560621,137,137,0,0,0
560636,152,152,0,0,0
560639,44,44,0,0,0
560645,25,25,0,0,0
560646,251,251,0,0,0
560653,402,402,0,0,0
560660,71,71,0,0,0
560675,201,201,0,0,0
560690,20,20,0,0,0
560691,102,102,0,0,0
560732,353,353,0,0,0
560739,77,77,0,0,0
560740,299,299,0,0,0
560746,282,282,0,0,0
560748,402,402,0,0,0
560754,50,50,0,0,0
560778,158,158,0,0,0
560781,27,27,0,0,0
560783,252,252,0,0,0
560795,120,120,0,0,0
560796,180,180,0,0,0
560819,251,251,0,0,0
560822,168,168,0,0,0
560859,255,255,0,0,0
560863,121,121,0,0,0
560902,25,25,0,0,0
560912,133,133,0,0,0
560928,39,39,0,0,0
560934,102,102,0,0,0
560939,255,255,0,0,0
560948,353,353,0,0,0
560950,102,102,0,0,0
560953,114,114,0,0,0
560961,282,282,0,0,0
560969,143,143,0,0,0
560989,3,3,0,0,0
561000,121,121,0,0,0
561032,39,39,0,0,0
561056,103,103,0,0,0
561069,65,65,0,0,0
561086,252,252,0,0,0
561117,201,201,0,0,0
561138,282,282,0,0,0
561152,29,29,0,0,0
561155,306,306,0,0,0
561172,345,345,0,0,0
561173,259,259,0,0,0
561201,193,193,0,0,0
561202,1,1,0,0,0
561211,22,22,0,0,0
561218,63,63,0,0,0
561226,259,259,0,0,0
561239,6,6,0,0,0
561250,313,313,0,0,0
561251,43,43,0,0,0
561263,299,299,0,0,0
561266,54,54,0,0,0
561270,74,74,0,0,0
561275,359,359,0,0,0
561287,128,128,0,0,0
561290,180,180,0,0,0
561296,83,83,0,0,0
561307,43,43,0,0,0
561323,251,251,0,0,0
561337,345,345,0,0,0
561346,137,137,0,0,0
561348,43,43,0,0,0
561353,5,5,0,0,0
561360,70,70,0,0,0
561418,315,315,0,0,0
561450,251,251,0,0,0
561468,255,255,0,0,0
561474,30,30,0,0,0
561477,168,168,0,0,0
561501,102,102,0,0,0
561516,282,282,0,0,0
561522,24,24,0,0,0
561523,55,55,0,0,0
561538,102,102,0,0,0
561551,128,128,0,0,0
561561,70,70,0,0,0
561564,39,39,0,0,0
561576,144,144,0,0,0
561606,19,19,0,0,0
561668,180,180,0,0,0
561681,259,259,0,0,0
561694,4,4,0,0,0
561718,11,11,0,0,0
561723,168,168,0,0,0
561727,5,5,0,0,0
561747,28,28,0,0,0
561756,315,315,0,0,0
561765,310,310,0,0,0
561770,40,40,0,0,0
561774,11,11,0,0,0
561785,94,94,0,0,0
561794,353,353,0,0,0
561835,45,45,0,0,0
561843,82,82,0,0,0
561844,132,132,0,0,0
561847,345,345,0,0,0
561872,23,23,0,0,0
561882,158,158,0,0,0
561891,76,76,0,0,0
561894,114,114,0,0,0
561916,168,168,0,0,0
561926,144,144,0,0,0
561932,128,128,0,0,0
561940,67,67,0,0,0
561952,402,402,0,0,0
561956,137,137,0,0,0
561964,345,345,0,0,0
561968,128,128,0,0,0
561975,315,315,0,0,0
561988,102,102,0,0,0
561996,71,71,0,0,0
562003,9,9,0,0,0
562016,184,184,0,0,0
562020,315,315,0,0,0
562028,151,151,0,0,0
562033,251,251,0,0,0
562044,15,15,0,0,0
562050,345,345,0,0,0
562053,402,402,0,0,0
562060,36,36,0,0,0
562074,152,152,0,0,0
562076,97,97,0,0,0
562079,252,252,0,0,0
562100,168,168,0,0,0
562105,67,67,0,0,0
562125,246,246,0,0,0
562137,180,180,0,0,0
562152,82,82,0,0,0
562160,103,103,0,0,0
562173,36,36,0,0,0
562189,25,25,0,0,0
562199,137,137,0,0,0
562240,353,353,0,0,0
562250,35,35,0,0,0
562259,65,65,0,0,0
562274,353,353,0,0,0
562282,252,252,0,0,0
562289,97,97,0,0,0
562300,6,6,0,0,0
562314,315,315,0,0,0
562323,102,102,0,0,0
562327,36,36,0,0,0
562335,143,143,0,0,0
562348,54,54,0,0,0
562352,198,198,0,0,0
562354,121,121,0,0,0
562376,74,74,0,0,0
562387,193,193,0,0,0
562394,180,180,0,0,0
562398,114,114,0,0,0
562404,168,168,0,0,0
562405,41,41,0,0,0
562408,22,22,0,0,0
562420,65,65,0,0,0
562421,313,313,0,0,0
562438,402,402,0,0,0
562445,94,94,0,0,0
562452,251,251,0,0,0
562453,17,17,0,0,0
562460,50,50,0,0,0
562468,246,246,0,0,0
562469,72,72,0,0,0
562474,353,353,0,0,0
562485,83,83,0,0,0
562494,23,23,0,0,0
562496,193,193,0,0,0
562504,56,56,0,0,0
562505,10,10,0,0,0
562522,246,246,0,0,0
562524,345,345,0,0,0
562559,310,310,0,0,0
562561,184,184,0,0,0
562573,193,193,0,0,0
562579,359,359,0,0,0
562608,143,143,0,0,0
562613,282,282,0,0,0
562620,315,315,0,0,0
562623,9,9,0,0,0
562625,35,35,0,0,0
562646,85,85,0,0,0
562647,259,259,0,0,0
562658,143,143,0,0,0
562661,29,29,0,0,0
562701,251,251,0,0,0
562720,143,143,0,0,0
562724,24,24,0,0,0
562726,168,168,0,0,0
562733,255,255,0,0,0
562747,184,184,0,0,0
562752,76,76,0,0,0
562781,201,201,0,0,0
562783,180,180,0,0,0
562786,163,163,0,0,0
562802,137,137,0,0,0
562807,69,69,0,0,0
562811,251,251,0,0,0
562817,315,315,0,0,0
562836,36,36,0,0,0
562838,306,306,0,0,0
562846,76,76,0,0,0
562852,163,163,0,0,0
562861,402,402,0,0,0
562880,281,281,0,0,0
562916,259,259,0,0,0
562929,94,94,0,0,0
562951,101,101,0,0,0
562963,113,113,0,0,0
562977,54,54,0,0,0
562978,1,1,0,0,0
562983,114,114,0,0,0
562985,282,282,0,0,0
562996,359,359,0,0,0
562999,11,11,0,0,0
563002,15,15,0,0,0
563015,15,15,0,0,0
563021,44,44,0,0,0
563027,137,137,0,0,0
563028,306,306,0,0,0
563029,313,313,0,0,0
563042,402,402,0,0,0
563055,12,12,0,0,0
563066,251,251,0,0,0
563074,152,152,0,0,0
563103,259,259,0,0,0
563111,315,315,0,0,0
563137,184,184,0,0,0
563139,171,171,0,0,0
563146,18,18,0,0,0
563166,252,252,0,0,0
563175,121,121,0,0,0
563182,306,306,0,0,0
563196,144,144,0,0,0
563204,201,201,0,0,0
563210,23,23,0,0,0
563232,171,171,0,0,0
563235,246,246,0,0,0
563244,345,345,0,0,0
563274,310,310,0,0,0
563293,97,97,0,0,0
563297,82,82,0,0,0
563309,19,19,0,0,0
563325,345,345,0,0,0
563331,359,359,0,0,0
563343,27,27,0,0,0
563361,152,152,0,0,0
563385,133,133,0,0,0
563390,251,251,0,0,0
563391,76,76,0,0,0
563394,16,16,0,0,0
563397,232,232,0,0,0
563400,152,152,0,0,0
563402,40,40,0,0,0
563419,27,27,0,0,0
563420,114,114,0,0,0
563428,252,252,0,0,0
563433,353,353,0,0,0
563446,36,36,0,0,0
563456,121,121,0,0,0
563461,345,345,0,0,0
563462,131,131,0,0,0
563485,22,22,0,0,0
563497,313,313,0,0,0
563505,39,39,0,0,0
563507,299,299,0,0,0
563520,54,54,0,0,0
563533,114,114,0,0,0
563537,65,65,0,0,0
563548,167,167,0,0,0
563549,167,167,0,0,0
563561,39,39,0,0,0
563596,12,12,0,0,0
563603,315,315,0,0,0
563618,353,353,0,0,0
563625,11,11,0,0,0
563632,102,102,0,0,0
563640,282,282,0,0,0
563643,171,171,0,0,0
563644,345,345,0,0,0
563653,121,121,0,0,0
563668,114,114,0,0,0
563676,63,63,0,0,0
563685,29,29,0,0,0
563692,76,76,0,0,0
563710,16,16,0,0,0
563716,20,20,0,0,0
563721,259,259,0,0,0
563724,114,114,0,0,0
563741,299,299,0,0,0
563760,232,232,0,0,0
563766,246,246,0,0,0
563767,55,55,0,0,0
563768,18,18,0,0,0
563773,315,315,0,0,0
563779,74,74,0,0,0
563786,102,102,0,0,0
563789,83,83,0,0,0
563790,163,163,0,0,0
563830,167,167,0,0,0
563834,151,151,0,0,0
563856,252,252,0,0,0
563861,255,255,0,0,0
563872,168,168,0,0,0
563874,299,299,0,0,0
563888,163,163,0,0,0
563890,63,63,0,0,0
563904,180,180,0,0,0
563913,25,25,0,0,0
563959,144,144,0,0,0
563960,315,315,0,0,0
563966,359,359,0,0,0
563967,113,113,0,0,0
564006,34,34,0,0,0
564010,282,282,0,0,0
564012,12,12,0,0,0
564015,201,201,0,0,0
564022,7,7,0,0,0
564031,168,168,0,0,0
564032,143,143,0,0,0
564038,85,85,0,0,0
564045,56,56,0,0,0
564058,85,85,0,0,0
564062,57,57,0,0,0
564077,306,306,0,0,0
564088,310,310,0,0,0
564096,315,315,0,0,0
564107,184,184,0,0,0
564116,137,137,0,0,0
564139,44,44,0,0,0
564146,83,83,0,0,0
564163,353,353,0,0,0
564164,201,201,0,0,0
564175,45,45,0,0,0
564222,201,201,0,0,0
564225,85,85,0,0,0
564227,163,163,0,0,0
564233,17,17,0,0,0
564251,345,345,0,0,0
564253,353,353,0,0,0
564271,15,15,0,0,0
564272,102,102,0,0,0
564283,76,76,0,0,0
564306,180,180,0,0,0
564325,63,63,0,0,0
564344,137,137,0,0,0
564371,55,55,0,0,0
564375,27,27,0,0,0
564381,353,353,0,0,0
564389,313,313,0,0,0
564431,193,193,0,0,0
564452,8,8,0,0,0
564457,71,71,0,0,0
564466,152,152,0,0,0
564468,35,35,0,0,0
564491,143,143,0,0,0
564492,29,29,0,0,0
564493,94,94,0,0,0
564500,131,131,0,0,0
564501,23,23,0,0,0
564505,201,201,0,0,0
564507,359,359,0,0,0
564508,163,163,0,0,0
564510,21,21,0,0,0
564511,66,66,0,0,0
564517,85,85,0,0,0
564522,193,193,0,0,0
564529,23,23,0,0,0
564538,55,55,0,0,0
564541,66,66,0,0,0
564556,252,252,0,0,0
564557,167,167,0,0,0
564561,345,345,0,0,0
564566,102,102,0,0,0
564574,255,255,0,0,0
564586,137,137,0,0,0
564588,184,184,0,0,0
564592,171,171,0,0,0
564597,251,251,0,0,0
564599,255,255,0,0,0
564600,310,310,0,0,0
564601,40,40,0,0,0
564603,251,251,0,0,0
564612,2,2,0,0,0
564615,128,128,0,0,0
564626,402,402,0,0,0
564634,128,128,0,0,0
564636,252,252,0,0,0
564640,71,71,0,0,0
564652,131,131,0,0,0
564657,35,35,0,0,0
564658,359,359,0,0,0
564676,313,313,0,0,0
564682,198,198,0,0,0
564683,246,246,0,0,0
564697,85,85,0,0,0
564699,232,232,0,0,0
564700,85,85,0,0,0
564701,315,315,0,0,0
564708,246,246,0,0,0
564715,232,232,0,0,0
564718,41,41,0,0,0
564753,24,24,0,0,0
564765,137,137,0,0,0
564773,168,168,0,0,0
564783,281,281,0,0,0
564788,152,152,0,0,0
564803,18,18,0,0,0
564842,114,114,0,0,0
564848,281,281,0,0,0
564850,313,313,0,0,0
564851,167,167,0,0,0
564855,50,50,0,0,0
564856,232,232,0,0,0
564857,12,12,0,0,0
564858,251,251,0,0,0
564872,310,310,0,0,0
564886,184,184,0,0,0
564889,310,310,0,0,0
564909,71,71,0,0,0
564922,102,102,0,0,0
564933,310,310,0,0,0
564945,94,94,0,0,0
564956,19,19,0,0,0
564986,281,281,0,0,0
565001,232,232,0,0,0
565008,74,74,0,0,0
565009,255,255,0,0,0
565022,201,201,0,0,0
565024,144,144,0,0,0
565026,8,8,0,0,0
565028,180,180,0,0,0
565038,114,114,0,0,0
565042,345,345,0,0,0
565053,70,70,0,0,0
565061,102,102,0,0,0
565076,74,74,0,0,0
565078,4,4,0,0,0
565116,232,232,0,0,0
565119,66,66,0,0,0
565124,282,282,0,0,0
565125,121,121,0,0,0
565133,113,113,0,0,0
565180,313,313,0,0,0
565192,54,54,0,0,0
565193,353,353,0,0,0
565213,133,133,0,0,0
565223,180,180,0,0,0
565224,50,50,0,0,0
565269,17,17,0,0,0
565299,120,120,0,0,0
565300,315,315,0,0,0
565313,15,15,0,0,0
565314,137,137,0,0,0
565317,130,130,0,0,0
565337,56,56,0,0,0
565342,259,259,0,0,0
565348,9,9,0,0,0
565351,50,50,0,0,0
565362,251,251,0,0,0
565374,17,17,0,0,0
565384,3,3,0,0,0
565400,359,359,0,0,0
565412,143,143,0,0,0
565415,201,201,0,0,0
565434,4,4,0,0,0
565471,94,94,0,0,0
565478,54,54,0,0,0
565494,402,402,0,0,0
565495,306,306,0,0,0
565510,114,114,0,0,0
565514,65,65,0,0,0
565517,251,251,0,0,0
565539,2,2,0,0,0
565542,11,11,0,0,0
565548,4,4,0,0,0
565557,306,306,0,0,0
565560,281,281,0,0,0
565577,20,20,0,0,0
565597,144,144,0,0,0
565602,359,359,0,0,0
565618,313,313,0,0,0
565619,310,310,0,0,0
565627,353,353,0,0,0
565643,259,259,0,0,0
565684,3,3,0,0,0
565688,313,313,0,0,0
565698,310,310,0,0,0
565711,85,85,0,0,0
565726,345,345,0,0,0
565736,180,180,0,0,0
565743,21,21,0,0,0
565748,3,3,0,0,0
565755,70,70,0,0,0
565758,28,28,0,0,0
565774,22,22,0,0,0
565780,281,281,0,0,0
565791,171,171,0,0,0
565798,74,74,0,0,0
565803,143,143,0,0,0
565817,36,36,0,0,0
565853,56,56,0,0,0
565854,137,137,0,0,0
565859,193,193,0,0,0
565869,36,36,0,0,0
565904,27,27,0,0,0
565914,259,259,0,0,0
565957,137,137,0,0,0
565961,151,151,0,0,0
565966,121,121,0,0,0
565971,402,402,0,0,0
565975,76,76,0,0,0
566011,255,255,0,0,0
566036,74,74,0,0,0
566059,353,353,0,0,0
566076,132,132,0,0,0
566097,310,310,0,0,0
566104,45,45,0,0,0
566107,198,198,0,0,0
566116,7,7,0,0,0
566118,402,402,0,0,0
566124,232,232,0,0,0
566134,306,306,0,0,0
566135,171,171,0,0,0
566139,158,158,0,0,0
566146,29,29,0,0,0
566157,306,306,0,0,0
566158,282,282,0,0,0
566165,10,10,0,0,0
566177,313,313,0,0,0
566180,101,101,0,0,0
566190,299,299,0,0,0
566197,114,114,0,0,0
566207,255,255,0,0,0
566208,313,313,0,0,0
566210,6,6,0,0,0
566215,11,11,0,0,0
566233,9,9,0,0,0
566240,143,143,0,0,0
566310,8,8,0,0,0
566317,25,25,0,0,0
566334,168,168,0,0,0
566344,12,12,0,0,0
566347,87,87,0,0,0
566351,353,353,0,0,0
566356,74,74,0,0,0
566363,168,168,0,0,0
566372,299,299,0,0,0
566374,128,128,0,0,0
566436,158,158,0,0,0
566440,184,184,0,0,0
566454,180,180,0,0,0
566456,180,180,0,0,0
566461,101,101,0,0,0
566469,120,120,0,0,0
566483,151,151,0,0,0
566489,180,180,0,0,0
566498,359,359,0,0,0
566504,345,345,0,0,0
566506,313,313,0,0,0
566511,282,282,0,0,0
566514,39,39,0,0,0
566544,65,65,0,0,0
566546,345,345,0,0,0
566554,299,299,0,0,0
566576,402,402,0,0,0
566579,246,246,0,0,0
566584,252,252,0,0,0
566596,102,102,0,0,0
566604,353,353,0,0,0
566606,76,76,0,0,0
566608,359,359,0,0,0
566657,71,71,0,0,0
566662,6,6,0,0,0
566668,402,402,0,0,0
566723,281,281,0,0,0
566727,4,4,0,0,0
566738,10,10,0,0,0
566751,15,15,0,0,0
566756,2,2,0,0,0
566769,75,75,0,0,0
566778,193,193,0,0,0
566780,198,198,0,0,0
566786,299,299,0,0,0
566795,315,315,0,0,0
566813,184,184,0,0,0
566850,87,87,0,0,0
566854,310,310,0,0,0
566862,345,345,0,0,0
566875,281,281,0,0,0
566939,10,10,0,0,0
566953,151,151,0,0,0
566967,27,27,0,0,0
566971,13,13,0,0,0
566973,23,23,0,0,0
566974,180,180,0,0,0
566980,133,133,0,0,0
566984,313,313,0,0,0
566997,402,402,0,0,0
566999,102,102,0,0,0
567012,29,29,0,0,0
567056,299,299,0,0,0
567081,299,299,0,0,0
567088,259,259,0,0,0
567105,180,180,0,0,0
567122,201,201,0,0,0
567129,315,315,0,0,0
567136,259,259,0,0,0
567137,24,24,0,0,0
567140,255,255,0,0,0
567150,281,281,0,0,0
567163,76,76,0,0,0
567165,315,315,0,0,0
567172,50,50,0,0,0
567174,306,306,0,0,0
567179,137,137,0,0,0
567181,198,198,0,0,0
567183,22,22,0,0,0
567196,97,97,0,0,0
567209,137,137,0,0,0
567217,306,306,0,0,0
567219,83,83,0,0,0
567228,113,113,0,0,0
567244,144,144,0,0,0
567245,143,143,0,0,0
567255,25,25,0,0,0
567258,315,315,0,0,0
567261,144,144,0,0,0
567279,255,255,0,0,0
567280,44,44,0,0,0
567293,163,163,0,0,0
567297,87,87,0,0,0
567302,57,57,0,0,0
567304,252,252,0,0,0
567326,353,353,0,0,0
567350,313,313,0,0,0
567356,18,18,0,0,0
567358,345,345,0,0,0
567366,252,252,0,0,0
567386,39,39,0,0,0
567406,198,198,0,0,0
567411,232,232,0,0,0
567418,34,34,0,0,0
567419,359,359,0,0,0
567422,306,306,0,0,0
567429,252,252,0,0,0
567434,130,130,0,0,0
567447,359,359,0,0,0
567449,74,74,0,0,0
567456,306,306,0,0,0
567465,82,82,0,0,0
567471,74,74,0,0,0
567474,101,101,0,0,0
567485,56,56,0,0,0
567515,120,120,0,0,0
567520,83,83,0,0,0
567523,35,35,0,0,0
567553,43,43,0,0,0
567558,282,282,0,0,0
567559,55,55,0,0,0
567560,9,9,0,0,0
567562,402,402,0,0,0
567585,144,144,0,0,0
567589,101,101,0,0,0
567600,310,310,0,0,0
567603,3,3,0,0,0
567606,232,232,0,0,0
567629,402,402,0,0,0
567670,310,310,0,0,0
567675,45,45,0,0,0
567700,8,8,0,0,0
567703,121,121,0,0,0
567713,345,345,0,0,0
567715,14,14,0,0,0
567729,201,201,0,0,0
567731,8,8,0,0,0
567786,76,76,0,0,0
567789,180,180,0,0,0
567793,74,74,0,0,0
567795,102,102,0,0,0
567797,168,168,0,0,0
567798,359,359,0,0,0
567799,158,158,0,0,0
567803,402,402,0,0,0
567817,8,8,0,0,0
567818,255,255,0,0,0
567823,36,36,0,0,0
567838,259,259,0,0,0
567853,57,57,0,0,0
567870,128,128,0,0,0
567891,6,6,0,0,0
567898,282,282,0,0,0
567904,67,67,0,0,0
567908,198,198,0,0,0
567911,252,252,0,0,0
567923,15,15,0,0,0
567926,143,143,0,0,0
567940,143,143,0,0,0
567956,8,8,0,0,0
567975,151,151,0,0,0
567988,74,74,0,0,0
567994,74,74,0,0,0
567999,130,130,0,0,0
568003,143,143,0,0,0
568017,232,232,0,0,0
568031,131,131,0,0,0
568062,4,4,0,0,0
568082,143,143,0,0,0
568086,251,251,0,0,0
568088,255,255,0,0,0
568094,167,167,0,0,0
568102,85,85,0,0,0
568140,103,103,0,0,0
568149,167,167,0,0,0
568150,76,76,0,0,0
568152,18,18,0,0,0
568158,251,251,0,0,0
568160,345,345,0,0,0
568177,402,402,0,0,0
568195,201,201,0,0,0
568198,18,18,0,0,0
568201,137,137,0,0,0
568205,113,113,0,0,0
568224,113,113,0,0,0
568246,306,306,0,0,0
568248,77,77,0,0,0
568251,232,232,0,0,0
568252,232,232,0,0,0
568256,137,137,0,0,0
568260,252,252,0,0,0
568264,171,171,0,0,0
568303,359,359,0,0,0
568321,232,232,0,0,0
568323,402,402,0,0,0
568349,137,137,0,0,0
568361,29,29,0,0,0
568367,85,85,0,0,0
568389,69,69,0,0,0
568391,246,246,0,0,0
568396,180,180,0,0,0
568400,402,402,0,0,0
568403,113,113,0,0,0
568425,168,168,0,0,0
568431,85,85,0,0,0
568437,114,114,0,0,0
568441,17,17,0,0,0
568444,255,255,0,0,0
568449,66,66,0,0,0
568451,74,74,0,0,0
568476,180,180,0,0,0
568478,345,345,0,0,0
568486,252,252,0,0,0
568488,180,180,0,0,0
568523,128,128,0,0,0
568532,167,167,0,0,0
568538,57,57,0,0,0
568545,34,34,0,0,0
568550,232,232,0,0,0
568560,251,251,0,0,0
568567,22,22,0,0,0
568568,151,151,0,0,0
568571,113,113,0,0,0
568573,35,35,0,0,0
568598,251,251,0,0,0
568611,16,16,0,0,0
568614,259,259,0,0,0
568621,402,402,0,0,0
568625,310,310,0,0,0
568663,151,151,0,0,0
568664,25,25,0,0,0
568674,315,315,0,0,0
568682,259,259,0,0,0
568690,120,120,0,0,0
568691,315,315,0,0,0
568694,121,121,0,0,0
568709,167,167,0,0,0
568739,50,50,0,0,0
568744,12,12,0,0,0
568774,281,281,0,0,0
568797,15,15,0,0,0
568833,255,255,0,0,0
568866,97,97,0,0,0
568879,74,74,0,0,0
568883,56,56,0,0,0
568887,137,137,0,0,0
568892,113,113,0,0,0
568893,315,315,0,0,0
568905,74,74,0,0,0
568916,306,306,0,0,0
568920,54,54,0,0,0
568921,152,152,0,0,0
568949,85,85,0,0,0
568950,85,85,0,0,0
568957,171,171,0,0,0
568971,44,44,0,0,0
568973,36,36,0,0,0
568977,255,255,0,0,0
568984,113,113,0,0,0
568992,25,25,0,0,0
569003,56,56,0,0,0
569010,246,246,0,0,0
569032,41,41,0,0,0
569039,5,5,0,0,0
569062,94,94,0,0,0
569064,251,251,0,0,0
569082,103,103,0,0,0
569083,359,359,0,0,0
569084,12,12,0,0,0
569106,252,252,0,0,0
569109,282,282,0,0,0
569121,310,310,0,0,0
569125,180,180,0,0,0
569147,74,74,0,0,0
569154,359,359,0,0,0
569162,66,66,0,0,0
569166,184,184,0,0,0
569172,137,137,0,0,0
569173,87,87,0,0,0
569180,282,282,0,0,0
569182,27,27,0,0,0
569183,15,15,0,0,0
569203,82,82,0,0,0
569212,201,201,0,0,0
569221,144,144,0,0,0
569235,152,152,0,0,0
569253,184,184,0,0,0
569261,50,50,0,0,0
569280,402,402,0,0,0
569293,315,315,0,0,0
569298,198,198,0,0,0
569300,94,94,0,0,0
569312,102,102,0,0,0
569341,359,359,0,0,0
569354,43,43,0,0,0
569358,56,56,0,0,0
569371,246,246,0,0,0
569372,120,120,0,0,0
569373,11,11,0,0,0
569381,16,16,0,0,0
569410,69,69,0,0,0
569445,306,306,0,0,0
569450,163,163,0,0,0
569452,251,251,0,0,0
569456,2,2,0,0,0
569461,232,232,0,0,0
569462,102,102,0,0,0
569468,24,24,0,0,0
569469,158,158,0,0,0
569471,402,402,0,0,0
569472,102,102,0,0,0
569481,114,114,0,0,0
569509,168,168,0,0,0
569520,5,5,0,0,0
569529,12,12,0,0,0
569531,39,39,0,0,0
569538,143,143,0,0,0
569558,310,310,0,0,0
569567,158,158,0,0,0
569575,103,103,0,0,0
569584,259,259,0,0,0
569588,14,14,0,0,0
569592,103,103,0,0,0
569595,75,75,0,0,0
569598,101,101,0,0,0
569621,152,152,0,0,0
569625,114,114,0,0,0
569626,315,315,0,0,0
569641,246,246,0,0,0
569655,25,25,0,0,0
569661,74,74,0,0,0
569675,353,353,0,0,0
569687,29,29,0,0,0
569727,97,97,0,0,0
569743,19,19,0,0,0
569756,152,152,0,0,0
569790,41,41,0,0,0
569791,402,402,0,0,0
569801,359,359,0,0,0
569809,299,299,0,0,0
569814,315,315,0,0,0
569837,315,315,0,0,0
569845,306,306,0,0,0
569857,27,27,0,0,0
569872,359,359,0,0,0
569874,102,102,0,0,0
569891,10,10,0,0,0
569898,315,315,0,0,0
569907,193,193,0,0,0
569918,168,168,0,0,0
569927,66,66,0,0,0
569933,345,345,0,0,0
569939,16,16,0,0,0
569946,24,24,0,0,0
569948,193,193,0,0,0
569952,252,252,0,0,0
569954,56,56,0,0,0
569987,15,15,0,0,0
570009,402,402,0,0,0
570020,144,144,0,0,0
570061,310,310,0,0,0
570068,102,102,0,0,0
570069,65,65,0,0,0
570072,143,143,0,0,0
570073,128,128,0,0,0
570086,151,151,0,0,0
570097,282,282,0,0,0
570099,402,402,0,0,0
570112,121,121,0,0,0
570127,345,345,0,0,0
570134,259,259,0,0,0
570172,152,152,0,0,0
570180,313,313,0,0,0
570188,74,74,0,0,0
570196,259,259,0,0,0
570205,15,15,0,0,0
570215,29,29,0,0,0
570229,402,402,0,0,0
570239,402,402,0,0,0
570247,85,85,0,0,0
570269,251,251,0,0,0
570277,56,56,0,0,0
570282,306,306,0,0,0
570296,65,65,0,0,0
570302,255,255,0,0,0
570308,359,359,0,0,0
570314,359,359,0,0,0
570369,171,171,0,0,0
570374,359,359,0,0,0
570395,74,74,0,0,0
570405,137,137,0,0,0
570415,15,15,0,0,0
570417,56,56,0,0,0
570418,193,193,0,0,0
570428,131,131,0,0,0
570429,282,282,0,0,0
570451,56,56,0,0,0
570459,54,54,0,0,0
570474,120,120,0,0,0
570507,121,121,0,0,0
570529,299,299,0,0,0
570539,353,353,0,0,0
570556,252,252,0,0,0
570567,310,310,0,0,0
570610,74,74,0,0,0
570627,158,158,0,0,0
570628,193,193,0,0,0
570637,36,36,0,0,0
570679,402,402,0,0,0
570681,137,137,0,0,0
570710,97,97,0,0,0
570722,259,259,0,0,0
570731,10,10,0,0,0
570737,246,246,0,0,0
570771,259,259,0,0,0
570774,171,171,0,0,0
570793,74,74,0,0,0
570801,251,251,0,0,0
570821,402,402,0,0,0
570834,232,232,0,0,0
570837,85,85,0,0,0
570850,246,246,0,0,0
570854,76,76,0,0,0
570856,130,130,0,0,0
570857,163,163,0,0,0
570861,353,353,0,0,0
570869,251,251,0,0,0
570871,45,45,0,0,0
570877,313,313,0,0,0
570882,70,70,0,0,0
570891,94,94,0,0,0
570901,45,45,0,0,0
570920,16,16,0,0,0
570928,7,7,0,0,0
570929,22,22,0,0,0
570932,345,345,0,0,0
570938,3,3,0,0,0
570953,102,102,0,0,0
570965,255,255,0,0,0
570981,120,120,0,0,0
570989,402,402,0,0,0
571012,259,259,0,0,0
571014,132,132,0,0,0
571019,137,137,0,0,0
571061,402,402,0,0,0
571068,17,17,0,0,0
571074,29,29,0,0,0
571075,246,246,0,0,0
571078,310,310,0,0,0
571082,77,77,0,0,0
571102,313,313,0,0,0
571104,8,8,0,0,0
571109,103,103,0,0,0
571110,232,232,0,0,0
571111,171,171,0,0,0
571115,143,143,0,0,0
571116,39,39,0,0,0
571120,57,57,0,0,0
571131,306,306,0,0,0
571132,402,402,0,0,0
571133,402,402,0,0,0
571134,36,36,0,0,0
571139,3,3,0,0,0
571167,120,120,0,0,0
571179,85,85,0,0,0
571195,282,282,0,0,0
571228,259,259,0,0,0
571255,282,282,0,0,0
571262,299,299,0,0,0
571304,19,19,0,0,0
571309,163,163,0,0,0
571315,345,345,0,0,0
571318,121,121,0,0,0
571327,353,353,0,0,0
571330,251,251,0,0,0
571348,4,4,0,0,0
571355,63,63,0,0,0
571360,299,299,0,0,0
571362,102,102,0,0,0
571365,198,198,0,0,0
571377,40,40,0,0,0
571380,137,137,0,0,0
571390,25,25,0,0,0
571402,167,167,0,0,0
571411,133,133,0,0,0
571415,359,359,0,0,0
571436,55,55,0,0,0
571437,310,310,0,0,0
571454,144,144,0,0,0
571459,359,359,0,0,0
571489,359,359,0,0,0
571490,345,345,0,0,0
571538,8,8,0,0,0
571550,75,75,0,0,0
571558,114,114,0,0,0
571567,76,76,0,0,0
571577,345,345,0,0,0
571581,252,252,0,0,0
571611,97,97,0,0,0
571619,163,163,0,0,0
571623,171,171,0,0,0
571629,16,16,0,0,0
571631,353,353,0,0,0
571632,102,102,0,0,0
571642,137,137,0,0,0
571661,17,17,0,0,0
571688,180,180,0,0,0
571698,193,193,0,0,0
571699,281,281,0,0,0
571708,102,102,0,0,0
571718,171,171,0,0,0
571721,246,246,0,0,0
571736,69,69,0,0,0
571749,310,310,0,0,0
571752,151,151,0,0,0
571756,76,76,0,0,0
571764,11,11,0,0,0
571779,130,130,0,0,0
571784,55,55,0,0,0
571785,306,306,0,0,0
571796,27,27,0,0,0
571810,184,184,0,0,0
571818,151,151,0,0,0
571832,171,171,0,0,0
571837,35,35,0,0,0
571842,128,128,0,0,0
571846,353,353,0,0,0
571864,85,85,0,0,0
571868,282,282,0,0,0
571876,315,315,0,0,0
571882,69,69,0,0,0
571890,168,168,0,0,0
571917,114,114,0,0,0
571932,12,12,0,0,0
571936,158,158,0,0,0
571937,18,18,0,0,0
571953,402,402,0,0,0
571965,45,45,0,0,0
571987,16,16,0,0,0
572034,130,130,0,0,0
572042,97,97,0,0,0
572054,82,82,0,0,0
572056,168,168,0,0,0
572069,299,299,0,0,0
572073,144,144,0,0,0
572076,201,201,0,0,0
572077,13,13,0,0,0
572079,13,13,0,0,0
572092,70,70,0,0,0
572111,45,45,0,0,0
572120,97,97,0,0,0
572129,143,143,0,0,0
572142,168,168,0,0,0
572146,74,74,0,0,0
572147,402,402,0,0,0
572174,55,55,0,0,0
572182,56,56,0,0,0
572198,353,353,0,0,0
572205,171,171,0,0,0
572217,306,306,0,0,0
572227,255,255,0,0,0
572247,15,15,0,0,0
572250,359,359,0,0,0
572262,184,184,0,0,0
572268,281,281,0,0,0
572274,163,163,0,0,0
572280,402,402,0,0,0
572281,102,102,0,0,0
572283,306,306,0,0,0
572301,55,55,0,0,0
572302,143,143,0,0,0
572321,14,14,0,0,0
572331,144,144,0,0,0
572350,25,25,0,0,0
572377,101,101,0,0,0
572378,251,251,0,0,0
572387,171,171,0,0,0
572392,74,74,0,0,0
572397,359,359,0,0,0
572419,121,121,0,0,0
572422,201,201,0,0,0
572443,299,299,0,0,0
572445,232,232,0,0,0
572456,143,143,0,0,0
572458,23,23,0,0,0
572459,353,353,0,0,0
572472,114,114,0,0,0
572484,16,16,0,0,0
572503,29,29,0,0,0
572517,402,402,0,0,0
572519,232,232,0,0,0
572522,167,167,0,0,0
572530,315,315,0,0,0
572542,299,299,0,0,0
572556,114,114,0,0,0
572557,143,143,0,0,0
572572,299,299,0,0,0
572578,102,102,0,0,0
572601,103,103,0,0,0
572605,402,402,0,0,0
572606,345,345,0,0,0
572611,102,102,0,0,0
572612,152,152,0,0,0
572615,281,281,0,0,0
572630,102,102,0,0,0
572647,345,345,0,0,0
572687,23,23,0,0,0
572692,152,152,0,0,0
572699,345,345,0,0,0
572727,70,70,0,0,0
572730,152,152,0,0,0
572738,137,137,0,0,0
572745,402,402,0,0,0
572748,359,359,0,0,0
572756,143,143,0,0,0
572760,299,299,0,0,0
572762,281,281,0,0,0
572773,143,143,0,0,0
572785,201,201,0,0,0
572793,15,15,0,0,0
572796,18,18,0,0,0
572806,70,70,0,0,0
572815,359,359,0,0,0
572837,402,402,0,0,0
572844,54,54,0,0,0
572857,152,152,0,0,0
572867,259,259,0,0,0
572880,315,315,0,0,0
572885,306,306,0,0,0
572915,11,11,0,0,0
572933,7,7,0,0,0
572940,299,299,0,0,0
572945,345,345,0,0,0
572947,246,246,0,0,0
572949,16,16,0,0,0
572966,137,137,0,0,0
572974,120,120,0,0,0
572984,36,36,0,0,0
572985,359,359,0,0,0
572988,402,402,0,0,0
572993,120,120,0,0,0
573017,102,102,0,0,0
573018,168,168,0,0,0
573023,27,27,0,0,0
573034,7,7,0,0,0
573036,103,103,0,0,0
573059,255,255,0,0,0
573075,113,113,0,0,0
573078,158,158,0,0,0
573084,168,168,0,0,0
573096,353,353,0,0,0
573108,6,6,0,0,0
573138,259,259,0,0,0
573156,313,313,0,0,0
573161,67,67,0,0,0
573164,130,130,0,0,0
573171,101,101,0,0,0
573179,44,44,0,0,0
573215,163,163,0,0,0
573216,17,17,0,0,0
573220,35,35,0,0,0
573223,120,120,0,0,0
573252,4,4,0,0,0
573253,56,56,0,0,0
573265,281,281,0,0,0
573268,353,353,0,0,0
573276,259,259,0,0,0
573292,18,18,0,0,0
573304,168,168,0,0,0
573315,259,259,0,0,0
573329,402,402,0,0,0
573341,315,315,0,0,0
573346,255,255,0,0,0
573361,39,39,0,0,0
573363,359,359,0,0,0
573368,402,402,0,0,0
573370,65,65,0,0,0
573382,113,113,0,0,0
573399,128,128,0,0,0
573407,180,180,0,0,0
573424,167,167,0,0,0
573437,120,120,0,0,0
573459,353,353,0,0,0
573463,251,251,0,0,0
573499,12,12,0,0,0
573503,120,120,0,0,0
573507,168,168,0,0,0
573517,69,69,0,0,0
573542,72,72,0,0,0
573550,101,101,0,0,0
573564,198,198,0,0,0
573580,282,282,0,0,0
573581,299,299,0,0,0
573589,7,7,0,0,0
573600,359,359,0,0,0
573607,251,251,0,0,0
573616,130,130,0,0,0
573627,137,137,0,0,0
573628,82,82,0,0,0
573643,114,114,0,0,0
573662,306,306,0,0,0
573687,359,359,0,0,0
573706,281,281,0,0,0
573708,255,255,0,0,0
573710,15,15,0,0,0
573719,114,114,0,0,0
573720,315,315,0,0,0
573725,23,23,0,0,0
573733,281,281,0,0,0
573737,184,184,0,0,0
573738,345,345,0,0,0
573748,65,65,0,0,0
573764,232,232,0,0,0
573766,281,281,0,0,0
573799,255,255,0,0,0
573811,97,97,0,0,0
573815,121,121,0,0,0
573816,180,180,0,0,0
573845,246,246,0,0,0
573853,232,232,0,0,0
573866,24,24,0,0,0
573868,17,17,0,0,0
573875,102,102,0,0,0
573880,54,54,0,0,0
573907,184,184,0,0,0
573909,282,282,0,0,0
573918,10,10,0,0,0
573930,67,67,0,0,0
573940,306,306,0,0,0
573958,18,18,0,0,0
573968,76,76,0,0,0
573988,114,114,0,0,0
573993,313,313,0,0,0
573995,201,201,0,0,0
573997,41,41,0,0,0
574006,75,75,0,0,0
574014,201,201,0,0,0
574021,55,55,0,0,0
574030,315,315,0,0,0
574037,353,353,0,0,0
574062,184,184,0,0,0
574069,152,152,0,0,0
574093,102,102,0,0,0
574096,168,168,0,0,0
574098,163,163,0,0,0
574104,121,121,0,0,0
574109,94,94,0,0,0
574111,201,201,0,0,0
574114,180,180,0,0,0
574134,3,3,0,0,0
574141,306,306,0,0,0
574146,133,133,0,0,0
574170,70,70,0,0,0
574173,101,101,0,0,0
574199,72,72,0,0,0
574209,65,65,0,0,0
574211,144,144,0,0,0
574222,252,252,0,0,0
574224,56,56,0,0,0
574233,128,128,0,0,0
574239,198,198,0,0,0
574241,158,158,0,0,0
574248,102,102,0,0,0
574258,30,30,0,0,0
574275,282,282,0,0,0
574286,345,345,0,0,0
574288,345,345,0,0,0
574289,74,74,0,0,0
574317,259,259,0,0,0
574343,345,345,0,0,0
574346,299,299,0,0,0
574358,137,137,0,0,0
574365,75,75,0,0,0
574367,29,29,0,0,0
574372,151,151,0,0,0
574386,163,163,0,0,0
574412,18,18,0,0,0
574423,17,17,0,0,0
574433,282,282,0,0,0
574441,22,22,0,0,0
574451,246,246,0,0,0
574472,255,255,0,0,0
574480,259,259,0,0,0
574498,65,65,0,0,0
574502,20,20,0,0,0
574534,75,75,0,0,0
574543,345,345,0,0,0
574578,180,180,0,0,0
574584,34,34,0,0,0
574595,83,83,0,0,0
574601,128,128,0,0,0
574606,359,359,0,0,0
574610,359,359,0,0,0
574622,76,76,0,0,0
574623,299,299,0,0,0
574624,39,39,0,0,0
574638,55,55,0,0,0
574640,345,345,0,0,0
574656,83,83,0,0,0
574682,15,15,0,0,0
574685,144,144,0,0,0
574689,6,6,0,0,0
574705,74,74,0,0,0
574708,76,76,0,0,0
574717,94,94,0,0,0
574745,198,198,0,0,0
574747,313,313,0,0,0
574753,15,15,0,0,0
574759,184,184,0,0,0
574766,345,345,0,0,0
574770,3,3,0,0,0
574780,255,255,0,0,0
574789,45,45,0,0,0
574794,252,252,0,0,0
574803,114,114,0,0,0
574828,359,359,0,0,0
574886,306,306,0,0,0
574905,193,193,0,0,0
574913,251,251,0,0,0
574917,306,306,0,0,0
574921,15,15,0,0,0
574925,13,13,0,0,0
574934,130,130,0,0,0
574965,251,251,0,0,0
574978,251,251,0,0,0
575024,29,29,0,0,0
575035,54,54,0,0,0
575043,120,120,0,0,0
575077,201,201,0,0,0
575080,353,353,0,0,0
575098,102,102,0,0,0
575111,83,83,0,0,0
575124,65,65,0,0,0
575125,402,402,0,0,0
575126,17,17,0,0,0
575167,143,143,0,0,0
575182,21,21,0,0,0
575199,167,167,0,0,0
575206,103,103,0,0,0
575216,144,144,0,0,0
575297,113,113,0,0,0
575314,87,87,0,0,0
575317,66,66,0,0,0
575318,114,114,0,0,0
575320,71,71,0,0,0
575327,20,20,0,0,0
575347,255,255,0,0,0
575354,4,4,0,0,0
575357,281,281,0,0,0
575368,14,14,0,0,0
575372,232,232,0,0,0
575391,25,25,0,0,0
575399,16,16,0,0,0
575420,128,128,0,0,0
575436,184,184,0,0,0
575446,152,152,0,0,0
575463,45,45,0,0,0
575471,55,55,0,0,0
575520,137,137,0,0,0
575530,2,2,0,0,0
575566,44,44,0,0,0
575579,44,44,0,0,0
575580,19,19,0,0,0
575581,310,310,0,0,0
575609,97,97,0,0,0
575612,35,35,0,0,0
575618,9,9,0,0,0
575647,201,201,0,0,0
575657,168,168,0,0,0
575660,232,232,0,0,0
575680,74,74,0,0,0
575691,306,306,0,0,0
575708,313,313,0,0,0
575711,353,353,0,0,0
575721,251,251,0,0,0
575726,168,168,0,0,0
575738,102,102,0,0,0
575748,259,259,0,0,0
575750,3,3,0,0,0
575751,36,36,0,0,0
575767,144,144,0,0,0
575770,310,310,0,0,0
575775,29,29,0,0,0
575788,232,232,0,0,0
575792,77,77,0,0,0
575793,152,152,0,0,0
575797,255,255,0,0,0
575800,184,184,0,0,0
575803,36,36,0,0,0
575804,39,39,0,0,0
575811,259,259,0,0,0
575814,102,102,0,0,0
575831,54,54,0,0,0
575838,137,137,0,0,0
575843,345,345,0,0,0
575864,246,246,0,0,0
575869,353,353,0,0,0
575891,137,137,0,0,0
575892,359,359,0,0,0
575895,7,7,0,0,0
575896,101,101,0,0,0
575910,36,36,0,0,0
575925,313,313,0,0,0
575929,102,102,0,0,0
575939,58,58,0,0,0
575960,65,65,0,0,0
575990,310,310,0,0,0
576035,251,251,0,0,0
576049,281,281,0,0,0
576056,137,137,0,0,0
576073,24,24,0,0,0
576078,402,402,0,0,0
576086,299,299,0,0,0
576089,74,74,0,0,0
576098,193,193,0,0,0
576128,14,14,0,0,0
576148,74,74,0,0,0
576181,85,85,0,0,0
576195,232,232,0,0,0
576204,402,402,0,0,0
576207,345,345,0,0,0
576211,255,255,0,0,0
576216,15,15,0,0,0
576236,345,345,0,0,0
576245,299,299,0,0,0
576258,201,201,0,0,0
576267,63,63,0,0,0
576268,23,23,0,0,0
576289,313,313,0,0,0
576311,184,184,0,0,0
576314,299,299,0,0,0
576315,152,152,0,0,0
576328,131,131,0,0,0
576329,313,313,0,0,0
576331,94,94,0,0,0
576349,131,131,0,0,0
576352,306,306,0,0,0
576371,50,50,0,0,0
576375,70,70,0,0,0
576391,359,359,0,0,0
576410,137,137,0,0,0
576420,232,232,0,0,0
576425,43,43,0,0,0
576431,27,27,0,0,0
576441,255,255,0,0,0
576448,359,359,0,0,0
576460,171,171,0,0,0
576466,151,151,0,0,0
576491,193,193,0,0,0
576497,132,132,0,0,0
576500,158,158,0,0,0
576504,128,128,0,0,0
576521,306,306,0,0,0
576555,299,299,0,0,0
576561,306,306,0,0,0
576593,201,201,0,0,0
576594,168,168,0,0,0
576612,22,22,0,0,0
576624,3,3,0,0,0
576653,282,282,0,0,0
576670,5,5,0,0,0
576685,71,71,0,0,0
576690,299,299,0,0,0
576698,152,152,0,0,0
576711,54,54,0,0,0
576722,171,171,0,0,0
576729,9,9,0,0,0
576748,44,44,0,0,0
576755,402,402,0,0,0
576756,232,232,0,0,0
576757,402,402,0,0,0
576766,94,94,0,0,0
576767,85,85,0,0,0
576793,163,163,0,0,0
576801,246,246,0,0,0
576804,359,359,0,0,0
576840,255,255,0,0,0
576867,76,76,0,0,0
576888,151,151,0,0,0
576901,7,7,0,0,0
576908,180,180,0,0,0
576943,310,310,0,0,0
576948,8,8,0,0,0
576949,282,282,0,0,0
576950,193,193,0,0,0
576970,82,82,0,0,0
576993,114,114,0,0,0
576996,6,6,0,0,0
577008,76,76,0,0,0
577015,315,315,0,0,0
577023,251,251,0,0,0
577027,171,171,0,0,0
577029,121,121,0,0,0
577038,151,151,0,0,0
577040,17,17,0,0,0
577059,198,198,0,0,0
577063,310,310,0,0,0
577077,201,201,0,0,0
577095,168,168,0,0,0
577098,44,44,0,0,0
577100,299,299,0,0,0
577105,114,114,0,0,0
577109,158,158,0,0,0
577123,55,55,0,0,0
577124,44,44,0,0,0
577131,359,359,0,0,0
577138,345,345,0,0,0
577145,44,44,0,0,0
577147,56,56,0,0,0
577161,353,353,0,0,0
577163,9,9,0,0,0
577164,29,29,0,0,0
577174,137,137,0,0,0
577182,10,10,0,0,0
577205,281,281,0,0,0
577218,353,353,0,0,0
577260,113,113,0,0,0
577263,402,402,0,0,0
577266,359,359,0,0,0
577268,232,232,0,0,0
577319,345,345,0,0,0
577331,184,184,0,0,0
577335,359,359,0,0,0
577342,180,180,0,0,0
577344,32,32,0,0,0
577347,13,13,0,0,0
577359,19,19,0,0,0
577376,184,184,0,0,0
577381,3,3,0,0,0
577384,299,299,0,0,0
577399,359,359,0,0,0
577402,103,103,0,0,0
577424,56,56,0,0,0
577431,259,259,0,0,0
577434,315,315,0,0,0
577437,29,29,0,0,0
577440,246,246,0,0,0
577444,137,137,0,0,0
577455,310,310,0,0,0
577458,259,259,0,0,0
577464,299,299,0,0,0
577467,163,163,0,0,0
577477,85,85,0,0,0
577480,55,55,0,0,0
577483,259,259,0,0,0
577488,151,151,0,0,0
577499,70,70,0,0,0
577505,232,232,0,0,0
577521,402,402,0,0,0
577531,5,5,0,0,0
577554,184,184,0,0,0
577560,76,76,0,0,0
577566,313,313,0,0,0
577573,63,63,0,0,0
577587,34,34,0,0,0
577589,198,198,0,0,0
577593,83,83,0,0,0
577631,180,180,0,0,0
577633,282,282,0,0,0
577655,184,184,0,0,0
577664,232,232,0,0,0
577665,50,50,0,0,0
577671,28,28,0,0,0
577693,3,3,0,0,0
577707,163,163,0,0,0
577709,306,306,0,0,0
577716,345,345,0,0,0
577738,103,103,0,0,0
577740,353,353,0,0,0
577741,34,34,0,0,0
577749,32,32,0,0,0
577765,144,144,0,0,0
577771,198,198,0,0,0
577773,3,3,0,0,0
577776,7,7,0,0,0
577777,306,306,0,0,0
577783,353,353,0,0,0
577794,152,152,0,0,0
577798,85,85,0,0,0
577810,6,6,0,0,0
577812,121,121,0,0,0
577822,180,180,0,0,0
577873,359,359,0,0,0
577877,282,282,0,0,0
577880,251,251,0,0,0
577898,180,180,0,0,0
577901,39,39,0,0,0
577908,5,5,0,0,0
577919,102,102,0,0,0
577978,251,251,0,0,0
577986,246,246,0,0,0
577987,30,30,0,0,0
578005,184,184,0,0,0
578018,76,76,0,0,0
578019,310,310,0,0,0
578031,76,76,0,0,0
578039,21,21,0,0,0
578042,281,281,0,0,0
578045,313,313,0,0,0
578054,87,87,0,0,0
578060,282,282,0,0,0
578063,306,306,0,0,0
578068,128,128,0,0,0
578088,282,282,0,0,0
578100,251,251,0,0,0
578119,27,27,0,0,0
578125,353,353,0,0,0
578148,35,35,0,0,0
578160,143,143,0,0,0
578185,44,44,0,0,0
578189,27,27,0,0,0
578195,24,24,0,0,0
578214,36,36,0,0,0
578230,306,306,0,0,0
578251,180,180,0,0,0
578267,163,163,0,0,0
578272,3,3,0,0,0
578276,198,198,0,0,0
578280,69,69,0,0,0
578292,193,193,0,0,0
578293,151,151,0,0,0
578316,313,313,0,0,0
578337,246,246,0,0,0
578358,402,402,0,0,0
578373,306,306,0,0,0
578375,315,315,0,0,0
578379,30,30,0,0,0
578395,246,246,0,0,0
578401,85,85,0,0,0
578407,315,315,0,0,0
578422,56,56,0,0,0
578429,299,299,0,0,0
578433,246,246,0,0,0
578440,259,259,0,0,0
578445,14,14,0,0,0
578446,201,201,0,0,0
578459,12,12,0,0,0
578469,137,137,0,0,0
578475,345,345,0,0,0
578476,94,94,0,0,0
578484,193,193,0,0,0
578486,74,74,0,0,0
578495,63,63,0,0,0
578506,193,193,0,0,0
578509,353,353,0,0,0
578530,30,30,0,0,0
578531,281,281,0,0,0
578552,18,18,0,0,0
578574,8,8,0,0,0
578603,43,43,0,0,0
578606,180,180,0,0,0
578611,353,353,0,0,0
578658,252,252,0,0,0
578675,40,40,0,0,0
578681,13,13,0,0,0
578683,18,18,0,0,0
578689,201,201,0,0,0
578701,77,77,0,0,0
578712,259,259,0,0,0
578727,282,282,0,0,0
578733,252,252,0,0,0
578751,4,4,0,0,0
578762,35,35,0,0,0
578771,171,171,0,0,0
578786,128,128,0,0,0
578791,85,85,0,0,0
578792,282,282,0,0,0
578829,282,282,0,0,0
578842,313,313,0,0,0
578849,281,281,0,0,0
578858,198,198,0,0,0
578879,82,82,0,0,0
578891,114,114,0,0,0
578905,306,306,0,0,0
578908,353,353,0,0,0
578910,54,54,0,0,0
578924,281,281,0,0,0
578948,171,171,0,0,0
578959,36,36,0,0,0
578964,94,94,0,0,0
578968,255,255,0,0,0
578982,83,83,0,0,0
578992,345,345,0,0,0
578993,306,306,0,0,0
579012,56,56,0,0,0
579015,345,345,0,0,0
579024,8,8,0,0,0
579035,144,144,0,0,0
579048,281,281,0,0,0
579067,15,15,0,0,0
579076,299,299,0,0,0
579081,130,130,0,0,0
579105,402,402,0,0,0
579120,201,201,0,0,0
579122,163,163,0,0,0
579159,198,198,0,0,0
579169,310,310,0,0,0
579173,251,251,0,0,0
579174,402,402,0,0,0
579176,34,34,0,0,0
579179,198,198,0,0,0
579186,16,16,0,0,0
579188,44,44,0,0,0
579189,121,121,0,0,0
579191,251,251,0,0,0
579196,144,144,0,0,0
579209,18,18,0,0,0
579220,193,193,0,0,0
579224,144,144,0,0,0
579225,94,94,0,0,0
579232,131,131,0,0,0
579237,74,74,0,0,0
579238,143,143,0,0,0
579248,58,58,0,0,0
579252,255,255,0,0,0
579271,15,15,0,0,0
579272,158,158,0,0,0
579273,180,180,0,0,0
579298,120,120,0,0,0
579313,184,184,0,0,0
579316,76,76,0,0,0
579324,6,6,0,0,0
579334,102,102,0,0,0
579344,74,74,0,0,0
579359,315,315,0,0,0
579372,101,101,0,0,0
579375,246,246,0,0,0
579379,259,259,0,0,0
579389,251,251,0,0,0
579405,359,359,0,0,0
579409,171,171,0,0,0
579416,359,359,0,0,0
579419,39,39,0,0,0
579440,101,101,0,0,0
579446,345,345,0,0,0
579455,56,56,0,0,0
579470,130,130,0,0,0
579475,282,282,0,0,0
579478,193,193,0,0,0
579480,102,102,0,0,0
579493,97,97,0,0,0
579500,18,18,0,0,0
579513,144,144,0,0,0
579515,6,6,0,0,0
579556,130,130,0,0,0
579563,29,29,0,0,0
579568,102,102,0,0,0
579570,30,30,0,0,0
579584,114,114,0,0,0
579586,251,251,0,0,0
579603,97,97,0,0,0
579605,50,50,0,0,0
579611,246,246,0,0,0
579612,201,201,0,0,0
579624,22,22,0,0,0
579653,252,252,0,0,0
579655,281,281,0,0,0
579660,158,158,0,0,0
579662,315,315,0,0,0
579675,402,402,0,0,0
579727,1,1,0,0,0
579746,310,310,0,0,0
579749,6,6,0,0,0
579763,10,10,0,0,0
579792,255,255,0,0,0
579795,5,5,0,0,0
579799,128,128,0,0,0
579806,120,120,0,0,0
579807,281,281,0,0,0
579810,184,184,0,0,0
579836,252,252,0,0,0
579846,171,171,0,0,0
579848,310,310,0,0,0
579849,163,163,0,0,0
579850,7,7,0,0,0
579856,54,54,0,0,0
579858,69,69,0,0,0
579869,198,198,0,0,0
579876,353,353,0,0,0
579895,184,184,0,0,0
579896,29,29,0,0,0
579901,25,25,0,0,0
579904,345,345,0,0,0
579906,252,252,0,0,0
579916,345,345,0,0,0
579959,315,315,0,0,0
579960,167,167,0,0,0
579968,15,15,0,0,0
579978,310,310,0,0,0
579990,102,102,0,0,0
580016,313,313,0,0,0
580023,158,158,0,0,0
580034,144,144,0,0,0
580071,259,259,0,0,0
580085,313,313,0,0,0
580087,151,151,0,0,0
580098,402,402,0,0,0
580113,57,57,0,0,0
580151,163,163,0,0,0
580157,39,39,0,0,0
580176,83,83,0,0,0
580189,198,198,0,0,0
580206,402,402,0,0,0
580225,113,113,0,0,0
580227,310,310,0,0,0
580244,131,131,0,0,0
580248,353,353,0,0,0
580250,85,85,0,0,0
580252,128,128,0,0,0
580264,313,313,0,0,0
580269,402,402,0,0,0
580276,55,55,0,0,0
580292,306,306,0,0,0
580314,70,70,0,0,0
580320,193,193,0,0,0
580324,12,12,0,0,0
580325,345,345,0,0,0
580326,36,36,0,0,0
580372,198,198,0,0,0
580375,353,353,0,0,0
580376,29,29,0,0,0
580380,171,171,0,0,0
580384,102,102,0,0,0
580396,83,83,0,0,0
580416,232,232,0,0,0
580418,143,143,0,0,0
580436,353,353,0,0,0
580445,151,151,0,0,0
580458,255,255,0,0,0
580465,281,281,0,0,0
580476,34,34,0,0,0
580478,102,102,0,0,0
580486,359,359,0,0,0
580500,315,315,0,0,0
580514,251,251,0,0,0
580526,252,252,0,0,0
580528,255,255,0,0,0
580531,151,151,0,0,0
580545,67,67,0,0,0
580548,184,184,0,0,0
580555,345,345,0,0,0
580563,87,87,0,0,0
580583,113,113,0,0,0
580588,102,102,0,0,0
580616,255,255,0,0,0
580617,310,310,0,0,0
580647,114,114,0,0,0
580661,114,114,0,0,0
580663,315,315,0,0,0
580671,313,313,0,0,0
580690,67,67,0,0,0
580693,167,167,0,0,0
580703,12,12,0,0,0
580724,69,69,0,0,0
580734,315,315,0,0,0
580736,121,121,0,0,0
580765,102,102,0,0,0
580770,70,70,0,0,0
580784,70,70,0,0,0
580797,85,85,0,0,0
580802,76,76,0,0,0
580804,102,102,0,0,0
580809,35,35,0,0,0
580817,313,313,0,0,0
580818,353,353,0,0,0
580824,152,152,0,0,0
580838,151,151,0,0,0
580855,5,5,0,0,0
580864,85,85,0,0,0
580883,130,130,0,0,0
580890,102,102,0,0,0
580898,101,101,0,0,0
580901,114,114,0,0,0
580902,120,120,0,0,0
580910,12,12,0,0,0
580919,121,121,0,0,0
580921,281,281,0,0,0
580926,255,255,0,0,0
580935,121,121,0,0,0
580940,20,20,0,0,0
580953,12,12,0,0,0
580955,24,24,0,0,0
580965,359,359,0,0,0
580966,12,12,0,0,0
580968,402,402,0,0,0
581004,313,313,0,0,0
581019,299,299,0,0,0
581037,281,281,0,0,0
581048,58,58,0,0,0
581051,402,402,0,0,0
581064,102,102,0,0,0
581065,232,232,0,0,0
581068,70,70,0,0,0
581069,306,306,0,0,0
581070,75,75,0,0,0
581072,22,22,0,0,0
581073,299,299,0,0,0
581075,353,353,0,0,0
581086,72,72,0,0,0
581111,345,345,0,0,0
581118,345,345,0,0,0
581122,158,158,0,0,0
581134,14,14,0,0,0
581149,11,11,0,0,0
581160,152,152,0,0,0
581186,25,25,0,0,0
581187,171,171,0,0,0
581188,353,353,0,0,0
581198,16,16,0,0,0
581202,359,359,0,0,0
581204,28,28,0,0,0
581205,251,251,0,0,0
581208,121,121,0,0,0
581239,359,359,0,0,0
581263,69,69,0,0,0
581268,313,313,0,0,0
581294,232,232,0,0,0
581320,36,36,0,0,0
581325,15,15,0,0,0
581352,193,193,0,0,0
581353,281,281,0,0,0
581371,74,74,0,0,0
581395,34,34,0,0,0
581399,94,94,0,0,0
581402,353,353,0,0,0
581404,299,299,0,0,0
581430,137,137,0,0,0
581433,34,34,0,0,0
581443,359,359,0,0,0
581446,282,282,0,0,0
581447,102,102,0,0,0
581465,131,131,0,0,0
581466,12,12,0,0,0
581472,69,69,0,0,0
581493,402,402,0,0,0
581501,251,251,0,0,0
581513,315,315,0,0,0
581546,251,251,0,0,0
581548,246,246,0,0,0
581585,281,281,0,0,0
581596,315,315,0,0,0
581612,359,359,0,0,0
581634,28,28,0,0,0
581663,232,232,0,0,0
581667,131,131,0,0,0
581671,313,313,0,0,0
581675,310,310,0,0,0
581698,306,306,0,0,0
581741,44,44,0,0,0
581752,313,313,0,0,0
581758,43,43,0,0,0
581764,315,315,0,0,0
581784,101,101,0,0,0
581789,76,76,0,0,0
581807,151,151,0,0,0
581820,35,35,0,0,0
581823,94,94,0,0,0
581832,151,151,0,0,0
581839,201,201,0,0,0
581852,21,21,0,0,0
581859,56,56,0,0,0
581870,282,282,0,0,0
581887,50,50,0,0,0
581896,402,402,0,0,0
581908,87,87,0,0,0
581913,101,101,0,0,0
581914,15,15,0,0,0
581917,345,345,0,0,0
581931,232,232,0,0,0
581932,12,12,0,0,0
581938,310,310,0,0,0
581957,299,299,0,0,0
581969,281,281,0,0,0
581972,281,281,0,0,0
581979,167,167,0,0,0
581993,30,30,0,0,0
581999,313,313,0,0,0
582000,152,152,0,0,0
582003,36,36,0,0,0
582014,103,103,0,0,0
582017,353,353,0,0,0
582020,345,345,0,0,0
582035,94,94,0,0,0
582038,299,299,0,0,0
582073,299,299,0,0,0
582076,306,306,0,0,0
582083,313,313,0,0,0
582084,198,198,0,0,0
582091,120,120,0,0,0
582101,50,50,0,0,0
582103,353,353,0,0,0
582104,120,120,0,0,0
582107,201,201,0,0,0
582113,113,113,0,0,0
582116,43,43,0,0,0
582128,198,198,0,0,0
582130,56,56,0,0,0
582134,41,41,0,0,0
582138,144,144,0,0,0
582160,151,151,0,0,0
582161,11,11,0,0,0
582173,281,281,0,0,0
582183,315,315,0,0,0
582185,402,402,0,0,0
582234,313,313,0,0,0
582238,1,1,0,0,0
582251,58,58,0,0,0
582273,5,5,0,0,0
582284,198,198,0,0,0
582305,113,113,0,0,0
582337,163,163,0,0,0
582346,246,246,0,0,0
582391,184,184,0,0,0
582399,11,11,0,0,0
582423,130,130,0,0,0
582427,184,184,0,0,0
582464,353,353,0,0,0
582468,121,121,0,0,0
582474,306,306,0,0,0
582475,121,121,0,0,0
582478,1,1,0,0,0
582489,29,29,0,0,0
582499,3,3,0,0,0
582507,345,345,0,0,0
582509,167,167,0,0,0
582519,306,306,0,0,0
582520,252,252,0,0,0
582569,252,252,0,0,0
582585,402,402,0,0,0
582597,74,74,0,0,0
582638,130,130,0,0,0
582644,69,69,0,0,0
582647,144,144,0,0,0
582650,151,151,0,0,0
582654,3,3,0,0,0
582657,246,246,0,0,0
582667,131,131,0,0,0
582668,353,353,0,0,0
582673,306,306,0,0,0
582679,114,114,0,0,0
582724,102,102,0,0,0
582768,130,130,0,0,0
582769,4,4,0,0,0
582779,158,158,0,0,0
582806,402,402,0,0,0
582839,151,151,0,0,0
582841,30,30,0,0,0
582842,76,76,0,0,0
582880,101,101,0,0,0
582885,4,4,0,0,0
582887,76,76,0,0,0
582888,44,44,0,0,0
582895,20,20,0,0,0
582898,313,313,0,0,0
582911,198,198,0,0,0
582919,94,94,0,0,0
582921,310,310,0,0,0
582922,402,402,0,0,0
582936,69,69,0,0,0
582958,94,94,0,0,0
582962,13,13,0,0,0
582965,29,29,0,0,0
582968,70,70,0,0,0
582986,29,29,0,0,0
583003,310,310,0,0,0
583012,201,201,0,0,0
583014,246,246,0,0,0
583016,20,20,0,0,0
583018,353,353,0,0,0
583025,101,101,0,0,0
583037,113,113,0,0,0
583073,137,137,0,0,0
583074,184,184,0,0,0
583094,102,102,0,0,0
583100,201,201,0,0,0
583110,87,87,0,0,0
583126,402,402,0,0,0
583129,12,12,0,0,0
583147,57,57,0,0,0
583170,18,18,0,0,0
583186,15,15,0,0,0
583203,315,315,0,0,0
583205,282,282,0,0,0
583213,201,201,0,0,0
583218,353,353,0,0,0
583229,255,255,0,0,0
583243,23,23,0,0,0
583250,13,13,0,0,0
583262,101,101,0,0,0
583268,198,198,0,0,0
583271,313,313,0,0,0
583275,315,315,0,0,0
583278,45,45,0,0,0
583318,201,201,0,0,0
583324,313,313,0,0,0
583326,10,10,0,0,0
583327,281,281,0,0,0
583338,1,1,0,0,0
583351,56,56,0,0,0
583360,184,184,0,0,0
583367,201,201,0,0,0
583372,35,35,0,0,0
583374,259,259,0,0,0
583388,151,151,0,0,0
583393,151,151,0,0,0
583401,57,57,0,0,0
583410,8,8,0,0,0
583416,193,193,0,0,0
583441,137,137,0,0,0
583446,77,77,0,0,0
583453,171,171,0,0,0
583464,299,299,0,0,0
583470,353,353,0,0,0
583480,163,163,0,0,0
583500,167,167,0,0,0
583515,306,306,0,0,0
583544,151,151,0,0,0
583546,20,20,0,0,0
583549,198,198,0,0,0
583572,281,281,0,0,0
583580,130,130,0,0,0
583585,359,359,0,0,0
583589,315,315,0,0,0
583603,102,102,0,0,0
583613,128,128,0,0,0
583615,151,151,0,0,0
583618,71,71,0,0,0
583620,402,402,0,0,0
583625,29,29,0,0,0
583627,353,353,0,0,0
583637,114,114,0,0,0
583641,74,74,0,0,0
583645,45,45,0,0,0
583648,87,87,0,0,0
583663,10,10,0,0,0
583665,131,131,0,0,0
583669,102,102,0,0,0
583673,251,251,0,0,0
583675,18,18,0,0,0
583678,345,345,0,0,0
583685,315,315,0,0,0
583691,17,17,0,0,0
583703,133,133,0,0,0
583721,76,76,0,0,0
583735,353,353,0,0,0
583755,259,259,0,0,0
583761,163,163,0,0,0
583771,198,198,0,0,0
583782,201,201,0,0,0
583793,198,198,0,0,0
583810,10,10,0,0,0
583813,310,310,0,0,0
583826,102,102,0,0,0
583828,15,15,0,0,0
583861,20,20,0,0,0
583870,55,55,0,0,0
583873,20,20,0,0,0
583877,17,17,0,0,0
583907,282,282,0,0,0
583922,167,167,0,0,0
583924,255,255,0,0,0
583929,56,56,0,0,0
583944,251,251,0,0,0
583961,306,306,0,0,0
583964,315,315,0,0,0
583965,402,402,0,0,0
583984,128,128,0,0,0
583988,359,359,0,0,0
584012,45,45,0,0,0
584028,193,193,0,0,0
584035,66,66,0,0,0
584055,359,359,0,0,0
584087,9,9,0,0,0
584098,18,18,0,0,0
584105,402,402,0,0,0
584106,359,359,0,0,0
584107,251,251,0,0,0
584134,299,299,0,0,0
584155,193,193,0,0,0
584156,113,113,0,0,0
584162,359,359,0,0,0
584184,246,246,0,0,0
584192,282,282,0,0,0
584201,77,77,0,0,0
584203,158,158,0,0,0
584215,56,56,0,0,0
584218,74,74,0,0,0
584219,299,299,0,0,0
584222,83,83,0,0,0
584225,171,171,0,0,0
584230,402,402,0,0,0
584238,193,193,0,0,0
584263,359,359,0,0,0
584270,94,94,0,0,0
584279,180,180,0,0,0
584296,76,76,0,0,0
584333,151,151,0,0,0
584335,310,310,0,0,0
584336,65,65,0,0,0
584354,152,152,0,0,0
584356,43,43,0,0,0
584360,74,74,0,0,0
584361,315,315,0,0,0
584366,114,114,0,0,0
584374,167,167,0,0,0
584387,306,306,0,0,0
584408,315,315,0,0,0
584438,144,144,0,0,0
584439,76,76,0,0,0
584440,184,184,0,0,0
584459,76,76,0,0,0
584463,102,102,0,0,0
584467,39,39,0,0,0
584474,158,158,0,0,0
584477,345,345,0,0,0
584505,184,184,0,0,0
584509,353,353,0,0,0
584527,131,131,0,0,0
584535,306,306,0,0,0
584540,281,281,0,0,0
584551,121,121,0,0,0
584557,71,71,0,0,0
584561,121,121,0,0,0
584569,232,232,0,0,0
584579,10,10,0,0,0
584588,180,180,0,0,0
584596,201,201,0,0,0
584598,198,198,0,0,0
584601,180,180,0,0,0
584635,282,282,0,0,0
584666,402,402,0,0,0
584684,310,310,0,0,0
584685,113,113,0,0,0
584716,77,77,0,0,0
584720,255,255,0,0,0
584722,315,315,0,0,0
584731,65,65,0,0,0
584734,74,74,0,0,0
584754,259,259,0,0,0
584761,232,232,0,0,0
584768,310,310,0,0,0
584777,137,137,0,0,0
584791,313,313,0,0,0
584798,28,28,0,0,0
584806,158,158,0,0,0
584810,310,310,0,0,0
584815,17,17,0,0,0
584817,299,299,0,0,0
584829,20,20,0,0,0
584838,17,17,0,0,0
584848,345,345,0,0,0
584855,310,310,0,0,0
584879,345,345,0,0,0
584881,1,1,0,0,0
584883,232,232,0,0,0
584898,299,299,0,0,0
584899,30,30,0,0,0
584903,315,315,0,0,0
584918,310,310,0,0,0
584924,76,76,0,0,0
584925,101,101,0,0,0
584934,103,103,0,0,0
584954,22,22,0,0,0
584955,353,353,0,0,0
584957,67,67,0,0,0
584964,246,246,0,0,0
584978,313,313,0,0,0
585004,12,12,0,0,0
585021,56,56,0,0,0
585029,25,25,0,0,0
585038,402,402,0,0,0
585048,75,75,0,0,0
585055,402,402,0,0,0
585077,103,103,0,0,0
585107,22,22,0,0,0
585115,143,143,0,0,0
585125,132,132,0,0,0
585133,158,158,0,0,0
585151,8,8,0,0,0
585166,10,10,0,0,0
585172,246,246,0,0,0
585174,20,20,0,0,0
585218,315,315,0,0,0
585235,353,353,0,0,0
585239,151,151,0,0,0
585243,310,310,0,0,0
585259,13,13,0,0,0
585271,281,281,0,0,0
585282,35,35,0,0,0
585298,11,11,0,0,0
585300,18,18,0,0,0
585304,151,151,0,0,0
585321,246,246,0,0,0
585336,20,20,0,0,0
585357,50,50,0,0,0
585358,299,299,0,0,0
585360,359,359,0,0,0
585389,75,75,0,0,0
585392,402,402,0,0,0
585412,259,259,0,0,0
585436,114,114,0,0,0
585442,281,281,0,0,0
585443,315,315,0,0,0
585453,87,87,0,0,0
585479,133,133,0,0,0
585485,8,8,0,0,0
585495,114,114,0,0,0
585512,102,102,0,0,0
585522,171,171,0,0,0
585526,193,193,0,0,0
585528,85,85,0,0,0
585529,143,143,0,0,0
585549,19,19,0,0,0
585560,102,102,0,0,0
585562,18,18,0,0,0
585584,180,180,0,0,0
585594,152,152,0,0,0
585680,402,402,0,0,0
585689,39,39,0,0,0
585694,102,102,0,0,0
585701,259,259,0,0,0
585706,168,168,0,0,0
585710,8,8,0,0,0
585746,313,313,0,0,0
585752,167,167,0,0,0
585754,359,359,0,0,0
585755,35,35,0,0,0
585767,313,313,0,0,0
585777,101,101,0,0,0
585789,18,18,0,0,0
585791,313,313,0,0,0
585793,310,310,0,0,0
585811,97,97,0,0,0
585817,281,281,0,0,0
585826,198,198,0,0,0
585839,306,306,0,0,0
585846,353,353,0,0,0
585851,310,310,0,0,0
585853,113,113,0,0,0
585855,15,15,0,0,0
585859,252,252,0,0,0
585883,137,137,0,0,0
585891,151,151,0,0,0
585895,152,152,0,0,0
585919,103,103,0,0,0
585920,345,345,0,0,0
585928,252,252,0,0,0
585939,137,137,0,0,0
585960,180,180,0,0,0
585967,184,184,0,0,0
585975,359,359,0,0,0
585980,83,83,0,0,0
585986,281,281,0,0,0
585990,131,131,0,0,0
585997,8,8,0,0,0
585998,74,74,0,0,0
586002,299,299,0,0,0
586014,252,252,0,0,0
586017,313,313,0,0,0
586034,151,151,0,0,0
586046,16,16,0,0,0
586054,75,75,0,0,0
586090,402,402,0,0,0
586105,251,251,0,0,0
586106,345,345,0,0,0
586117,168,168,0,0,0
586128,259,259,0,0,0
586130,101,101,0,0,0
586137,16,16,0,0,0
586156,35,35,0,0,0
586160,1,1,0,0,0
586176,259,259,0,0,0
586188,180,180,0,0,0
586204,359,359,0,0,0
586205,359,359,0,0,0
586221,252,252,0,0,0
586225,70,70,0,0,0
586230,299,299,0,0,0
586237,71,71,0,0,0
586244,163,163,0,0,0
586256,345,345,0,0,0
586269,11,11,0,0,0
586270,315,315,0,0,0
586303,310,310,0,0,0
586311,281,281,0,0,0
586314,114,114,0,0,0
586341,315,315,0,0,0
586345,19,19,0,0,0
586372,12,12,0,0,0
586380,232,232,0,0,0
586388,310,310,0,0,0
586392,14,14,0,0,0
586397,29,29,0,0,0
586411,299,299,0,0,0
586439,19,19,0,0,0
586457,359,359,0,0,0
586458,102,102,0,0,0
586460,306,306,0,0,0
586461,359,359,0,0,0
586487,402,402,0,0,0
586499,9,9,0,0,0
586514,41,41,0,0,0
586520,102,102,0,0,0
586530,167,167,0,0,0
586546,151,151,0,0,0
586552,131,131,0,0,0
586568,232,232,0,0,0
586569,152,152,0,0,0
586604,315,315,0,0,0
586613,251,251,0,0,0
586614,27,27,0,0,0
586630,353,353,0,0,0
586644,1,1,0,0,0
586645,18,18,0,0,0
586667,7,7,0,0,0
586669,87,87,0,0,0
586670,10,10,0,0,0
586672,55,55,0,0,0
586680,259,259,0,0,0
586719,353,353,0,0,0
586721,13,13,0,0,0
586725,44,44,0,0,0
586728,102,102,0,0,0
586729,168,168,0,0,0
586760,345,345,0,0,0
586763,85,85,0,0,0
586780,137,137,0,0,0
586786,310,310,0,0,0
586795,137,137,0,0,0
586804,133,133,0,0,0
586805,251,251,0,0,0
586811,246,246,0,0,0
586816,353,353,0,0,0
586837,158,158,0,0,0
586846,151,151,0,0,0
586860,66,66,0,0,0
586864,22,22,0,0,0
586871,130,130,0,0,0
586873,359,359,0,0,0
586874,13,13,0,0,0
586882,50,50,0,0,0
586906,193,193,0,0,0
586908,315,315,0,0,0
586953,3,3,0,0,0
586956,8,8,0,0,0
586963,306,306,0,0,0
586977,76,76,0,0,0
586982,57,57,0,0,0
586986,20,20,0,0,0
587003,101,101,0,0,0
587005,151,151,0,0,0
587025,168,168,0,0,0
587057,121,121,0,0,0
587063,310,310,0,0,0
587064,345,345,0,0,0
587075,85,85,0,0,0
587093,167,167,0,0,0
587098,193,193,0,0,0
587104,63,63,0,0,0
587109,167,167,0,0,0
587141,44,44,0,0,0
587150,144,144,0,0,0
587182,16,16,0,0,0
587185,345,345,0,0,0
587189,34,34,0,0,0
587199,171,171,0,0,0
587212,167,167,0,0,0
587241,57,57,0,0,0
587242,87,87,0,0,0
587243,102,102,0,0,0
587289,6,6,0,0,0
587310,315,315,0,0,0
587313,306,306,0,0,0
587315,255,255,0,0,0
587316,5,5,0,0,0
587323,121,121,0,0,0
587344,121,121,0,0,0
587351,87,87,0,0,0
587393,15,15,0,0,0
587398,18,18,0,0,0
587409,359,359,0,0,0
587414,184,184,0,0,0
587472,103,103,0,0,0
587474,43,43,0,0,0
587475,102,102,0,0,0
587481,130,130,0,0,0
587483,11,11,0,0,0
587485,402,402,0,0,0
587505,310,310,0,0,0
587512,102,102,0,0,0
587513,82,82,0,0,0
587518,345,345,0,0,0
587523,7,7,0,0,0
587534,121,121,0,0,0
587554,310,310,0,0,0
587555,3,3,0,0,0
587583,2,2,0,0,0
587597,251,251,0,0,0
587622,97,97,0,0,0
587624,14,14,0,0,0
587634,113,113,0,0,0
587640,306,306,0,0,0
587649,74,74,0,0,0
587660,65,65,0,0,0
587668,313,313,0,0,0
587670,56,56,0,0,0
587672,76,76,0,0,0
587695,10,10,0,0,0
587697,313,313,0,0,0
587713,70,70,0,0,0
587731,103,103,0,0,0
587734,310,310,0,0,0
587747,30,30,0,0,0
587755,22,22,0,0,0
587757,310,310,0,0,0
587763,251,251,0,0,0
587772,402,402,0,0,0
587775,113,113,0,0,0
587777,255,255,0,0,0
587812,246,246,0,0,0
587821,94,94,0,0,0
587828,85,85,0,0,0
587854,402,402,0,0,0
587856,281,281,0,0,0
587858,13,13,0,0,0
587865,193,193,0,0,0
587872,152,152,0,0,0
587890,310,310,0,0,0
587900,310,310,0,0,0
587910,402,402,0,0,0
587920,25,25,0,0,0
587933,120,120,0,0,0
587939,13,13,0,0,0
587974,74,74,0,0,0
587983,232,232,0,0,0
587987,251,251,0,0,0
587989,76,76,0,0,0
588024,201,201,0,0,0
588043,282,282,0,0,0
588057,180,180,0,0,0
588060,180,180,0,0,0
588075,121,121,0,0,0
588103,132,132,0,0,0
588108,25,25,0,0,0
588110,12,12,0,0,0
588129,66,66,0,0,0
588133,281,281,0,0,0
588137,315,315,0,0,0
588152,158,158,0,0,0
588174,345,345,0,0,0
588189,4,4,0,0,0
588190,252,252,0,0,0
588192,54,54,0,0,0
588224,19,19,0,0,0
588230,255,255,0,0,0
588233,402,402,0,0,0
588239,5,5,0,0,0
588261,24,24,0,0,0
588267,402,402,0,0,0
588276,345,345,0,0,0
588291,306,306,0,0,0
588333,282,282,0,0,0
588342,198,198,0,0,0
588348,94,94,0,0,0
588364,6,6,0,0,0
588365,201,201,0,0,0
588376,310,310,0,0,0
588383,306,306,0,0,0
588394,151,151,0,0,0
588398,281,281,0,0,0
588414,131,131,0,0,0
588416,359,359,0,0,0
588421,313,313,0,0,0
588428,255,255,0,0,0
588463,50,50,0,0,0
588471,152,152,0,0,0
588489,281,281,0,0,0
588490,8,8,0,0,0
588510,282,282,0,0,0
588511,16,16,0,0,0
588512,11,11,0,0,0
588531,94,94,0,0,0
588534,158,158,0,0,0
588545,299,299,0,0,0
588550,137,137,0,0,0
588565,184,184,0,0,0
588572,20,20,0,0,0
588585,232,232,0,0,0
588601,353,353,0,0,0
588616,1,1,0,0,0
588618,306,306,0,0,0
588626,193,193,0,0,0
588640,137,137,0,0,0
588658,120,120,0,0,0
588670,152,152,0,0,0
588680,44,44,0,0,0
588681,114,114,0,0,0
588691,259,259,0,0,0
588700,259,259,0,0,0
588730,36,36,0,0,0
588732,402,402,0,0,0
588735,24,24,0,0,0
588737,315,315,0,0,0
588738,39,39,0,0,0
588746,128,128,0,0,0
588748,113,113,0,0,0
588755,306,306,0,0,0
588784,3,3,0,0,0
588799,246,246,0,0,0
588801,85,85,0,0,0
588822,25,25,0,0,0
588827,151,151,0,0,0
588831,232,232,0,0,0
588835,65,65,0,0,0
588848,313,313,0,0,0
588870,103,103,0,0,0
588873,299,299,0,0,0
588877,171,171,0,0,0
588878,113,113,0,0,0
588892,5,5,0,0,0
588907,359,359,0,0,0
588910,402,402,0,0,0
588928,306,306,0,0,0
588929,28,28,0,0,0
588946,193,193,0,0,0
588973,6,6,0,0,0
588974,39,39,0,0,0
588996,65,65,0,0,0
588999,310,310,0,0,0
589000,232,232,0,0,0
589001,75,75,0,0,0
589011,7,7,0,0,0
589030,1,1,0,0,0
589035,54,54,0,0,0
589045,74,74,0,0,0
589059,17,17,0,0,0
589067,313,313,0,0,0
589090,3,3,0,0,0
589095,315,315,0,0,0
589096,102,102,0,0,0
589114,171,171,0,0,0
589126,315,315,0,0,0
589145,132,132,0,0,0
589147,57,57,0,0,0
589157,85,85,0,0,0
589161,12,12,0,0,0
589163,306,306,0,0,0
589175,353,353,0,0,0
589228,144,144,0,0,0
589232,252,252,0,0,0
589238,315,315,0,0,0
589240,359,359,0,0,0
589256,137,137,0,0,0
589262,77,77,0,0,0
589275,8,8,0,0,0
589297,30,30,0,0,0
589303,315,315,0,0,0
589313,102,102,0,0,0
589350,43,43,0,0,0
589352,310,310,0,0,0
589403,114,114,0,0,0
589429,402,402,0,0,0
589455,402,402,0,0,0
589473,193,193,0,0,0
589476,11,11,0,0,0
589478,259,259,0,0,0
589485,3,3,0,0,0
589491,282,282,0,0,0
589500,353,353,0,0,0
589504,198,198,0,0,0
589526,151,151,0,0,0
589533,29,29,0,0,0
589534,315,315,0,0,0
589536,315,315,0,0,0
589553,345,345,0,0,0
589559,87,87,0,0,0
589570,76,76,0,0,0
589582,133,133,0,0,0
589583,11,11,0,0,0
589595,128,128,0,0,0
589597,259,259,0,0,0
589609,306,306,0,0,0
589624,299,299,0,0,0
589643,67,67,0,0,0
589656,137,137,0,0,0
589661,259,259,0,0,0
589663,359,359,0,0,0
589670,310,310,0,0,0
589681,87,87,0,0,0
589691,20,20,0,0,0
589699,102,102,0,0,0
589704,102,102,0,0,0
589714,251,251,0,0,0
589721,83,83,0,0,0
589725,402,402,0,0,0
589745,310,310,0,0,0
589756,87,87,0,0,0
589767,402,402,0,0,0
589783,299,299,0,0,0
589797,29,29,0,0,0
589810,143,143,0,0,0
589814,113,113,0,0,0
589818,252,252,0,0,0
589834,25,25,0,0,0
589835,102,102,0,0,0
589837,345,345,0,0,0
589846,232,232,0,0,0
589851,144,144,0,0,0
589866,40,40,0,0,0
589881,193,193,0,0,0
589889,36,36,0,0,0
589901,193,193,0,0,0
589905,121,121,0,0,0
589906,246,246,0,0,0
589915,130,130,0,0,0
589917,359,359,0,0,0
589918,55,55,0,0,0
589943,17,17,0,0,0
589945,94,94,0,0,0
589952,259,259,0,0,0
589956,137,137,0,0,0
589966,128,128,0,0,0
589967,259,259,0,0,0
589973,6,6,0,0,0
589975,76,76,0,0,0
589979,152,152,0,0,0
589981,198,198,0,0,0
589983,151,151,0,0,0
590000,101,101,0,0,0
590035,171,171,0,0,0
590037,8,8,0,0,0
590044,353,353,0,0,0
590062,70,70,0,0,0
590087,281,281,0,0,0
590101,313,313,0,0,0
590105,232,232,0,0,0
590111,29,29,0,0,0
590120,55,55,0,0,0
590175,193,193,0,0,0
590180,16,16,0,0,0
590197,36,36,0,0,0
590202,34,34,0,0,0
590205,193,193,0,0,0
590212,201,201,0,0,0
590223,18,18,0,0,0
590236,131,131,0,0,0
590265,120,120,0,0,0
590295,94,94,0,0,0
590329,171,171,0,0,0
590331,34,34,0,0,0
590337,102,102,0,0,0
590345,54,54,0,0,0
590351,252,252,0,0,0
590365,102,102,0,0,0
590389,353,353,0,0,0
590393,180,180,0,0,0
590396,65,65,0,0,0
590397,74,74,0,0,0
590400,9,9,0,0,0
590427,252,252,0,0,0
590428,74,74,0,0,0
590444,114,114,0,0,0
590472,9,9,0,0,0
590474,201,201,0,0,0
590493,74,74,0,0,0
590503,255,255,0,0,0
590506,255,255,0,0,0
590508,201,201,0,0,0
590511,94,94,0,0,0
590514,67,67,0,0,0
590520,114,114,0,0,0
590527,345,345,0,0,0
590536,184,184,0,0,0
590578,171,171,0,0,0
590583,259,259,0,0,0
590589,50,50,0,0,0
590615,43,43,0,0,0
590616,132,132,0,0,0
590620,12,12,0,0,0
590621,120,120,0,0,0
590642,74,74,0,0,0
590653,17,17,0,0,0
590686,18,18,0,0,0
590695,19,19,0,0,0
590710,193,193,0,0,0
590714,353,353,0,0,0
590721,259,259,0,0,0
590729,359,359,0,0,0
590732,63,63,0,0,0
590741,34,34,0,0,0
590743,171,171,0,0,0
590744,32,32,0,0,0
590749,359,359,0,0,0
590768,40,40,0,0,0
590776,198,198,0,0,0
590813,152,152,0,0,0
590820,310,310,0,0,0
590826,130,130,0,0,0
590828,56,56,0,0,0
590832,102,102,0,0,0
590854,152,152,0,0,0
590858,152,152,0,0,0
590863,113,113,0,0,0
590871,70,70,0,0,0
590876,87,87,0,0,0
590890,252,252,0,0,0
590944,121,121,0,0,0
590952,299,299,0,0,0
590970,19,19,0,0,0
590973,259,259,0,0,0
590975,281,281,0,0,0
590994,201,201,0,0,0
590999,359,359,0,0,0
591003,281,281,0,0,0
591009,259,259,0,0,0
591063,56,56,0,0,0
591083,345,345,0,0,0
591104,168,168,0,0,0
591107,144,144,0,0,0
591120,133,133,0,0,0
591125,74,74,0,0,0
591128,25,25,0,0,0
591143,45,45,0,0,0
591164,281,281,0,0,0
591172,313,313,0,0,0
591188,151,151,0,0,0
591210,315,315,0,0,0
591214,252,252,0,0,0
591217,402,402,0,0,0
591222,114,114,0,0,0
591245,5,5,0,0,0
591252,12,12,0,0,0
591270,13,13,0,0,0
591273,310,310,0,0,0
591278,54,54,0,0,0
591279,97,97,0,0,0
591291,306,306,0,0,0
591294,34,34,0,0,0
591298,167,167,0,0,0
591301,152,152,0,0,0
591303,130,130,0,0,0
591305,16,16,0,0,0
591379,18,18,0,0,0
591390,251,251,0,0,0
591395,27,27,0,0,0
591398,56,56,0,0,0
591407,252,252,0,0,0
591409,282,282,0,0,0
591432,131,131,0,0,0
591435,345,345,0,0,0
591436,10,10,0,0,0
591438,299,299,0,0,0
591446,402,402,0,0,0
591454,282,282,0,0,0
591487,198,198,0,0,0
591501,76,76,0,0,0
591507,4,4,0,0,0
591514,65,65,0,0,0
591515,158,158,0,0,0
591524,34,34,0,0,0
591538,19,19,0,0,0
591543,137,137,0,0,0
591558,313,313,0,0,0
591567,6,6,0,0,0
591572,36,36,0,0,0
591582,36,36,0,0,0
591600,41,41,0,0,0
591627,198,198,0,0,0
591646,77,77,0,0,0
591653,281,281,0,0,0
591657,44,44,0,0,0
591658,232,232,0,0,0
591673,232,232,0,0,0
591700,44,44,0,0,0
591711,282,282,0,0,0
591725,246,246,0,0,0
591733,359,359,0,0,0
591734,41,41,0,0,0
591744,201,201,0,0,0
591753,16,16,0,0,0
591768,77,77,0,0,0
591792,299,299,0,0,0
591807,50,50,0,0,0
591824,70,70,0,0,0
591829,171,171,0,0,0
591851,121,121,0,0,0
591856,168,168,0,0,0
591857,97,97,0,0,0
591872,282,282,0,0,0
591873,8,8,0,0,0
591875,193,193,0,0,0
591877,10,10,0,0,0
591886,345,345,0,0,0
591890,201,201,0,0,0
591893,44,44,0,0,0
591904,113,113,0,0,0
591908,359,359,0,0,0
591910,315,315,0,0,0
591924,13,13,0,0,0
591930,130,130,0,0,0
591937,76,76,0,0,0
591950,193,193,0,0,0
591982,113,113,0,0,0
591997,168,168,0,0,0
592011,281,281,0,0,0
592024,345,345,0,0,0
592034,103,103,0,0,0
592047,163,163,0,0,0
592056,232,232,0,0,0
592063,345,345,0,0,0
592064,76,76,0,0,0
592078,15,15,0,0,0
592079,252,252,0,0,0
592091,193,193,0,0,0
592095,201,201,0,0,0
592097,402,402,0,0,0
592104,359,359,0,0,0
592105,167,167,0,0,0
592127,232,232,0,0,0
592131,359,359,0,0,0
592138,128,128,0,0,0
592143,35,35,0,0,0
592165,22,22,0,0,0
592168,281,281,0,0,0
592177,87,87,0,0,0
592189,255,255,0,0,0
592194,120,120,0,0,0
592199,20,20,0,0,0
592210,158,158,0,0,0
592219,132,132,0,0,0
592220,310,310,0,0,0
592247,10,10,0,0,0
592250,36,36,0,0,0
592264,76,76,0,0,0
592275,313,313,0,0,0
592284,7,7,0,0,0
592286,310,310,0,0,0
592295,25,25,0,0,0
592306,130,130,0,0,0
592310,34,34,0,0,0
592318,402,402,0,0,0
592328,22,22,0,0,0
592339,151,151,0,0,0
592344,359,359,0,0,0
592347,345,345,0,0,0
592348,255,255,0,0,0
592350,345,345,0,0,0
592365,252,252,0,0,0
592371,167,167,0,0,0
592375,7,7,0,0,0
592382,94,94,0,0,0
592392,201,201,0,0,0
592393,251,251,0,0,0
592402,137,137,0,0,0
592406,306,306,0,0,0
592418,353,353,0,0,0
592419,10,10,0,0,0
592420,43,43,0,0,0
592427,180,180,0,0,0
592431,402,402,0,0,0
592432,353,353,0,0,0
592451,27,27,0,0,0
592464,12,12,0,0,0
592476,232,232,0,0,0
592496,353,353,0,0,0
592498,28,28,0,0,0
592502,18,18,0,0,0
592504,74,74,0,0,0
592531,259,259,0,0,0
592549,167,167,0,0,0
592558,184,184,0,0,0
592566,56,56,0,0,0
592575,282,282,0,0,0
592582,184,184,0,0,0
592589,74,74,0,0,0
592594,345,345,0,0,0
592597,184,184,0,0,0
592637,310,310,0,0,0
592654,102,102,0,0,0
592666,114,114,0,0,0
592669,168,168,0,0,0
592688,255,255,0,0,0
592690,168,168,0,0,0
592710,130,130,0,0,0
592737,232,232,0,0,0
592773,120,120,0,0,0
592776,114,114,0,0,0
592780,353,353,0,0,0
592781,251,251,0,0,0
592783,130,130,0,0,0
592785,359,359,0,0,0
592786,113,113,0,0,0
592794,315,315,0,0,0
592805,232,232,0,0,0
592811,167,167,0,0,0
592835,163,163,0,0,0
592849,2,2,0,0,0
592861,282,282,0,0,0
592870,402,402,0,0,0
592875,163,163,0,0,0
592885,255,255,0,0,0
592891,76,76,0,0,0
592897,232,232,0,0,0
592902,151,151,0,0,0
592910,402,402,0,0,0
592927,25,25,0,0,0
592930,121,121,0,0,0
592944,232,232,0,0,0
592958,144,144,0,0,0
592964,3,3,0,0,0
592973,259,259,0,0,0
592980,113,113,0,0,0
592982,27,27,0,0,0
593000,16,16,0,0,0
593014,14,14,0,0,0
593030,282,282,0,0,0
593032,133,133,0,0,0
593054,168,168,0,0,0
593060,299,299,0,0,0
593074,74,74,0,0,0
593080,22,22,0,0,0
593082,15,15,0,0,0
593094,299,299,0,0,0
593117,9,9,0,0,0
593122,345,345,0,0,0
593144,34,34,0,0,0
593176,232,232,0,0,0
593195,252,252,0,0,0
593198,251,251,0,0,0
593217,259,259,0,0,0
593230,281,281,0,0,0
593245,144,144,0,0,0
593268,6,6,0,0,0
593277,121,121,0,0,0
593284,3,3,0,0,0
593286,345,345,0,0,0
593289,133,133,0,0,0
593311,2,2,0,0,0
593313,359,359,0,0,0
593318,259,259,0,0,0
593334,3,3,0,0,0
593339,2,2,0,0,0
593342,137,137,0,0,0
593352,76,76,0,0,0
593358,353,353,0,0,0
593359,198,198,0,0,0
593386,13,13,0,0,0
593390,306,306,0,0,0
593413,12,12,0,0,0
593428,44,44,0,0,0
593443,35,35,0,0,0
593451,114,114,0,0,0
593454,114,114,0,0,0
593456,22,22,0,0,0
593479,97,97,0,0,0
593482,35,35,0,0,0
593498,198,198,0,0,0
593503,15,15,0,0,0
593508,282,282,0,0,0
593509,310,310,0,0,0
593511,193,193,0,0,0
593516,69,69,0,0,0
593539,16,16,0,0,0
593555,15,15,0,0,0
593557,102,102,0,0,0
593616,359,359,0,0,0
593622,137,137,0,0,0
593649,359,359,0,0,0
593665,201,201,0,0,0
593670,44,44,0,0,0
593673,359,359,0,0,0
593679,282,282,0,0,0
593680,315,315,0,0,0
593686,121,121,0,0,0
593692,152,152,0,0,0
593723,10,10,0,0,0
593729,359,359,0,0,0
593755,76,76,0,0,0
593759,66,66,0,0,0
593780,353,353,0,0,0
593782,353,353,0,0,0
593783,114,114,0,0,0
593787,34,34,0,0,0
593790,3,3,0,0,0
593795,168,168,0,0,0
593799,306,306,0,0,0
593815,255,255,0,0,0
593821,76,76,0,0,0
593822,27,27,0,0,0
593833,131,131,0,0,0
593841,246,246,0,0,0
593847,10,10,0,0,0
593848,69,69,0,0,0
593855,313,313,0,0,0
593865,102,102,0,0,0
593868,22,22,0,0,0
593899,310,310,0,0,0
593904,402,402,0,0,0
593910,131,131,0,0,0
593921,151,151,0,0,0
593923,299,299,0,0,0
593926,402,402,0,0,0
593936,167,167,0,0,0
593949,23,23,0,0,0
593969,74,74,0,0,0
593972,281,281,0,0,0
593974,198,198,0,0,0
593990,353,353,0,0,0
593994,97,97,0,0,0
593995,87,87,0,0,0
594007,71,71,0,0,0
594038,359,359,0,0,0
594042,71,71,0,0,0
594048,198,198,0,0,0
594051,128,128,0,0,0
594060,171,171,0,0,0
594077,39,39,0,0,0
594078,281,281,0,0,0
594085,313,313,0,0,0
594100,299,299,0,0,0
594110,198,198,0,0,0
594112,143,143,0,0,0
594117,12,12,0,0,0
594133,19,19,0,0,0
594138,201,201,0,0,0
594151,77,77,0,0,0
594159,43,43,0,0,0
594163,63,63,0,0,0
594179,193,193,0,0,0
594194,39,39,0,0,0
594196,306,306,0,0,0
594206,43,43,0,0,0
594215,128,128,0,0,0
594218,281,281,0,0,0
594229,22,22,0,0,0
594243,299,299,0,0,0
594248,255,255,0,0,0
594250,144,144,0,0,0
594265,137,137,0,0,0
594273,18,18,0,0,0
594275,359,359,0,0,0
594280,76,76,0,0,0
594283,121,121,0,0,0
594289,198,198,0,0,0
594291,102,102,0,0,0
594295,402,402,0,0,0
594296,34,34,0,0,0
594305,102,102,0,0,0
594306,36,36,0,0,0
594313,252,252,0,0,0
594320,282,282,0,0,0
594323,102,102,0,0,0
594330,144,144,0,0,0
594334,359,359,0,0,0
594356,299,299,0,0,0
594357,57,57,0,0,0
594368,121,121,0,0,0
594371,74,74,0,0,0
594378,74,74,0,0,0
594380,299,299,0,0,0
594390,43,43,0,0,0
594408,310,310,0,0,0
594433,246,246,0,0,0
594448,2,2,0,0,0
594475,3,3,0,0,0
594501,76,76,0,0,0
594513,143,143,0,0,0
594529,120,120,0,0,0
594541,163,163,0,0,0
594542,353,353,0,0,0
594544,282,282,0,0,0
594563,44,44,0,0,0
594606,18,18,0,0,0
594607,252,252,0,0,0
594611,101,101,0,0,0
594613,43,43,0,0,0
594634,102,102,0,0,0
594641,137,137,0,0,0
594648,232,232,0,0,0
594664,198,198,0,0,0
594679,65,65,0,0,0
594681,310,310,0,0,0
594697,246,246,0,0,0
594721,30,30,0,0,0
594743,359,359,0,0,0
594746,252,252,0,0,0
594750,252,252,0,0,0
594753,94,94,0,0,0
594758,198,198,0,0,0
594759,184,184,0,0,0
594781,193,193,0,0,0
594786,232,232,0,0,0
594795,282,282,0,0,0
594796,114,114,0,0,0
594805,16,16,0,0,0
594822,18,18,0,0,0
594823,353,353,0,0,0
594827,246,246,0,0,0
594841,353,353,0,0,0
594862,252,252,0,0,0
594864,353,353,0,0,0
594870,121,121,0,0,0
594883,85,85,0,0,0
594885,32,32,0,0,0
594897,35,35,0,0,0
594905,246,246,0,0,0
594906,121,121,0,0,0
594907,180,180,0,0,0
594919,76,76,0,0,0
594929,402,402,0,0,0
594966,184,184,0,0,0
594988,7,7,0,0,0
594989,41,41,0,0,0
594993,310,310,0,0,0
595011,20,20,0,0,0
595013,251,251,0,0,0
595025,359,359,0,0,0
595026,198,198,0,0,0
595029,232,232,0,0,0
595050,201,201,0,0,0
595070,180,180,0,0,0
595095,282,282,0,0,0
595099,10,10,0,0,0
595111,402,402,0,0,0
595149,128,128,0,0,0
595150,163,163,0,0,0
595152,167,167,0,0,0
595153,167,167,0,0,0
595159,102,102,0,0,0
595175,313,313,0,0,0
595178,201,201,0,0,0
595191,281,281,0,0,0
595205,255,255,0,0,0
595215,65,65,0,0,0
595234,77,77,0,0,0
595235,402,402,0,0,0
595237,3,3,0,0,0
595247,17,17,0,0,0
595258,151,151,0,0,0
595268,180,180,0,0,0
595272,102,102,0,0,0
595281,27,27,0,0,0
595293,101,101,0,0,0
595300,12,12,0,0,0
595304,252,252,0,0,0
595312,193,193,0,0,0
595316,313,313,0,0,0
595317,151,151,0,0,0
595332,315,315,0,0,0
595337,315,315,0,0,0
595338,130,130,0,0,0
595365,69,69,0,0,0
595376,232,232,0,0,0
595399,75,75,0,0,0
595406,5,5,0,0,0
595441,27,27,0,0,0
595448,87,87,0,0,0
595451,180,180,0,0,0
595461,114,114,0,0,0
595483,353,353,0,0,0
595501,184,184,0,0,0
595504,77,77,0,0,0
595505,201,201,0,0,0
595523,168,168,0,0,0
595526,69,69,0,0,0
595529,3,3,0,0,0
595558,402,402,0,0,0
595562,310,310,0,0,0
595603,97,97,0,0,0
595609,184,184,0,0,0
595613,32,32,0,0,0
595623,131,131,0,0,0
595631,71,71,0,0,0
595649,246,246,0,0,0
595655,57,57,0,0,0
595666,56,56,0,0,0
595669,43,43,0,0,0
595674,281,281,0,0,0
595693,97,97,0,0,0
595713,252,252,0,0,0
595715,282,282,0,0,0
595722,345,345,0,0,0
595725,345,345,0,0,0
595735,11,11,0,0,0
595748,132,132,0,0,0
595749,70,70,0,0,0
595763,201,201,0,0,0
595781,310,310,0,0,0
595787,87,87,0,0,0
595798,255,255,0,0,0
595805,168,168,0,0,0
595823,36,36,0,0,0
595827,151,151,0,0,0
595837,102,102,0,0,0
595842,57,57,0,0,0
595851,353,353,0,0,0
595852,2,2,0,0,0
595861,282,282,0,0,0
595863,282,282,0,0,0
595867,77,77,0,0,0
595885,113,113,0,0,0
595906,102,102,0,0,0
595916,137,137,0,0,0
595918,193,193,0,0,0
595947,11,11,0,0,0
595951,128,128,0,0,0
595955,131,131,0,0,0
595977,282,282,0,0,0
596002,167,167,0,0,0
596041,152,152,0,0,0
596043,114,114,0,0,0
596060,255,255,0,0,0
596081,128,128,0,0,0
596095,282,282,0,0,0
596106,70,70,0,0,0
596107,7,7,0,0,0
596115,193,193,0,0,0
596154,7,7,0,0,0
596164,72,72,0,0,0
596168,10,10,0,0,0
596174,246,246,0,0,0
596207,402,402,0,0,0
596214,19,19,0,0,0
596244,25,25,0,0,0
596253,137,137,0,0,0
596263,131,131,0,0,0
596265,75,75,0,0,0
596275,63,63,0,0,0
596286,315,315,0,0,0
596295,43,43,0,0,0
596296,87,87,0,0,0
596308,45,45,0,0,0
596333,19,19,0,0,0
596338,113,113,0,0,0
596354,76,76,0,0,0
596373,306,306,0,0,0
596381,102,102,0,0,0
596390,25,25,0,0,0
596404,128,128,0,0,0
596413,232,232,0,0,0
596426,171,171,0,0,0
596432,8,8,0,0,0
596487,40,40,0,0,0
596489,8,8,0,0,0
596523,15,15,0,0,0
596528,158,158,0,0,0
596534,15,15,0,0,0
596537,97,97,0,0,0
596540,313,313,0,0,0
596541,315,315,0,0,0
596545,163,163,0,0,0
596565,54,54,0,0,0
596570,69,69,0,0,0
596584,246,246,0,0,0
596600,131,131,0,0,0
596603,255,255,0,0,0
596611,97,97,0,0,0
596622,353,353,0,0,0
596625,94,94,0,0,0
596646,58,58,0,0,0
596684,315,315,0,0,0
596691,310,310,0,0,0
596700,313,313,0,0,0
596708,299,299,0,0,0
596714,163,163,0,0,0
596717,252,252,0,0,0
596723,306,306,0,0,0
596729,12,12,0,0,0
596731,143,143,0,0,0
596732,35,35,0,0,0
596734,168,168,0,0,0
596738,70,70,0,0,0
596739,252,252,0,0,0
596749,281,281,0,0,0
596764,306,306,0,0,0
596768,151,151,0,0,0
596770,282,282,0,0,0
596773,76,76,0,0,0
596796,232,232,0,0,0
596800,281,281,0,0,0
596813,3,3,0,0,0
596896,143,143,0,0,0
596903,345,345,0,0,0
596930,97,97,0,0,0
596946,121,121,0,0,0
596957,3,3,0,0,0
596961,54,54,0,0,0
596981,281,281,0,0,0
596991,69,69,0,0,0
596993,14,14,0,0,0
596995,130,130,0,0,0
597003,67,67,0,0,0
597005,67,67,0,0,0
597040,306,306,0,0,0
597042,83,83,0,0,0
597044,34,34,0,0,0
597067,306,306,0,0,0
597073,66,66,0,0,0
597080,12,12,0,0,0
597094,232,232,0,0,0
597107,306,306,0,0,0
597108,130,130,0,0,0
597112,69,69,0,0,0
597113,35,35,0,0,0
597122,353,353,0,0,0
597132,76,76,0,0,0
597144,255,255,0,0,0
597159,306,306,0,0,0
597172,180,180,0,0,0
597232,158,158,0,0,0
597263,255,255,0,0,0
597267,39,39,0,0,0
597275,184,184,0,0,0
597278,144,144,0,0,0
597279,310,310,0,0,0
597284,44,44,0,0,0
597285,306,306,0,0,0
597293,114,114,0,0,0
597295,252,252,0,0,0
597296,131,131,0,0,0
597306,120,120,0,0,0
597311,77,77,0,0,0
597334,11,11,0,0,0
597341,402,402,0,0,0
597359,69,69,0,0,0
597362,70,70,0,0,0
597373,137,137,0,0,0
597386,121,121,0,0,0
597390,101,101,0,0,0
597399,128,128,0,0,0
597404,246,246,0,0,0
597411,232,232,0,0,0
597414,180,180,0,0,0
597434,152,152,0,0,0
597442,313,313,0,0,0
597462,36,36,0,0,0
597485,306,306,0,0,0
597489,3,3,0,0,0
597491,15,15,0,0,0
597494,121,121,0,0,0
597500,345,345,0,0,0
597525,255,255,0,0,0
597527,39,39,0,0,0
597529,345,345,0,0,0
597538,353,353,0,0,0
597544,310,310,0,0,0
597546,128,128,0,0,0
597551,27,27,0,0,0
597566,14,14,0,0,0
597576,16,16,0,0,0
597591,76,76,0,0,0
597593,310,310,0,0,0
597630,20,20,0,0,0
597631,359,359,0,0,0
597646,44,44,0,0,0
597661,1,1,0,0,0
597673,198,198,0,0,0
597694,310,310,0,0,0
597696,23,23,0,0,0
597699,36,36,0,0,0
597709,359,359,0,0,0
597712,2,2,0,0,0
597726,10,10,0,0,0
597737,131,131,0,0,0
597740,359,359,0,0,0
597755,359,359,0,0,0
597774,151,151,0,0,0
597790,103,103,0,0,0
597805,2,2,0,0,0
597819,353,353,0,0,0
597839,121,121,0,0,0
597844,18,18,0,0,0
597848,180,180,0,0,0
597859,184,184,0,0,0
597895,137,137,0,0,0
597896,152,152,0,0,0
597901,255,255,0,0,0
597905,102,102,0,0,0
597923,56,56,0,0,0
597930,6,6,0,0,0
597939,137,137,0,0,0
597959,41,41,0,0,0
597966,130,130,0,0,0
597970,281,281,0,0,0
597972,259,259,0,0,0
597974,74,74,0,0,0
597985,121,121,0,0,0
598028,313,313,0,0,0
598031,171,171,0,0,0
598036,50,50,0,0,0
598042,57,57,0,0,0
598046,158,158,0,0,0
598059,83,83,0,0,0
598077,2,2,0,0,0
598131,151,151,0,0,0
598141,143,143,0,0,0
598157,128,128,0,0,0
598159,7,7,0,0,0
598179,102,102,0,0,0
598181,66,66,0,0,0
598189,402,402,0,0,0
598195,113,113,0,0,0
598212,76,76,0,0,0
598215,143,143,0,0,0
598219,120,120,0,0,0
598234,281,281,0,0,0
598250,102,102,0,0,0
598261,5,5,0,0,0
598265,232,232,0,0,0
598287,151,151,0,0,0
598319,101,101,0,0,0
598332,315,315,0,0,0
598337,143,143,0,0,0
598351,359,359,0,0,0
598358,10,10,0,0,0
598361,251,251,0,0,0
598362,66,66,0,0,0
598366,103,103,0,0,0
598383,359,359,0,0,0
598395,15,15,0,0,0
598402,101,101,0,0,0
598410,44,44,0,0,0
598417,40,40,0,0,0
598445,306,306,0,0,0
598460,184,184,0,0,0
598488,36,36,0,0,0
598501,359,359,0,0,0
598503,151,151,0,0,0
598505,299,299,0,0,0
598506,22,22,0,0,0
598516,133,133,0,0,0
598530,345,345,0,0,0
598540,152,152,0,0,0
598561,121,121,0,0,0
598569,158,158,0,0,0
598586,167,167,0,0,0
598593,201,201,0,0,0
598614,251,251,0,0,0
598618,232,232,0,0,0
598631,246,246,0,0,0
598633,299,299,0,0,0
598649,18,18,0,0,0
598668,251,251,0,0,0
598690,121,121,0,0,0
598693,102,102,0,0,0
598707,128,128,0,0,0
598710,168,168,0,0,0
598712,299,299,0,0,0
598738,310,310,0,0,0
598742,246,246,0,0,0
598778,114,114,0,0,0
598809,39,39,0,0,0
598831,255,255,0,0,0
598832,13,13,0,0,0
598852,246,246,0,0,0
598861,137,137,0,0,0
598863,252,252,0,0,0
598883,184,184,0,0,0
598887,50,50,0,0,0
598893,201,201,0,0,0
598909,310,310,0,0,0
598918,102,102,0,0,0
598927,255,255,0,0,0
598939,315,315,0,0,0
598945,201,201,0,0,0
598971,158,158,0,0,0
598977,167,167,0,0,0
598978,5,5,0,0,0
598981,17,17,0,0,0
598987,306,306,0,0,0
598999,35,35,0,0,0
599034,77,77,0,0,0
599046,130,130,0,0,0
599049,12,12,0,0,0
599053,359,359,0,0,0
599060,120,120,0,0,0
599062,259,259,0,0,0
599064,3,3,0,0,0
599067,232,232,0,0,0
599068,201,201,0,0,0
599088,19,19,0,0,0
599094,35,35,0,0,0
599100,359,359,0,0,0
599115,345,345,0,0,0
599136,121,121,0,0,0
599162,299,299,0,0,0
599164,313,313,0,0,0
599166,345,345,0,0,0
599170,74,74,0,0,0
599208,299,299,0,0,0
599217,402,402,0,0,0
599218,97,97,0,0,0
599227,128,128,0,0,0
599276,25,25,0,0,0
599295,232,232,0,0,0
599300,315,315,0,0,0
599307,137,137,0,0,0
599318,56,56,0,0,0
599338,56,56,0,0,0
599345,28,28,0,0,0
599348,345,345,0,0,0
599369,255,255,0,0,0
599374,76,76,0,0,0
599379,251,251,0,0,0
599404,299,299,0,0,0
599405,75,75,0,0,0
599407,45,45,0,0,0
599409,198,198,0,0,0
599418,402,402,0,0,0
599422,353,353,0,0,0
599433,252,252,0,0,0
599479,315,315,0,0,0
599483,76,76,0,0,0
599488,103,103,0,0,0
599495,102,102,0,0,0
599496,282,282,0,0,0
599532,282,282,0,0,0
599574,259,259,0,0,0
599581,128,128,0,0,0
599618,143,143,0,0,0
599625,171,171,0,0,0
599671,152,152,0,0,0
599674,151,151,0,0,0
599681,168,168,0,0,0
599683,77,77,0,0,0
599697,255,255,0,0,0
599698,313,313,0,0,0
599704,114,114,0,0,0
599709,315,315,0,0,0
599727,34,34,0,0,0
599731,83,83,0,0,0
599745,76,76,0,0,0
599749,97,97,0,0,0
599772,402,402,0,0,0
599780,259,259,0,0,0
599794,57,57,0,0,0
599797,6,6,0,0,0
599800,71,71,0,0,0
599809,353,353,0,0,0
599816,101,101,0,0,0
599822,70,70,0,0,0
599823,76,76,0,0,0
599856,15,15,0,0,0
599857,137,137,0,0,0
599860,19,19,0,0,0
599873,20,20,0,0,0
599875,114,114,0,0,0
599887,143,143,0,0,0
599903,69,69,0,0,0
599906,34,34,0,0,0
599920,152,152,0,0,0
599937,120,120,0,0,0
599938,35,35,0,0,0
599942,259,259,0,0,0
599958,359,359,0,0,0
599970,310,310,0,0,0
599987,198,198,0,0,0
600004,281,281,0,0,0
600007,151,151,0,0,0
600010,259,259,0,0,0
600026,180,180,0,0,0
600032,246,246,0,0,0
600055,180,180,0,0,0
600091,75,75,0,0,0
600115,158,158,0,0,0
600139,19,19,0,0,0
600165,130,130,0,0,0
600169,251,251,0,0,0
600179,168,168,0,0,0
600184,72,72,0,0,0
600194,19,19,0,0,0
600198,259,259,0,0,0
600248,120,120,0,0,0
600265,251,251,0,0,0
600280,24,24,0,0,0
600296,130,130,0,0,0
600313,171,171,0,0,0
600328,102,102,0,0,0
600333,5,5,0,0,0
600341,167,167,0,0,0
600350,44,44,0,0,0
600370,198,198,0,0,0
600371,137,137,0,0,0
600378,55,55,0,0,0
600384,201,201,0,0,0
600396,232,232,0,0,0
600397,252,252,0,0,0
600400,83,83,0,0,0
600408,359,359,0,0,0
600437,76,76,0,0,0
600443,299,299,0,0,0
600447,113,113,0,0,0
600456,246,246,0,0,0
600458,50,50,0,0,0
600461,345,345,0,0,0
600464,74,74,0,0,0
600476,255,255,0,0,0
600484,121,121,0,0,0
600485,3,3,0,0,0
600498,143,143,0,0,0
600501,72,72,0,0,0
600506,76,76,0,0,0
600518,30,30,0,0,0
600519,74,74,0,0,0
600522,3,3,0,0,0
600562,144,144,0,0,0
600564,171,171,0,0,0
600594,282,282,0,0,0
600600,12,12,0,0,0
600602,163,163,0,0,0
600607,58,58,0,0,0
600623,85,85,0,0,0
600625,77,77,0,0,0
600629,359,359,0,0,0
600648,310,310,0,0,0
600652,184,184,0,0,0
600654,67,67,0,0,0
600657,310,310,0,0,0
600660,359,359,0,0,0
600679,259,259,0,0,0
600752,310,310,0,0,0
600763,114,114,0,0,0
600768,15,15,0,0,0
600774,315,315,0,0,0
600782,252,252,0,0,0
600783,44,44,0,0,0
600797,144,144,0,0,0
600817,306,306,0,0,0
600827,184,184,0,0,0
600830,74,74,0,0,0
600848,180,180,0,0,0
600852,121,121,0,0,0
600865,70,70,0,0,0
600884,315,315,0,0,0
600900,130,130,0,0,0
600912,282,282,0,0,0
600922,54,54,0,0,0
600942,17,17,0,0,0
600966,128,128,0,0,0
600974,402,402,0,0,0
600997,32,32,0,0,0
601014,74,74,0,0,0
601022,402,402,0,0,0
601040,101,101,0,0,0
601044,402,402,0,0,0
601052,402,402,0,0,0
601058,252,252,0,0,0
601062,143,143,0,0,0
601083,74,74,0,0,0
601088,198,198,0,0,0
601117,3,3,0,0,0
601118,158,158,0,0,0
601126,359,359,0,0,0
601137,180,180,0,0,0
601161,353,353,0,0,0
601208,28,28,0,0,0
601215,102,102,0,0,0
601247,232,232,0,0,0
601257,113,113,0,0,0
601266,41,41,0,0,0
601270,34,34,0,0,0
601297,4,4,0,0,0
601307,120,120,0,0,0
601323,2,2,0,0,0
601331,137,137,0,0,0
601333,345,345,0,0,0
601339,137,137,0,0,0
601351,3,3,0,0,0
601394,54,54,0,0,0
601407,232,232,0,0,0
601432,353,353,0,0,0
601434,19,19,0,0,0
601436,345,345,0,0,0
601438,255,255,0,0,0
601448,41,41,0,0,0
601451,113,113,0,0,0
601455,85,85,0,0,0
601457,69,69,0,0,0
601465,14,14,0,0,0
601468,71,71,0,0,0
601484,137,137,0,0,0
601502,75,75,0,0,0
601504,259,259,0,0,0
601513,152,152,0,0,0
601519,94,94,0,0,0
601522,131,131,0,0,0
601528,252,252,0,0,0
601538,345,345,0,0,0
601543,65,65,0,0,0
601561,44,44,0,0,0
601567,76,76,0,0,0
601575,143,143,0,0,0
601586,282,282,0,0,0
601587,252,252,0,0,0
601603,13,13,0,0,0
601604,313,313,0,0,0
601617,16,16,0,0,0
601632,77,77,0,0,0
601635,306,306,0,0,0
601644,171,171,0,0,0
601645,29,29,0,0,0
601673,11,11,0,0,0
601683,251,251,0,0,0
601698,131,131,0,0,0
601706,29,29,0,0,0
601717,113,113,0,0,0
601725,402,402,0,0,0
601735,151,151,0,0,0
601767,17,17,0,0,0
601780,259,259,0,0,0
601795,5,5,0,0,0
601810,359,359,0,0,0
601812,143,143,0,0,0
601819,306,306,0,0,0
601825,402,402,0,0,0
601826,144,144,0,0,0
601830,168,168,0,0,0
601839,71,71,0,0,0
601851,310,310,0,0,0
601870,94,94,0,0,0
601887,171,171,0,0,0
601888,168,168,0,0,0
601893,85,85,0,0,0
601895,315,315,0,0,0
601901,27,27,0,0,0
601906,184,184,0,0,0
601908,310,310,0,0,0
601915,152,152,0,0,0
601924,246,246,0,0,0
601933,130,130,0,0,0
601950,143,143,0,0,0
601952,163,163,0,0,0
601995,282,282,0,0,0
602016,251,251,0,0,0
602019,158,158,0,0,0
602036,29,29,0,0,0
602041,151,151,0,0,0
602044,315,315,0,0,0
602052,282,282,0,0,0
602062,103,103,0,0,0
602071,11,11,0,0,0
602072,58,58,0,0,0
602096,3,3,0,0,0
602122,359,359,0,0,0
602135,10,10,0,0,0
602147,359,359,0,0,0
602195,132,132,0,0,0
602214,167,167,0,0,0
602218,70,70,0,0,0
602226,345,345,0,0,0
602229,152,152,0,0,0
602241,137,137,0,0,0
602272,299,299,0,0,0
602289,87,87,0,0,0
602291,282,282,0,0,0
602310,306,306,0,0,0
602319,315,315,0,0,0
602323,345,345,0,0,0
602324,402,402,0,0,0
602326,232,232,0,0,0
602340,63,63,0,0,0
602343,18,18,0,0,0
602363,113,113,0,0,0
602377,137,137,0,0,0
602388,66,66,0,0,0
602392,121,121,0,0,0
602408,8,8,0,0,0
602446,402,402,0,0,0
602451,131,131,0,0,0
602456,345,345,0,0,0
602481,143,143,0,0,0
602483,259,259,0,0,0
602489,65,65,0,0,0
602493,345,345,0,0,0
602509,102,102,0,0,0
602533,251,251,0,0,0
602536,281,281,0,0,0
602541,152,152,0,0,0
602545,259,259,0,0,0
602549,255,255,0,0,0
602555,255,255,0,0,0
602561,282,282,0,0,0
602564,132,132,0,0,0
602566,306,306,0,0,0
602574,158,158,0,0,0
602583,252,252,0,0,0
602584,97,97,0,0,0
602605,1,1,0,0,0
602611,281,281,0,0,0
602612,184,184,0,0,0
602624,259,259,0,0,0
602685,85,85,0,0,0
602687,255,255,0,0,0
602700,83,83,0,0,0
602705,6,6,0,0,0
602712,167,167,0,0,0
602736,72,72,0,0,0
602766,163,163,0,0,0
602783,359,359,0,0,0
602784,171,171,0,0,0
602788,113,113,0,0,0
602796,113,113,0,0,0
602799,315,315,0,0,0
602820,171,171,0,0,0
602832,345,345,0,0,0
602877,168,168,0,0,0
602885,315,315,0,0,0
602900,180,180,0,0,0
602916,54,54,0,0,0
602931,171,171,0,0,0
602993,17,17,0,0,0
602994,57,57,0,0,0
603012,259,259,0,0,0
603015,313,313,0,0,0
603025,76,76,0,0,0
603046,71,71,0,0,0
603049,180,180,0,0,0
603056,128,128,0,0,0
603060,34,34,0,0,0
603063,65,65,0,0,0
603075,19,19,0,0,0
603082,71,71,0,0,0
603083,121,121,0,0,0
603089,55,55,0,0,0
603091,353,353,0,0,0
603097,102,102,0,0,0
603098,158,158,0,0,0
603100,27,27,0,0,0
603107,143,143,0,0,0
603115,281,281,0,0,0
603155,198,198,0,0,0
603160,281,281,0,0,0
603163,36,36,0,0,0
603177,251,251,0,0,0
603193,201,201,0,0,0
603221,102,102,0,0,0
603237,252,252,0,0,0
603252,131,131,0,0,0
603256,102,102,0,0,0
603260,259,259,0,0,0
603261,252,252,0,0,0
603282,133,133,0,0,0
603287,255,255,0,0,0
603322,7,7,0,0,0
603328,313,313,0,0,0
603336,75,75,0,0,0
603344,359,359,0,0,0
603358,299,299,0,0,0
603384,54,54,0,0,0
603387,12,12,0,0,0
603389,252,252,0,0,0
603393,252,252,0,0,0
603394,132,132,0,0,0
603395,22,22,0,0,0
603438,315,315,0,0,0
603442,144,144,0,0,0
603451,315,315,0,0,0
603469,353,353,0,0,0
603476,5,5,0,0,0
603496,252,252,0,0,0
603517,168,168,0,0,0
603522,121,121,0,0,0
603528,30,30,0,0,0
603537,402,402,0,0,0
603548,36,36,0,0,0
603554,50,50,0,0,0
603568,15,15,0,0,0
603577,70,70,0,0,0
603582,193,193,0,0,0
603586,282,282,0,0,0
603610,67,67,0,0,0
603617,121,121,0,0,0
603629,313,313,0,0,0
603656,402,402,0,0,0
603680,310,310,0,0,0
603687,359,359,0,0,0
603695,255,255,0,0,0
603726,359,359,0,0,0
603739,121,121,0,0,0
603783,167,167,0,0,0
603813,8,8,0,0,0
603818,251,251,0,0,0
603820,315,315,0,0,0
603823,97,97,0,0,0
603825,113,113,0,0,0
603832,306,306,0,0,0
603845,282,282,0,0,0
603854,143,143,0,0,0
603859,306,306,0,0,0
603861,315,315,0,0,0
603877,310,310,0,0,0
603885,281,281,0,0,0
603890,402,402,0,0,0
603908,167,167,0,0,0
603919,255,255,0,0,0
603934,35,35,0,0,0
603945,114,114,0,0,0
603958,259,259,0,0,0
603968,252,252,0,0,0
603970,20,20,0,0,0
603973,36,36,0,0,0
603976,246,246,0,0,0
603983,163,163,0,0,0
604006,130,130,0,0,0
604015,310,310,0,0,0
604020,282,282,0,0,0
604023,353,353,0,0,0
604024,70,70,0,0,0
604032,163,163,0,0,0
604039,282,282,0,0,0
604055,137,137,0,0,0
604065,255,255,0,0,0
604068,25,25,0,0,0
604086,76,76,0,0,0
604088,345,345,0,0,0
604101,58,58,0,0,0
604104,133,133,0,0,0
604125,15,15,0,0,0
604128,255,255,0,0,0
604131,163,163,0,0,0
604139,281,281,0,0,0
604140,16,16,0,0,0
604164,299,299,0,0,0
604168,55,55,0,0,0
604172,232,232,0,0,0
604177,67,67,0,0,0
604187,184,184,0,0,0
604228,102,102,0,0,0
604232,12,12,0,0,0
604247,171,171,0,0,0
604253,310,310,0,0,0
604269,281,281,0,0,0
604280,15,15,0,0,0
604283,251,251,0,0,0
604286,50,50,0,0,0
604290,71,71,0,0,0
604291,143,143,0,0,0
604300,299,299,0,0,0
604303,281,281,0,0,0
604316,15,15,0,0,0
604328,353,353,0,0,0
604330,72,72,0,0,0
604331,180,180,0,0,0
604337,359,359,0,0,0
604363,310,310,0,0,0
604368,94,94,0,0,0
604380,281,281,0,0,0
604384,359,359,0,0,0
604388,158,158,0,0,0
604418,36,36,0,0,0
604419,259,259,0,0,0
604462,4,4,0,0,0
604468,353,353,0,0,0
604480,306,306,0,0,0
604497,201,201,0,0,0
604513,198,198,0,0,0
604524,8,8,0,0,0
604525,198,198,0,0,0
604533,10,10,0,0,0
604543,97,97,0,0,0
604548,132,132,0,0,0
604561,345,345,0,0,0
604568,58,58,0,0,0
604572,168,168,0,0,0
604581,158,158,0,0,0
604587,315,315,0,0,0
604591,12,12,0,0,0
604609,144,144,0,0,0
604611,246,246,0,0,0
604613,74,74,0,0,0
604614,94,94,0,0,0
604623,255,255,0,0,0
604631,353,353,0,0,0
604632,282,282,0,0,0
604646,36,36,0,0,0
604651,171,171,0,0,0
604653,171,171,0,0,0
604659,315,315,0,0,0
604661,184,184,0,0,0
604684,345,345,0,0,0
604715,144,144,0,0,0
604720,313,313,0,0,0
604741,3,3,0,0,0
604745,402,402,0,0,0
604749,114,114,0,0,0
604756,29,29,0,0,0
604770,402,402,0,0,0
604774,44,44,0,0,0
604775,246,246,0,0,0
604783,402,402,0,0,0
604785,75,75,0,0,0
604787,114,114,0,0,0
604789,74,74,0,0,0
604795,310,310,0,0,0
604808,133,133,0,0,0
604841,252,252,0,0,0
604935,14,14,0,0,0
604951,36,36,0,0,0
604961,282,282,0,0,0
604962,74,74,0,0,0
604977,57,57,0,0,0
604981,27,27,0,0,0
605019,114,114,0,0,0
605027,402,402,0,0,0
605029,83,83,0,0,0
605040,102,102,0,0,0
605070,345,345,0,0,0
605072,8,8,0,0,0
605079,282,282,0,0,0
605081,232,232,0,0,0
605083,281,281,0,0,0
605089,70,70,0,0,0
605100,102,102,0,0,0
605124,255,255,0,0,0
605127,8,8,0,0,0
605135,359,359,0,0,0
605143,50,50,0,0,0
605144,259,259,0,0,0
605145,101,101,0,0,0
605156,12,12,0,0,0
605167,282,282,0,0,0
605174,4,4,0,0,0
605194,259,259,0,0,0
605195,193,193,0,0,0
605200,353,353,0,0,0
605204,143,143,0,0,0
605217,143,143,0,0,0
605226,114,114,0,0,0
605269,345,345,0,0,0
605280,306,306,0,0,0
605293,19,19,0,0,0
605296,193,193,0,0,0
605302,158,158,0,0,0
605310,246,246,0,0,0
605311,94,94,0,0,0
605317,313,313,0,0,0
605321,345,345,0,0,0
605327,67,67,0,0,0
605328,353,353,0,0,0
605330,299,299,0,0,0
605332,128,128,0,0,0
605343,87,87,0,0,0
605356,132,132,0,0,0
605361,36,36,0,0,0
605366,201,201,0,0,0
605368,102,102,0,0,0
605375,259,259,0,0,0
605382,74,74,0,0,0
605386,281,281,0,0,0
605395,15,15,0,0,0
605402,74,74,0,0,0
605403,402,402,0,0,0
605417,282,282,0,0,0
605424,184,184,0,0,0
605446,25,25,0,0,0
605463,353,353,0,0,0
605470,137,137,0,0,0
605474,72,72,0,0,0
605489,251,251,0,0,0
605498,87,87,0,0,0
605517,44,44,0,0,0
605527,315,315,0,0,0
605530,74,74,0,0,0
605538,121,121,0,0,0
605546,15,15,0,0,0
605550,315,315,0,0,0
605561,246,246,0,0,0
605583,18,18,0,0,0
605585,168,168,0,0,0
605591,306,306,0,0,0
605593,70,70,0,0,0
605605,315,315,0,0,0
605616,152,152,0,0,0
605623,15,15,0,0,0
605636,198,198,0,0,0
605638,299,299,0,0,0
605642,353,353,0,0,0
605646,281,281,0,0,0
605648,353,353,0,0,0
605692,402,402,0,0,0
605715,201,201,0,0,0
605717,66,66,0,0,0
605731,281,281,0,0,0
605757,168,168,0,0,0
605762,246,246,0,0,0
605765,94,94,0,0,0
605772,65,65,0,0,0
605773,3,3,0,0,0
605776,8,8,0,0,0
605779,75,75,0,0,0
605782,353,353,0,0,0
605789,7,7,0,0,0
605794,137,137,0,0,0
605797,345,345,0,0,0
605815,18,18,0,0,0
605822,246,246,0,0,0
605827,402,402,0,0,0
605831,103,103,0,0,0
605859,282,282,0,0,0
605864,35,35,0,0,0
605876,315,315,0,0,0
605885,19,19,0,0,0
605887,171,171,0,0,0
605898,345,345,0,0,0
605916,76,76,0,0,0
605926,70,70,0,0,0
605944,23,23,0,0,0
605957,345,345,0,0,0
605974,232,232,0,0,0
605993,143,143,0,0,0
606003,310,310,0,0,0
606004,402,402,0,0,0
606019,56,56,0,0,0
606026,171,171,0,0,0
606032,402,402,0,0,0
606036,282,282,0,0,0
606038,282,282,0,0,0
606056,232,232,0,0,0
606075,251,251,0,0,0
606110,310,310,0,0,0
606112,163,163,0,0,0
606126,151,151,0,0,0
606133,310,310,0,0,0
606139,282,282,0,0,0
606147,128,128,0,0,0
606154,359,359,0,0,0
606158,15,15,0,0,0
606190,15,15,0,0,0
606200,201,201,0,0,0
606211,163,163,0,0,0
606216,44,44,0,0,0
606230,1,1,0,0,0
606232,45,45,0,0,0
606248,143,143,0,0,0
606259,65,65,0,0,0
606261,12,12,0,0,0
606263,158,158,0,0,0
606264,353,353,0,0,0
606267,45,45,0,0,0
606275,1,1,0,0,0
606285,114,114,0,0,0
606290,85,85,0,0,0
606298,45,45,0,0,0
606305,168,168,0,0,0
606321,345,345,0,0,0
606325,281,281,0,0,0
606346,121,121,0,0,0
606348,315,315,0,0,0
606390,232,232,0,0,0
606393,29,29,0,0,0
606394,8,8,0,0,0
606402,313,313,0,0,0
606415,255,255,0,0,0
606418,193,193,0,0,0
606419,232,232,0,0,0
606422,22,22,0,0,0
606455,24,24,0,0,0
606482,255,255,0,0,0
606484,55,55,0,0,0
606486,345,345,0,0,0
606512,70,70,0,0,0
606521,281,281,0,0,0
606529,3,3,0,0,0
606535,85,85,0,0,0
606542,151,151,0,0,0
606560,25,25,0,0,0
606594,29,29,0,0,0
606595,359,359,0,0,0
606602,246,246,0,0,0
606605,246,246,0,0,0
606606,313,313,0,0,0
606615,18,18,0,0,0
606629,353,353,0,0,0
606631,9,9,0,0,0
606647,345,345,0,0,0
606653,65,65,0,0,0
606664,281,281,0,0,0
606667,152,152,0,0,0
606669,7,7,0,0,0
606680,281,281,0,0,0
606691,128,128,0,0,0
606717,158,158,0,0,0
606728,82,82,0,0,0
606736,282,282,0,0,0
606751,54,54,0,0,0
606753,184,184,0,0,0
606765,121,121,0,0,0
606783,77,77,0,0,0
606817,171,171,0,0,0
606822,158,158,0,0,0
606825,281,281,0,0,0
606834,35,35,0,0,0
606899,152,152,0,0,0
606904,102,102,0,0,0
606922,345,345,0,0,0
606926,315,315,0,0,0
606927,193,193,0,0,0
606946,40,40,0,0,0
606968,359,359,0,0,0
606985,310,310,0,0,0
606987,246,246,0,0,0
606991,70,70,0,0,0
606998,102,102,0,0,0
607008,137,137,0,0,0
607013,97,97,0,0,0
607023,133,133,0,0,0
607032,20,20,0,0,0
607038,353,353,0,0,0
607043,198,198,0,0,0
607061,310,310,0,0,0
607069,16,16,0,0,0
607071,315,315,0,0,0
607083,7,7,0,0,0
607084,70,70,0,0,0
607097,67,67,0,0,0
607126,30,30,0,0,0
607130,198,198,0,0,0
607135,137,137,0,0,0
607143,56,56,0,0,0
607195,232,232,0,0,0
607197,184,184,0,0,0
607203,102,102,0,0,0
607204,255,255,0,0,0
607214,70,70,0,0,0
607216,310,310,0,0,0
607220,252,252,0,0,0
607224,66,66,0,0,0
607231,313,313,0,0,0
607254,137,137,0,0,0
607256,74,74,0,0,0
607257,5,5,0,0,0
607264,299,299,0,0,0
607265,2,2,0,0,0
607270,184,184,0,0,0
607272,184,184,0,0,0
607275,114,114,0,0,0
607281,137,137,0,0,0
607294,35,35,0,0,0
607297,310,310,0,0,0
607312,246,246,0,0,0
607313,83,83,0,0,0
607328,71,71,0,0,0
607343,315,315,0,0,0
607357,255,255,0,0,0
607359,87,87,0,0,0
607384,10,10,0,0,0
607408,30,30,0,0,0
607413,137,137,0,0,0
607442,246,246,0,0,0
607446,67,67,0,0,0
607448,121,121,0,0,0
607449,30,30,0,0,0
607457,167,167,0,0,0
607469,232,232,0,0,0
607475,315,315,0,0,0
607482,71,71,0,0,0
607506,345,345,0,0,0
607519,163,163,0,0,0
607533,58,58,0,0,0
607546,3,3,0,0,0
607550,18,18,0,0,0
607551,353,353,0,0,0
607576,152,152,0,0,0
607578,137,137,0,0,0
607580,35,35,0,0,0
607600,6,6,0,0,0
607604,83,83,0,0,0
607607,76,76,0,0,0
607608,255,255,0,0,0
607616,201,201,0,0,0
607674,282,282,0,0,0
607675,282,282,0,0,0
607685,345,345,0,0,0
607718,12,12,0,0,0
607728,198,198,0,0,0
607751,39,39,0,0,0
607761,131,131,0,0,0
607793,353,353,0,0,0
607811,71,71,0,0,0
607854,184,184,0,0,0
607856,259,259,0,0,0
607858,299,299,0,0,0
607867,27,27,0,0,0
607870,17,17,0,0,0
607878,50,50,0,0,0
607880,282,282,0,0,0
607890,306,306,0,0,0
607910,56,56,0,0,0
607916,281,281,0,0,0
607924,130,130,0,0,0
607946,281,281,0,0,0
607953,66,66,0,0,0
607958,74,74,0,0,0
607976,25,25,0,0,0
607988,101,101,0,0,0
608015,281,281,0,0,0
608023,313,313,0,0,0
608052,35,35,0,0,0
608091,6,6,0,0,0
608110,45,45,0,0,0
608159,402,402,0,0,0
608171,7,7,0,0,0
608189,180,180,0,0,0
608193,13,13,0,0,0
608195,310,310,0,0,0
608202,40,40,0,0,0
608206,282,282,0,0,0
608222,251,251,0,0,0
608223,171,171,0,0,0
608247,359,359,0,0,0
608262,259,259,0,0,0
608282,282,282,0,0,0
608283,75,75,0,0,0
608284,12,12,0,0,0
608287,255,255,0,0,0
608289,255,255,0,0,0
608298,359,359,0,0,0
608302,76,76,0,0,0
608337,101,101,0,0,0
608341,133,133,0,0,0
608346,345,345,0,0,0
608355,402,402,0,0,0
608397,143,143,0,0,0
608429,3,3,0,0,0
608435,402,402,0,0,0
608479,7,7,0,0,0
608488,171,171,0,0,0
608491,137,137,0,0,0
608500,70,70,0,0,0
608501,65,65,0,0,0
608505,198,198,0,0,0
608515,151,151,0,0,0
608529,402,402,0,0,0
608533,34,34,0,0,0
608547,85,85,0,0,0
608554,167,167,0,0,0
608557,246,246,0,0,0
608583,34,34,0,0,0
608594,282,282,0,0,0
608595,97,97,0,0,0
608600,34,34,0,0,0
608631,71,71,0,0,0
608635,5,5,0,0,0
608639,56,56,0,0,0
608645,50,50,0,0,0
608651,75,75,0,0,0
608654,34,34,0,0,0
608656,121,121,0,0,0
608658,402,402,0,0,0
608660,56,56,0,0,0
608664,281,281,0,0,0
608666,94,94,0,0,0
608677,27,27,0,0,0
608679,29,29,0,0,0
608680,282,282,0,0,0
608695,114,114,0,0,0
608700,353,353,0,0,0
608701,252,252,0,0,0
608711,171,171,0,0,0
608716,143,143,0,0,0
608719,255,255,0,0,0
608720,359,359,0,0,0
608728,152,152,0,0,0
608747,299,299,0,0,0
608749,313,313,0,0,0
608750,50,50,0,0,0
608765,3,3,0,0,0
608777,345,345,0,0,0
608782,158,158,0,0,0
608807,50,50,0,0,0
608812,232,232,0,0,0
608822,281,281,0,0,0
608823,3,3,0,0,0
608835,345,345,0,0,0
608848,34,34,0,0,0
608857,102,102,0,0,0
608862,130,130,0,0,0
608864,63,63,0,0,0
608865,152,152,0,0,0
608889,402,402,0,0,0
608895,137,137,0,0,0
608897,313,313,0,0,0
608911,76,76,0,0,0
608913,114,114,0,0,0
608940,23,23,0,0,0
608942,359,359,0,0,0
608944,402,402,0,0,0
608960,310,310,0,0,0
608963,5,5,0,0,0
608968,36,36,0,0,0
608970,313,313,0,0,0
608972,252,252,0,0,0
608980,282,282,0,0,0
608984,137,137,0,0,0
608993,171,171,0,0,0
608997,306,306,0,0,0
609002,168,168,0,0,0
609004,158,158,0,0,0
609021,57,57,0,0,0
609054,201,201,0,0,0
609061,201,201,0,0,0
609064,16,16,0,0,0
609065,50,50,0,0,0
609078,66,66,0,0,0
609088,70,70,0,0,0
609097,77,77,0,0,0
609099,75,75,0,0,0
609115,163,163,0,0,0
609119,255,255,0,0,0
609141,198,198,0,0,0
609146,193,193,0,0,0
609169,315,315,0,0,0
609172,4,4,0,0,0
609178,7,7,0,0,0
609186,87,87,0,0,0
609222,27,27,0,0,0
609233,151,151,0,0,0
609236,50,50,0,0,0
609238,345,345,0,0,0
609247,121,121,0,0,0
609256,102,102,0,0,0
609268,201,201,0,0,0
609286,353,353,0,0,0
609314,345,345,0,0,0
609317,255,255,0,0,0
609337,345,345,0,0,0
609370,137,137,0,0,0
609411,8,8,0,0,0
609426,137,137,0,0,0
609432,255,255,0,0,0
609433,151,151,0,0,0
609442,121,121,0,0,0
609443,198,198,0,0,0
609449,77,77,0,0,0
609456,310,310,0,0,0
609457,201,201,0,0,0
609481,131,131,0,0,0
609482,315,315,0,0,0
609491,121,121,0,0,0
609496,9,9,0,0,0
609514,56,56,0,0,0
609518,315,315,0,0,0
609521,113,113,0,0,0
609527,193,193,0,0,0
609530,171,171,0,0,0
609536,120,120,0,0,0
609557,345,345,0,0,0
609589,251,251,0,0,0
609594,315,315,0,0,0
609608,130,130,0,0,0
609612,131,131,0,0,0
609624,94,94,0,0,0
609625,20,20,0,0,0
609638,315,315,0,0,0
609645,97,97,0,0,0
609685,13,13,0,0,0
609700,137,137,0,0,0
609739,12,12,0,0,0
609742,259,259,0,0,0
609755,5,5,0,0,0
609764,77,77,0,0,0
609777,282,282,0,0,0
609783,102,102,0,0,0
609785,259,259,0,0,0
609789,131,131,0,0,0
609791,54,54,0,0,0
609794,66,66,0,0,0
609800,167,167,0,0,0
609813,163,163,0,0,0
609845,198,198,0,0,0
609849,71,71,0,0,0
609879,193,193,0,0,0
609881,114,114,0,0,0
609908,315,315,0,0,0
609914,281,281,0,0,0
609928,1,1,0,0,0
609930,12,12,0,0,0
609937,201,201,0,0,0
609941,345,345,0,0,0
609953,16,16,0,0,0
609989,281,281,0,0,0
609999,313,313,0,0,0
610018,28,28,0,0,0
610021,232,232,0,0,0
610028,114,114,0,0,0
610038,24,24,0,0,0
610044,152,152,0,0,0
610049,66,66,0,0,0
610052,246,246,0,0,0
610054,74,74,0,0,0
610070,128,128,0,0,0
610099,310,310,0,0,0
610103,252,252,0,0,0
610107,180,180,0,0,0
610108,72,72,0,0,0
610109,76,76,0,0,0
610117,353,353,0,0,0
610131,167,167,0,0,0
610143,121,121,0,0,0
610144,114,114,0,0,0
610150,40,40,0,0,0
610152,50,50,0,0,0
610158,102,102,0,0,0
610175,137,137,0,0,0
610185,246,246,0,0,0
610189,232,232,0,0,0
610191,171,171,0,0,0
610194,120,120,0,0,0
610198,198,198,0,0,0
610205,17,17,0,0,0
610207,353,353,0,0,0
610214,315,315,0,0,0
610228,101,101,0,0,0
610248,306,306,0,0,0
610261,57,57,0,0,0
610302,97,97,0,0,0
610305,45,45,0,0,0
610307,306,306,0,0,0
610308,281,281,0,0,0
610357,102,102,0,0,0
610385,184,184,0,0,0
610386,70,70,0,0,0
610395,87,87,0,0,0
610396,2,2,0,0,0
610399,102,102,0,0,0
610414,252,252,0,0,0
610423,402,402,0,0,0
610446,251,251,0,0,0
610475,137,137,0,0,0
610492,137,137,0,0,0
610503,151,151,0,0,0
610507,180,180,0,0,0
610514,299,299,0,0,0
610532,252,252,0,0,0
610555,315,315,0,0,0
610557,143,143,0,0,0
610586,8,8,0,0,0
610589,313,313,0,0,0
610602,16,16,0,0,0
610617,3,3,0,0,0
610631,87,87,0,0,0
610642,113,113,0,0,0
610649,9,9,0,0,0
610658,232,232,0,0,0
610659,353,353,0,0,0
610685,76,76,0,0,0
610689,113,113,0,0,0
610703,198,198,0,0,0
610727,24,24,0,0,0
610730,121,121,0,0,0
610733,15,15,0,0,0
610747,76,76,0,0,0
610759,13,13,0,0,0
610766,158,158,0,0,0
610768,259,259,0,0,0
610776,35,35,0,0,0
610793,76,76,0,0,0
610800,353,353,0,0,0
610824,184,184,0,0,0
610832,359,359,0,0,0
610858,282,282,0,0,0
610865,198,198,0,0,0
610885,20,20,0,0,0
610917,251,251,0,0,0
610920,315,315,0,0,0
610941,184,184,0,0,0
610959,402,402,0,0,0
610964,163,163,0,0,0
610974,201,201,0,0,0
610979,18,18,0,0,0
610982,402,402,0,0,0
611014,18,18,0,0,0
611026,232,232,0,0,0
611027,402,402,0,0,0
611039,11,11,0,0,0
611048,353,353,0,0,0
611055,345,345,0,0,0
611057,168,168,0,0,0
611061,201,201,0,0,0
611066,137,137,0,0,0
611068,201,201,0,0,0
611070,66,66,0,0,0
611072,198,198,0,0,0
611092,198,198,0,0,0
611098,345,345,0,0,0
611099,251,251,0,0,0
611104,137,137,0,0,0
611107,359,359,0,0,0
611151,3,3,0,0,0
611156,402,402,0,0,0
611158,25,25,0,0,0
611163,137,137,0,0,0
611164,39,39,0,0,0
611165,82,82,0,0,0
611171,36,36,0,0,0
611175,359,359,0,0,0
611177,130,130,0,0,0
611195,158,158,0,0,0
611211,10,10,0,0,0
611217,24,24,0,0,0
611228,246,246,0,0,0
611237,8,8,0,0,0
611252,55,55,0,0,0
611259,163,163,0,0,0
611272,137,137,0,0,0
611296,353,353,0,0,0
611298,4,4,0,0,0
611315,30,30,0,0,0
611317,315,315,0,0,0
611330,2,2,0,0,0
611345,113,113,0,0,0
611360,359,359,0,0,0
611375,128,128,0,0,0
611383,83,83,0,0,0
611413,133,133,0,0,0
611428,359,359,0,0,0
611432,315,315,0,0,0
611433,198,198,0,0,0
611441,171,171,0,0,0
611444,74,74,0,0,0
611449,252,252,0,0,0
611455,345,345,0,0,0
611478,137,137,0,0,0
611491,232,232,0,0,0
611492,306,306,0,0,0
611493,72,72,0,0,0
611505,58,58,0,0,0
611527,180,180,0,0,0
611534,113,113,0,0,0
611542,232,232,0,0,0
611547,131,131,0,0,0
611565,114,114,0,0,0
611609,313,313,0,0,0
611611,353,353,0,0,0
611636,130,130,0,0,0
611644,353,353,0,0,0
611659,7,7,0,0,0
611687,56,56,0,0,0
611689,255,255,0,0,0
611706,13,13,0,0,0
611718,74,74,0,0,0
611727,184,184,0,0,0
611728,198,198,0,0,0
611752,7,7,0,0,0
611789,402,402,0,0,0
611801,121,121,0,0,0
611809,255,255,0,0,0
611828,255,255,0,0,0
611850,151,151,0,0,0
611855,310,310,0,0,0
611862,353,353,0,0,0
611897,353,353,0,0,0
611907,137,137,0,0,0
611913,232,232,0,0,0
611918,171,171,0,0,0
611943,137,137,0,0,0
611952,9,9,0,0,0
611957,74,74,0,0,0
611958,128,128,0,0,0
611993,137,137,0,0,0
611995,54,54,0,0,0
612007,198,198,0,0,0
612018,56,56,0,0,0
612042,232,232,0,0,0
612048,133,133,0,0,0
612051,315,315,0,0,0
612054,255,255,0,0,0
612060,282,282,0,0,0
612073,193,193,0,0,0
612078,72,72,0,0,0
612081,180,180,0,0,0
612089,167,167,0,0,0
612097,184,184,0,0,0
612107,313,313,0,0,0
612108,143,143,0,0,0
612120,70,70,0,0,0
612124,77,77,0,0,0
612128,151,151,0,0,0
612135,128,128,0,0,0
612146,55,55,0,0,0
612149,299,299,0,0,0
612155,310,310,0,0,0
612173,163,163,0,0,0
612194,306,306,0,0,0
612199,70,70,0,0,0
612208,251,251,0,0,0
612210,255,255,0,0,0
612216,6,6,0,0,0
612235,259,259,0,0,0
612253,75,75,0,0,0
612261,63,63,0,0,0
612312,17,17,0,0,0
612314,353,353,0,0,0
612319,402,402,0,0,0
612328,168,168,0,0,0
612363,43,43,0,0,0
612382,20,20,0,0,0
612406,299,299,0,0,0
612410,41,41,0,0,0
612425,158,158,0,0,0
612434,345,345,0,0,0
612462,121,121,0,0,0
612464,137,137,0,0,0
612489,25,25,0,0,0
612490,70,70,0,0,0
612498,44,44,0,0,0
612512,299,299,0,0,0
612556,72,72,0,0,0
612573,402,402,0,0,0
612574,9,9,0,0,0
612591,252,252,0,0,0
612602,17,17,0,0,0
612619,102,102,0,0,0
612638,313,313,0,0,0
612644,130,130,0,0,0
612649,58,58,0,0,0
612660,39,39,0,0,0
612662,83,83,0,0,0
612664,201,201,0,0,0
612675,163,163,0,0,0
612683,402,402,0,0,0
612688,299,299,0,0,0
612691,246,246,0,0,0
612699,102,102,0,0,0
612714,246,246,0,0,0
612732,282,282,0,0,0
612740,45,45,0,0,0
612744,10,10,0,0,0
612770,114,114,0,0,0
612779,22,22,0,0,0
612799,168,168,0,0,0
612801,101,101,0,0,0
612813,313,313,0,0,0
612814,168,168,0,0,0
612823,201,201,0,0,0
612827,184,184,0,0,0
612874,310,310,0,0,0
612875,201,201,0,0,0
612877,152,152,0,0,0
612879,128,128,0,0,0
612881,281,281,0,0,0
612897,6,6,0,0,0
612907,299,299,0,0,0
612948,281,281,0,0,0
612952,83,83,0,0,0
612958,85,85,0,0,0
612960,359,359,0,0,0
612979,299,299,0,0,0
612988,281,281,0,0,0
612996,151,151,0,0,0
612999,10,10,0,0,0
613006,259,259,0,0,0
613030,2,2,0,0,0
613045,10,10,0,0,0
613046,131,131,0,0,0
613053,359,359,0,0,0
613071,131,131,0,0,0
613082,299,299,0,0,0
613098,72,72,0,0,0
613104,74,74,0,0,0
613108,1,1,0,0,0
613118,63,63,0,0,0
613132,402,402,0,0,0
613170,281,281,0,0,0
613172,113,113,0,0,0
613179,133,133,0,0,0
613188,36,36,0,0,0
613190,315,315,0,0,0
613194,171,171,0,0,0
613195,163,163,0,0,0
613204,133,133,0,0,0
613211,359,359,0,0,0
613228,132,132,0,0,0
613243,315,315,0,0,0
613259,359,359,0,0,0
613264,113,113,0,0,0
613273,82,82,0,0,0
613277,168,168,0,0,0
613281,12,12,0,0,0
613296,101,101,0,0,0
613312,184,184,0,0,0
613314,70,70,0,0,0
613326,167,167,0,0,0
613346,17,17,0,0,0
613369,114,114,0,0,0
613377,103,103,0,0,0
613381,102,102,0,0,0
613406,43,43,0,0,0
613407,70,70,0,0,0
613418,255,255,0,0,0
613419,282,282,0,0,0
613435,299,299,0,0,0
613438,184,184,0,0,0
613439,87,87,0,0,0
613442,313,313,0,0,0
613452,6,6,0,0,0
613464,306,306,0,0,0
613479,251,251,0,0,0
613486,299,299,0,0,0
613493,353,353,0,0,0
613510,306,306,0,0,0
613522,158,158,0,0,0
613530,246,246,0,0,0
613532,299,299,0,0,0
613543,402,402,0,0,0
613549,24,24,0,0,0
613572,128,128,0,0,0
613589,163,163,0,0,0
613590,345,345,0,0,0
613605,7,7,0,0,0
613609,7,7,0,0,0
613610,17,17,0,0,0
613612,17,17,0,0,0
613636,315,315,0,0,0
613694,359,359,0,0,0
613698,163,163,0,0,0
613706,34,34,0,0,0
613769,353,353,0,0,0
613770,34,34,0,0,0
613773,15,15,0,0,0
613820,299,299,0,0,0
613849,402,402,0,0,0
613864,345,345,0,0,0
613906,5,5,0,0,0
613930,232,232,0,0,0
613935,345,345,0,0,0
613940,44,44,0,0,0
613957,63,63,0,0,0
614008,353,353,0,0,0
614033,306,306,0,0,0
614037,43,43,0,0,0
614043,359,359,0,0,0
614050,94,94,0,0,0
614057,359,359,0,0,0
614074,345,345,0,0,0
614096,22,22,0,0,0
614101,114,114,0,0,0
614106,24,24,0,0,0
614122,6,6,0,0,0
614125,158,158,0,0,0
614129,353,353,0,0,0
614131,299,299,0,0,0
614134,97,97,0,0,0
614140,259,259,0,0,0
614143,39,39,0,0,0
614174,114,114,0,0,0
614179,251,251,0,0,0
614187,43,43,0,0,0
614199,345,345,0,0,0
614229,282,282,0,0,0
614231,359,359,0,0,0
614240,50,50,0,0,0
614251,22,22,0,0,0
614256,10,10,0,0,0
614282,85,85,0,0,0
614285,255,255,0,0,0
614292,34,34,0,0,0
614294,76,76,0,0,0
614302,255,255,0,0,0
614324,12,12,0,0,0
614333,180,180,0,0,0
614341,180,180,0,0,0
614349,353,353,0,0,0
614356,315,315,0,0,0
614358,12,12,0,0,0
614359,152,152,0,0,0
614364,102,102,0,0,0
614390,353,353,0,0,0
614404,252,252,0,0,0
614413,8,8,0,0,0
614428,121,121,0,0,0
614455,402,402,0,0,0
614462,198,198,0,0,0
614463,315,315,0,0,0
614467,76,76,0,0,0
614469,201,201,0,0,0
614470,35,35,0,0,0
614479,184,184,0,0,0
614482,83,83,0,0,0
614542,310,310,0,0,0
614543,76,76,0,0,0
614579,29,29,0,0,0
614632,137,137,0,0,0
614637,35,35,0,0,0
614639,114,114,0,0,0
614648,353,353,0,0,0
614662,152,152,0,0,0
614677,251,251,0,0,0
614701,11,11,0,0,0
614723,97,97,0,0,0
614746,137,137,0,0,0
614750,55,55,0,0,0
614755,359,359,0,0,0
614761,359,359,0,0,0
614766,359,359,0,0,0
614777,74,74,0,0,0
614782,359,359,0,0,0
614795,102,102,0,0,0
614816,27,27,0,0,0
614821,6,6,0,0,0
614834,97,97,0,0,0
614859,18,18,0,0,0
614861,101,101,0,0,0
614870,198,198,0,0,0
614895,193,193,0,0,0
614907,24,24,0,0,0
614932,137,137,0,0,0
614981,171,171,0,0,0
614987,282,282,0,0,0
615004,345,345,0,0,0
615015,44,44,0,0,0
615016,306,306,0,0,0
615021,77,77,0,0,0
615030,315,315,0,0,0
615067,30,30,0,0,0
615074,306,306,0,0,0
615077,353,353,0,0,0
615088,143,143,0,0,0
615091,193,193,0,0,0
615099,252,252,0,0,0
615113,75,75,0,0,0
615115,259,259,0,0,0
615117,120,120,0,0,0
615123,10,10,0,0,0
615125,44,44,0,0,0
615136,251,251,0,0,0
615141,168,168,0,0,0
615155,168,168,0,0,0
615158,345,345,0,0,0
615162,299,299,0,0,0
615173,353,353,0,0,0
615183,143,143,0,0,0
615196,402,402,0,0,0
615218,5,5,0,0,0
615221,94,94,0,0,0
615255,25,25,0,0,0
615267,69,69,0,0,0
615273,41,41,0,0,0
615275,310,310,0,0,0
615278,315,315,0,0,0
615296,251,251,0,0,0
615313,281,281,0,0,0
615314,402,402,0,0,0
615325,402,402,0,0,0
615340,74,74,0,0,0
615341,281,281,0,0,0
615343,252,252,0,0,0
615363,83,83,0,0,0
615367,12,12,0,0,0
615372,7,7,0,0,0
615426,310,310,0,0,0
615453,39,39,0,0,0
615459,83,83,0,0,0
615490,315,315,0,0,0
615498,246,246,0,0,0
615500,56,56,0,0,0
615502,281,281,0,0,0
615536,252,252,0,0,0
615538,402,402,0,0,0
615548,402,402,0,0,0
615561,77,77,0,0,0
615566,167,167,0,0,0
615573,74,74,0,0,0
615574,313,313,0,0,0
615590,131,131,0,0,0
615592,306,306,0,0,0
615608,163,163,0,0,0
615610,56,56,0,0,0
615640,158,158,0,0,0
615659,121,121,0,0,0
615691,114,114,0,0,0
615700,281,281,0,0,0
615703,11,11,0,0,0
615709,6,6,0,0,0
615726,310,310,0,0,0
615730,103,103,0,0,0
615736,167,167,0,0,0
615755,74,74,0,0,0
615765,29,29,0,0,0
615766,402,402,0,0,0
615774,167,167,0,0,0
615775,69,69,0,0,0
615778,25,25,0,0,0
615782,281,281,0,0,0
615787,184,184,0,0,0
615801,133,133,0,0,0
615816,137,137,0,0,0
615823,281,281,0,0,0
615830,299,299,0,0,0
615838,251,251,0,0,0
615861,306,306,0,0,0
615879,251,251,0,0,0
615882,315,315,0,0,0
615890,252,252,0,0,0
615900,25,25,0,0,0
615912,137,137,0,0,0
615913,193,193,0,0,0
615930,163,163,0,0,0
615937,13,13,0,0,0
615961,299,299,0,0,0
615963,310,310,0,0,0
615983,113,113,0,0,0
615988,251,251,0,0,0
616006,252,252,0,0,0
616014,306,306,0,0,0
616020,58,58,0,0,0
616033,32,32,0,0,0
616042,75,75,0,0,0
616044,158,158,0,0,0
616048,299,299,0,0,0
616109,345,345,0,0,0
616125,121,121,0,0,0
616127,22,22,0,0,0
616129,299,299,0,0,0
616137,151,151,0,0,0
616151,121,121,0,0,0
616160,57,57,0,0,0
616169,130,130,0,0,0
616192,113,113,0,0,0
616194,3,3,0,0,0
616230,137,137,0,0,0
616234,28,28,0,0,0
616236,255,255,0,0,0
616250,15,15,0,0,0
616264,131,131,0,0,0
616269,34,34,0,0,0
616291,259,259,0,0,0
616292,246,246,0,0,0
616296,251,251,0,0,0
616306,259,259,0,0,0
616311,299,299,0,0,0
616318,281,281,0,0,0
616320,102,102,0,0,0
616326,128,128,0,0,0
616327,114,114,0,0,0
616334,152,152,0,0,0
616357,402,402,0,0,0
616360,281,281,0,0,0
616370,151,151,0,0,0
616371,163,163,0,0,0
616373,97,97,0,0,0
616375,67,67,0,0,0
616384,137,137,0,0,0
616393,55,55,0,0,0
616402,56,56,0,0,0
616403,121,121,0,0,0
616406,35,35,0,0,0
616414,20,20,0,0,0
616419,171,171,0,0,0
616420,7,7,0,0,0
616458,353,353,0,0,0
616486,180,180,0,0,0
616491,69,69,0,0,0
616494,44,44,0,0,0
616497,151,151,0,0,0
616507,310,310,0,0,0
616526,255,255,0,0,0
616538,359,359,0,0,0
616554,137,137,0,0,0
616562,6,6,0,0,0
616564,20,20,0,0,0
616567,306,306,0,0,0
616569,246,246,0,0,0
616590,1,1,0,0,0
616595,152,152,0,0,0
616605,8,8,0,0,0
616612,74,74,0,0,0
616630,345,345,0,0,0
616646,259,259,0,0,0
616650,359,359,0,0,0
616663,232,232,0,0,0
616679,251,251,0,0,0
616685,255,255,0,0,0
616699,402,402,0,0,0
616716,13,13,0,0,0
616733,20,20,0,0,0
616742,306,306,0,0,0
616770,402,402,0,0,0
616792,114,114,0,0,0
616799,198,198,0,0,0
616815,353,353,0,0,0
616839,252,252,0,0,0
616843,255,255,0,0,0
616846,252,252,0,0,0
616867,12,12,0,0,0
616876,184,184,0,0,0
616877,310,310,0,0,0
616882,353,353,0,0,0
616887,83,83,0,0,0
616896,310,310,0,0,0
616911,353,353,0,0,0
616912,34,34,0,0,0
616916,201,201,0,0,0
616918,75,75,0,0,0
616933,232,232,0,0,0
616951,72,72,0,0,0
616966,315,315,0,0,0
616975,82,82,0,0,0
616979,7,7,0,0,0
616983,180,180,0,0,0
616992,128,128,0,0,0
616993,41,41,0,0,0
616995,353,353,0,0,0
617025,25,25,0,0,0
617027,75,75,0,0,0
617047,251,251,0,0,0
617080,97,97,0,0,0
617091,16,16,0,0,0
617107,102,102,0,0,0
617131,25,25,0,0,0
617143,313,313,0,0,0
617166,133,133,0,0,0
617167,232,232,0,0,0
617175,345,345,0,0,0
617177,359,359,0,0,0
617178,44,44,0,0,0
617189,281,281,0,0,0
617193,2,2,0,0,0
617209,103,103,0,0,0
617216,353,353,0,0,0
617228,77,77,0,0,0
617232,315,315,0,0,0
617235,120,120,0,0,0
617236,103,103,0,0,0
617252,101,101,0,0,0
617285,58,58,0,0,0
617312,180,180,0,0,0
617323,77,77,0,0,0
617328,306,306,0,0,0
617339,313,313,0,0,0
617346,315,315,0,0,0
617348,2,2,0,0,0
617354,74,74,0,0,0
617361,39,39,0,0,0
617363,133,133,0,0,0
617366,35,35,0,0,0
617378,103,103,0,0,0
617386,168,168,0,0,0
617421,299,299,0,0,0
617433,171,171,0,0,0
617454,144,144,0,0,0
617460,70,70,0,0,0
617461,171,171,0,0,0
617468,255,255,0,0,0
617482,402,402,0,0,0
617498,359,359,0,0,0
617500,35,35,0,0,0
617525,251,251,0,0,0
617527,120,120,0,0,0
617536,306,306,0,0,0
617547,82,82,0,0,0
617552,121,121,0,0,0
617556,313,313,0,0,0
617578,201,201,0,0,0
617593,359,359,0,0,0
617595,7,7,0,0,0
617601,402,402,0,0,0
617606,282,282,0,0,0
617609,11,11,0,0,0
617615,4,4,0,0,0
617624,158,158,0,0,0
617626,310,310,0,0,0
617636,130,130,0,0,0
617651,158,158,0,0,0
617654,85,85,0,0,0
617667,281,281,0,0,0
617670,97,97,0,0,0
617681,310,310,0,0,0
617684,16,16,0,0,0
617691,252,252,0,0,0
617699,103,103,0,0,0
617707,1,1,0,0,0
617712,87,87,0,0,0
617717,87,87,0,0,0
617721,171,171,0,0,0
617740,16,16,0,0,0
617752,201,201,0,0,0
617764,158,158,0,0,0
617783,255,255,0,0,0
617807,87,87,0,0,0
617818,128,128,0,0,0
617823,232,232,0,0,0
617834,158,158,0,0,0
617837,184,184,0,0,0
617849,246,246,0,0,0
617861,54,54,0,0,0
617879,27,27,0,0,0
617882,299,299,0,0,0
617886,402,402,0,0,0
617904,102,102,0,0,0
617948,14,14,0,0,0
617953,259,259,0,0,0
617957,36,36,0,0,0
617959,246,246,0,0,0
617973,137,137,0,0,0
617998,255,255,0,0,0
618023,310,310,0,0,0
618026,72,72,0,0,0
618036,167,167,0,0,0
618051,50,50,0,0,0
618064,82,82,0,0,0
618075,29,29,0,0,0
618090,121,121,0,0,0
618100,102,102,0,0,0
618103,282,282,0,0,0
618106,345,345,0,0,0
618121,34,34,0,0,0
618123,251,251,0,0,0
618126,306,306,0,0,0
618137,132,132,0,0,0
618150,198,198,0,0,0
618152,171,171,0,0,0
618158,198,198,0,0,0
618161,359,359,0,0,0
618166,76,76,0,0,0
618169,137,137,0,0,0
618179,167,167,0,0,0
618180,163,163,0,0,0
618249,281,281,0,0,0
618251,56,56,0,0,0
618256,82,82,0,0,0
618257,15,15,0,0,0
618259,21,21,0,0,0
618261,313,313,0,0,0
618262,246,246,0,0,0
618280,27,27,0,0,0
618291,10,10,0,0,0
618292,313,313,0,0,0
618315,359,359,0,0,0
618319,353,353,0,0,0
618321,315,315,0,0,0
618334,131,131,0,0,0
618336,114,114,0,0,0
618347,299,299,0,0,0
618363,184,184,0,0,0
618366,193,193,0,0,0
618371,101,101,0,0,0
618377,167,167,0,0,0
618393,131,131,0,0,0
618406,151,151,0,0,0
618410,94,94,0,0,0
618417,282,282,0,0,0
618422,70,70,0,0,0
618423,255,255,0,0,0
618427,310,310,0,0,0
618442,201,201,0,0,0
618457,120,120,0,0,0
618465,137,137,0,0,0
618473,45,45,0,0,0
618479,259,259,0,0,0
618480,43,43,0,0,0
618483,43,43,0,0,0
618504,353,353,0,0,0
618524,76,76,0,0,0
618542,128,128,0,0,0
618573,114,114,0,0,0
618585,259,259,0,0,0
618614,114,114,0,0,0
618627,121,121,0,0,0
618642,41,41,0,0,0
618666,353,353,0,0,0
618671,198,198,0,0,0
618678,158,158,0,0,0
618679,76,76,0,0,0
618690,353,353,0,0,0
618696,306,306,0,0,0
618701,168,168,0,0,0
618703,70,70,0,0,0
618725,29,29,0,0,0
618743,66,66,0,0,0
618763,44,44,0,0,0
618777,14,14,0,0,0
618778,193,193,0,0,0
618812,66,66,0,0,0
618819,16,16,0,0,0
618825,67,67,0,0,0
618839,35,35,0,0,0
618852,313,313,0,0,0
618868,56,56,0,0,0
618879,255,255,0,0,0
618884,66,66,0,0,0
618889,44,44,0,0,0
618898,171,171,0,0,0
618918,299,299,0,0,0
618923,402,402,0,0,0
618928,57,57,0,0,0
618953,353,353,0,0,0
618976,77,77,0,0,0
619006,19,19,0,0,0
619020,193,193,0,0,0
619024,15,15,0,0,0
619035,4,4,0,0,0
619043,255,255,0,0,0
619045,76,76,0,0,0
619085,345,345,0,0,0
619087,76,76,0,0,0
619090,353,353,0,0,0
619104,198,198,0,0,0
619112,133,133,0,0,0
619132,102,102,0,0,0
619135,306,306,0,0,0
619144,310,310,0,0,0
619150,128,128,0,0,0
619186,18,18,0,0,0
619219,3,3,0,0,0
619222,17,17,0,0,0
619233,7,7,0,0,0
619235,50,50,0,0,0
619244,15,15,0,0,0
619245,158,158,0,0,0
619247,232,232,0,0,0
619252,184,184,0,0,0
619294,171,171,0,0,0
619300,315,315,0,0,0
619308,114,114,0,0,0
619325,310,310,0,0,0
619326,232,232,0,0,0
619330,75,75,0,0,0
619365,130,130,0,0,0
619367,168,168,0,0,0
619369,114,114,0,0,0
619393,128,128,0,0,0
619411,184,184,0,0,0
619420,34,34,0,0,0
619454,345,345,0,0,0
619456,7,7,0,0,0
619458,71,71,0,0,0
619460,32,32,0,0,0
619494,282,282,0,0,0
619510,251,251,0,0,0
619515,345,345,0,0,0
619529,184,184,0,0,0
619540,198,198,0,0,0
619561,102,102,0,0,0
619582,131,131,0,0,0
619583,83,83,0,0,0
619603,36,36,0,0,0
619611,102,102,0,0,0
619613,282,282,0,0,0
619623,18,18,0,0,0
619628,359,359,0,0,0
619659,201,201,0,0,0
619679,402,402,0,0,0
619682,315,315,0,0,0
619689,76,76,0,0,0
619690,168,168,0,0,0
619702,359,359,0,0,0
619720,353,353,0,0,0
619807,251,251,0,0,0
619844,121,121,0,0,0
619845,158,158,0,0,0
619850,353,353,0,0,0
619859,353,353,0,0,0
619863,102,102,0,0,0
619870,121,121,0,0,0
619878,120,120,0,0,0
619881,77,77,0,0,0
619882,58,58,0,0,0
619899,74,74,0,0,0
619905,345,345,0,0,0
619938,345,345,0,0,0
619943,76,76,0,0,0
619950,310,310,0,0,0
619951,143,143,0,0,0
619986,11,11,0,0,0
619998,232,232,0,0,0
620012,130,130,0,0,0
620028,6,6,0,0,0
620046,281,281,0,0,0
620059,151,151,0,0,0
620064,87,87,0,0,0
620072,22,22,0,0,0
620083,168,168,0,0,0
620092,23,23,0,0,0
620095,184,184,0,0,0
620098,282,282,0,0,0
620114,171,171,0,0,0
620125,310,310,0,0,0
620141,306,306,0,0,0
620142,402,402,0,0,0
620148,184,184,0,0,0
620155,201,201,0,0,0
620197,310,310,0,0,0
620202,359,359,0,0,0
620203,20,20,0,0,0
620220,281,281,0,0,0
620221,345,345,0,0,0
620223,39,39,0,0,0
620225,137,137,0,0,0
620247,315,315,0,0,0
620268,143,143,0,0,0
620304,282,282,0,0,0
620312,402,402,0,0,0
620326,152,152,0,0,0
620332,87,87,0,0,0
620333,10,10,0,0,0
620342,353,353,0,0,0
620346,121,121,0,0,0
620357,315,315,0,0,0
620358,120,120,0,0,0
620371,77,77,0,0,0
620388,66,66,0,0,0
620399,299,299,0,0,0
620400,193,193,0,0,0
620407,163,163,0,0,0
620414,315,315,0,0,0
620483,131,131,0,0,0
620510,345,345,0,0,0
620520,102,102,0,0,0
620522,56,56,0,0,0
620529,306,306,0,0,0
620532,103,103,0,0,0
620543,255,255,0,0,0
620550,24,24,0,0,0
620556,77,77,0,0,0
620578,315,315,0,0,0
620581,345,345,0,0,0
620583,44,44,0,0,0
620588,15,15,0,0,0
620607,101,101,0,0,0
620609,137,137,0,0,0
620610,66,66,0,0,0
620628,18,18,0,0,0
620632,114,114,0,0,0
620636,35,35,0,0,0
620638,74,74,0,0,0
620640,310,310,0,0,0
620660,69,69,0,0,0
620669,151,151,0,0,0
620674,15,15,0,0,0
620683,345,345,0,0,0
620720,402,402,0,0,0
620729,101,101,0,0,0
620736,180,180,0,0,0
620759,70,70,0,0,0
620760,168,168,0,0,0
620762,20,20,0,0,0
620781,402,402,0,0,0
620789,306,306,0,0,0
620792,102,102,0,0,0
620809,71,71,0,0,0
620819,315,315,0,0,0
620823,3,3,0,0,0
620843,7,7,0,0,0
620854,306,306,0,0,0
620858,70,70,0,0,0
620893,402,402,0,0,0
620898,113,113,0,0,0
620907,4,4,0,0,0
620920,193,193,0,0,0
620952,10,10,0,0,0
620962,70,70,0,0,0
620972,17,17,0,0,0
620994,180,180,0,0,0
621000,121,121,0,0,0
621006,128,128,0,0,0
621007,282,282,0,0,0
621019,94,94,0,0,0
621021,103,103,0,0,0
621032,20,20,0,0,0
621044,120,120,0,0,0
621057,27,27,0,0,0
621069,55,55,0,0,0
621083,72,72,0,0,0
621088,131,131,0,0,0
621102,345,345,0,0,0
621116,66,66,0,0,0
621121,315,315,0,0,0
621125,310,310,0,0,0
621126,74,74,0,0,0
621155,198,198,0,0,0
621177,198,198,0,0,0
621190,71,71,0,0,0
621203,114,114,0,0,0
621220,158,158,0,0,0
621225,83,83,0,0,0
621237,13,13,0,0,0
621252,151,151,0,0,0
621256,252,252,0,0,0
621268,131,131,0,0,0
621277,180,180,0,0,0
621289,251,251,0,0,0
621297,167,167,0,0,0
621313,132,132,0,0,0
621328,17,17,0,0,0
621329,353,353,0,0,0
621334,198,198,0,0,0
621345,3,3,0,0,0
621351,133,133,0,0,0
621359,251,251,0,0,0
621382,17,17,0,0,0
621383,315,315,0,0,0
621394,402,402,0,0,0
621399,20,20,0,0,0
621406,345,345,0,0,0
621409,252,252,0,0,0
621411,198,198,0,0,0
621463,353,353,0,0,0
621468,171,171,0,0,0
621478,18,18,0,0,0
621499,184,184,0,0,0
621502,143,143,0,0,0
621512,137,137,0,0,0
621519,55,55,0,0,0
621523,313,313,0,0,0
621536,20,20,0,0,0
621541,143,143,0,0,0
621547,27,27,0,0,0
621566,251,251,0,0,0
621580,255,255,0,0,0
621642,2,2,0,0,0
621655,114,114,0,0,0
621664,83,83,0,0,0
621672,133,133,0,0,0
621674,315,315,0,0,0
621681,345,345,0,0,0
621691,299,299,0,0,0
621695,114,114,0,0,0
621706,75,75,0,0,0
621712,201,201,0,0,0
621714,12,12,0,0,0
621717,315,315,0,0,0
621719,103,103,0,0,0
621721,201,201,0,0,0
621727,29,29,0,0,0
621729,246,246,0,0,0
621742,345,345,0,0,0
621757,83,83,0,0,0
621768,5,5,0,0,0
621776,255,255,0,0,0
621785,310,310,0,0,0
621789,29,29,0,0,0
621792,310,310,0,0,0
621822,345,345,0,0,0
621830,402,402,0,0,0
621860,133,133,0,0,0
621868,18,18,0,0,0
621870,282,282,0,0,0
621874,3,3,0,0,0
621887,131,131,0,0,0
621896,6,6,0,0,0
621908,74,74,0,0,0
621921,259,259,0,0,0
621941,402,402,0,0,0
621969,246,246,0,0,0
621970,76,76,0,0,0
621977,193,193,0,0,0
621985,55,55,0,0,0
621986,163,163,0,0,0
621989,246,246,0,0,0
621992,12,12,0,0,0
621994,18,18,0,0,0
622007,345,345,0,0,0
622009,310,310,0,0,0
622024,20,20,0,0,0
622046,353,353,0,0,0
622061,102,102,0,0,0
622064,167,167,0,0,0
622080,97,97,0,0,0
622084,282,282,0,0,0
622087,55,55,0,0,0
622121,232,232,0,0,0
622141,121,121,0,0,0
622167,102,102,0,0,0
622169,22,22,0,0,0
622172,74,74,0,0,0
622183,114,114,0,0,0
622188,345,345,0,0,0
622201,102,102,0,0,0
622213,306,306,0,0,0
622233,74,74,0,0,0
622245,102,102,0,0,0
622246,313,313,0,0,0
622254,76,76,0,0,0
622259,232,232,0,0,0
622274,20,20,0,0,0
622297,168,168,0,0,0
622307,144,144,0,0,0
622309,101,101,0,0,0
622310,5,5,0,0,0
622317,121,121,0,0,0
622319,143,143,0,0,0
622323,128,128,0,0,0
622328,65,65,0,0,0
622337,128,128,0,0,0
622343,76,76,0,0,0
622345,252,252,0,0,0
622358,252,252,0,0,0
622360,83,83,0,0,0
622367,75,75,0,0,0
622374,15,15,0,0,0
622376,163,163,0,0,0
622379,133,133,0,0,0
622393,246,246,0,0,0
622413,25,25,0,0,0
622414,34,34,0,0,0
622426,36,36,0,0,0
622439,246,246,0,0,0
622455,251,251,0,0,0
622463,232,232,0,0,0
622467,121,121,0,0,0
622494,246,246,0,0,0
622502,353,353,0,0,0
622503,103,103,0,0,0
622525,76,76,0,0,0
622557,143,143,0,0,0
622568,55,55,0,0,0
622572,45,45,0,0,0
622574,74,74,0,0,0
622606,5,5,0,0,0
622617,137,137,0,0,0
622618,43,43,0,0,0
622620,143,143,0,0,0
622668,359,359,0,0,0
622669,70,70,0,0,0
622682,133,133,0,0,0
622700,70,70,0,0,0
622718,252,252,0,0,0
622724,359,359,0,0,0
622728,15,15,0,0,0
622731,167,167,0,0,0
622754,137,137,0,0,0
622786,152,152,0,0,0
622790,402,402,0,0,0
622798,180,180,0,0,0
622799,40,40,0,0,0
622827,35,35,0,0,0
622834,353,353,0,0,0
622838,94,94,0,0,0
622843,193,193,0,0,0
622854,168,168,0,0,0
622878,163,163,0,0,0
622883,121,121,0,0,0
622885,128,128,0,0,0
622894,71,71,0,0,0
622898,120,120,0,0,0
622921,255,255,0,0,0
622932,163,163,0,0,0
622953,102,102,0,0,0
622959,63,63,0,0,0
622969,402,402,0,0,0
622996,313,313,0,0,0
623004,152,152,0,0,0
623013,299,299,0,0,0
623014,232,232,0,0,0
623020,255,255,0,0,0
623036,158,158,0,0,0
623048,310,310,0,0,0
623059,10,10,0,0,0
623068,315,315,0,0,0
623076,402,402,0,0,0
623082,137,137,0,0,0
623087,353,353,0,0,0
623093,282,282,0,0,0
623096,259,259,0,0,0
623098,310,310,0,0,0
623113,315,315,0,0,0
623124,94,94,0,0,0
623126,198,198,0,0,0
623134,83,83,0,0,0
623148,255,255,0,0,0
623167,163,163,0,0,0
623171,58,58,0,0,0
623183,158,158,0,0,0
623184,184,184,0,0,0
623193,193,193,0,0,0
623199,67,67,0,0,0
623200,402,402,0,0,0
623206,198,198,0,0,0
623223,39,39,0,0,0
623233,144,144,0,0,0
623248,198,198,0,0,0
623273,306,306,0,0,0
623292,27,27,0,0,0
623295,13,13,0,0,0
623303,77,77,0,0,0
623315,1,1,0,0,0
623320,359,359,0,0,0
623323,151,151,0,0,0
623332,83,83,0,0,0
623339,168,168,0,0,0
623345,353,353,0,0,0
623349,252,252,0,0,0
623373,251,251,0,0,0
623407,2,2,0,0,0
623416,3,3,0,0,0
623422,11,11,0,0,0
623423,36,36,0,0,0
623427,25,25,0,0,0
623439,102,102,0,0,0
623450,167,167,0,0,0
623466,58,58,0,0,0
623467,281,281,0,0,0
623471,158,158,0,0,0
623477,151,151,0,0,0
623519,184,184,0,0,0
623529,101,101,0,0,0
623539,29,29,0,0,0
623543,402,402,0,0,0
623544,143,143,0,0,0
623561,12,12,0,0,0
623565,246,246,0,0,0
623569,128,128,0,0,0
623576,359,359,0,0,0
623579,58,58,0,0,0
623588,40,40,0,0,0
623597,50,50,0,0,0
623606,353,353,0,0,0
623610,310,310,0,0,0
623617,353,353,0,0,0
623666,128,128,0,0,0
623676,70,70,0,0,0
623729,144,144,0,0,0
623756,310,310,0,0,0
623787,27,27,0,0,0
623793,151,151,0,0,0
623795,128,128,0,0,0
623802,14,14,0,0,0
623811,310,310,0,0,0
623818,193,193,0,0,0
623834,402,402,0,0,0
623842,353,353,0,0,0
623849,144,144,0,0,0
623859,402,402,0,0,0
623884,282,282,0,0,0
623889,97,97,0,0,0
623890,193,193,0,0,0
623891,402,402,0,0,0
623901,130,130,0,0,0
623922,345,345,0,0,0
623923,310,310,0,0,0
623924,232,232,0,0,0
623935,97,97,0,0,0
623941,306,306,0,0,0
623972,163,163,0,0,0
623979,252,252,0,0,0
624014,56,56,0,0,0
624018,32,32,0,0,0
624040,353,353,0,0,0
624071,158,158,0,0,0
624075,15,15,0,0,0
624102,7,7,0,0,0
624113,39,39,0,0,0
624122,232,232,0,0,0
624158,299,299,0,0,0
624163,152,152,0,0,0
624164,56,56,0,0,0
624173,143,143,0,0,0
624181,67,67,0,0,0
624198,72,72,0,0,0
624212,171,171,0,0,0
624214,102,102,0,0,0
624271,54,54,0,0,0
624273,402,402,0,0,0
624280,167,167,0,0,0
624301,281,281,0,0,0
624311,198,198,0,0,0
624331,299,299,0,0,0
624333,281,281,0,0,0
624349,8,8,0,0,0
624361,70,70,0,0,0
624362,15,15,0,0,0
624367,102,102,0,0,0
624373,345,345,0,0,0
624387,113,113,0,0,0
624391,402,402,0,0,0
624395,131,131,0,0,0
624397,114,114,0,0,0
624415,259,259,0,0,0
624426,168,168,0,0,0
624436,252,252,0,0,0
624466,246,246,0,0,0
624499,58,58,0,0,0
624500,13,13,0,0,0
624507,251,251,0,0,0
624523,102,102,0,0,0
624526,281,281,0,0,0
624539,121,121,0,0,0
624569,246,246,0,0,0
624581,12,12,0,0,0
624588,113,113,0,0,0
624614,315,315,0,0,0
624619,69,69,0,0,0
624626,23,23,0,0,0
624634,24,24,0,0,0
624647,120,120,0,0,0
624669,306,306,0,0,0
624686,359,359,0,0,0
624690,402,402,0,0,0
624699,144,144,0,0,0
624702,246,246,0,0,0
624704,158,158,0,0,0
624708,83,83,0,0,0
624719,313,313,0,0,0
624733,121,121,0,0,0
624761,198,198,0,0,0
624783,201,201,0,0,0
624791,66,66,0,0,0
624796,167,167,0,0,0
624821,402,402,0,0,0
624822,171,171,0,0,0
624824,24,24,0,0,0
624836,87,87,0,0,0
624854,103,103,0,0,0
624870,137,137,0,0,0
624878,74,74,0,0,0
624882,94,94,0,0,0
624890,24,24,0,0,0
624915,63,63,0,0,0
624923,113,113,0,0,0
624934,76,76,0,0,0
624945,76,76,0,0,0
624960,83,83,0,0,0
624962,402,402,0,0,0
624968,163,163,0,0,0
624969,102,102,0,0,0
624972,85,85,0,0,0
624993,83,83,0,0,0
624999,128,128,0,0,0
625004,114,114,0,0,0
625006,251,251,0,0,0
625034,193,193,0,0,0
625036,76,76,0,0,0
625043,137,137,0,0,0
625046,76,76,0,0,0
625049,17,17,0,0,0
625051,67,67,0,0,0
625092,359,359,0,0,0
625101,43,43,0,0,0
625102,201,201,0,0,0
625104,29,29,0,0,0
625114,144,144,0,0,0
625119,15,15,0,0,0
625130,4,4,0,0,0
625131,168,168,0,0,0
625139,282,282,0,0,0
625147,131,131,0,0,0
625160,83,83,0,0,0
625165,359,359,0,0,0
625171,32,32,0,0,0
625177,67,67,0,0,0
625193,54,54,0,0,0
625198,76,76,0,0,0
625215,180,180,0,0,0
625218,315,315,0,0,0
625230,65,65,0,0,0
625232,345,345,0,0,0
625254,76,76,0,0,0
625267,359,359,0,0,0
625270,12,12,0,0,0
625282,259,259,0,0,0
625292,281,281,0,0,0
625318,113,113,0,0,0
625379,74,74,0,0,0
625382,282,282,0,0,0
625389,103,103,0,0,0
625398,15,15,0,0,0
625401,180,180,0,0,0
625418,12,12,0,0,0
625423,359,359,0,0,0
625443,113,113,0,0,0
625475,158,158,0,0,0
625494,232,232,0,0,0
625495,353,353,0,0,0
625496,259,259,0,0,0
625541,315,315,0,0,0
625546,251,251,0,0,0
625560,345,345,0,0,0
625580,76,76,0,0,0
625581,306,306,0,0,0
625583,259,259,0,0,0
625585,102,102,0,0,0
625586,67,67,0,0,0
625599,251,251,0,0,0
625617,10,10,0,0,0
625651,193,193,0,0,0
625656,97,97,0,0,0
625669,20,20,0,0,0
625686,252,252,0,0,0
625691,56,56,0,0,0
625692,5,5,0,0,0
625707,16,16,0,0,0
625712,310,310,0,0,0
625716,82,82,0,0,0
625727,232,232,0,0,0
625736,359,359,0,0,0
625739,130,130,0,0,0
625748,120,120,0,0,0
625750,152,152,0,0,0
625751,232,232,0,0,0
625752,143,143,0,0,0
625757,184,184,0,0,0
625761,50,50,0,0,0
625762,121,121,0,0,0
625772,35,35,0,0,0
625792,56,56,0,0,0
625799,144,144,0,0,0
625802,102,102,0,0,0
625820,255,255,0,0,0
625825,36,36,0,0,0
625829,306,306,0,0,0
625831,7,7,0,0,0
625834,97,97,0,0,0
625837,10,10,0,0,0
625854,133,133,0,0,0
625857,27,27,0,0,0
625858,15,15,0,0,0
625880,143,143,0,0,0
625895,151,151,0,0,0
625905,259,259,0,0,0
625910,353,353,0,0,0
625930,70,70,0,0,0
625968,402,402,0,0,0
625980,180,180,0,0,0
625988,359,359,0,0,0
626004,16,16,0,0,0
626011,97,97,0,0,0
626013,70,70,0,0,0
626034,121,121,0,0,0
626036,132,132,0,0,0
626042,58,58,0,0,0
626054,34,34,0,0,0
626070,34,34,0,0,0
626078,4,4,0,0,0
626079,184,184,0,0,0
626085,66,66,0,0,0
626088,121,121,0,0,0
626103,168,168,0,0,0
626113,137,137,0,0,0
626123,246,246,0,0,0
626154,198,198,0,0,0
626155,18,18,0,0,0
626165,310,310,0,0,0
626167,12,12,0,0,0
626172,121,121,0,0,0
626176,315,315,0,0,0
626222,101,101,0,0,0
626244,70,70,0,0,0
626266,246,246,0,0,0
626299,281,281,0,0,0
626312,74,74,0,0,0
626314,25,25,0,0,0
626325,359,359,0,0,0
626327,133,133,0,0,0
626349,20,20,0,0,0
626358,345,345,0,0,0
626366,151,151,0,0,0
626367,402,402,0,0,0
626389,27,27,0,0,0
626396,315,315,0,0,0
626424,402,402,0,0,0
626428,128,128,0,0,0
626436,87,87,0,0,0
626443,44,44,0,0,0
626458,103,103,0,0,0
626463,158,158,0,0,0
626464,58,58,0,0,0
626478,232,232,0,0,0
626517,201,201,0,0,0
626522,16,16,0,0,0
626529,167,167,0,0,0
626532,201,201,0,0,0
626534,114,114,0,0,0
626545,8,8,0,0,0
626558,103,103,0,0,0
626571,345,345,0,0,0
626580,180,180,0,0,0
626589,315,315,0,0,0
626595,299,299,0,0,0
626603,252,252,0,0,0
626614,163,163,0,0,0
626616,19,19,0,0,0
626638,163,163,0,0,0
626647,402,402,0,0,0
626649,259,259,0,0,0
626671,345,345,0,0,0
626682,34,34,0,0,0
626684,299,299,0,0,0
626689,121,121,0,0,0
626690,69,69,0,0,0
626704,180,180,0,0,0
626710,70,70,0,0,0
626757,255,255,0,0,0
626768,65,65,0,0,0
626781,128,128,0,0,0
626802,313,313,0,0,0
626811,315,315,0,0,0
626827,76,76,0,0,0
626838,32,32,0,0,0
626844,7,7,0,0,0
626847,10,10,0,0,0
626850,36,36,0,0,0
626854,10,10,0,0,0
626860,246,246,0,0,0
626865,201,201,0,0,0
626868,101,101,0,0,0
626872,20,20,0,0,0
626903,184,184,0,0,0
626905,282,282,0,0,0
626929,15,15,0,0,0
626948,101,101,0,0,0
626952,180,180,0,0,0
626953,144,144,0,0,0
626974,25,25,0,0,0
626976,252,252,0,0,0
626979,114,114,0,0,0
626984,24,24,0,0,0
627018,359,359,0,0,0
627034,259,259,0,0,0
627035,171,171,0,0,0
627036,54,54,0,0,0
627042,144,144,0,0,0
627049,201,201,0,0,0
627060,36,36,0,0,0
627062,15,15,0,0,0
627069,259,259,0,0,0
627072,259,259,0,0,0
627080,74,74,0,0,0
627082,158,158,0,0,0
627084,345,345,0,0,0
627091,75,75,0,0,0
627120,25,25,0,0,0
627123,74,74,0,0,0
627127,21,21,0,0,0
627151,74,74,0,0,0
627155,76,76,0,0,0
627170,198,198,0,0,0
627176,168,168,0,0,0
627182,2,2,0,0,0
627195,67,67,0,0,0
627196,56,56,0,0,0
627201,252,252,0,0,0
627202,353,353,0,0,0
627213,143,143,0,0,0
627214,63,63,0,0,0
627229,15,15,0,0,0
627263,315,315,0,0,0
627286,39,39,0,0,0
627291,55,55,0,0,0
627295,35,35,0,0,0
627305,315,315,0,0,0
627310,163,163,0,0,0
627318,13,13,0,0,0
627330,353,353,0,0,0
627348,255,255,0,0,0
627362,1,1,0,0,0
627387,50,50,0,0,0
627395,158,158,0,0,0
627412,43,43,0,0,0
627425,55,55,0,0,0
627432,11,11,0,0,0
627435,315,315,0,0,0
627460,353,353,0,0,0
627468,198,198,0,0,0
627482,27,27,0,0,0
627494,56,56,0,0,0
627495,9,9,0,0,0
627501,282,282,0,0,0
627502,56,56,0,0,0
627503,299,299,0,0,0
627521,402,402,0,0,0
627524,6,6,0,0,0
627537,193,193,0,0,0
627540,102,102,0,0,0
627549,36,36,0,0,0
627569,36,36,0,0,0
627596,152,152,0,0,0
627603,402,402,0,0,0
627614,101,101,0,0,0
627616,281,281,0,0,0
627625,198,198,0,0,0
627628,251,251,0,0,0
627629,313,313,0,0,0
627635,282,282,0,0,0
627651,282,282,0,0,0
627668,66,66,0,0,0
627671,101,101,0,0,0
627704,255,255,0,0,0
627711,101,101,0,0,0
627724,402,402,0,0,0
627732,15,15,0,0,0
627745,94,94,0,0,0
627767,353,353,0,0,0
627773,345,345,0,0,0
627800,163,163,0,0,0
627815,282,282,0,0,0
627818,29,29,0,0,0
627834,180,180,0,0,0
627854,143,143,0,0,0
627876,34,34,0,0,0
627894,152,152,0,0,0
627922,29,29,0,0,0
627928,281,281,0,0,0
627957,402,402,0,0,0
627959,151,151,0,0,0
627960,232,232,0,0,0
627968,131,131,0,0,0
627977,58,58,0,0,0
627981,102,102,0,0,0
627993,313,313,0,0,0
628001,32,32,0,0,0
628007,6,6,0,0,0
628019,255,255,0,0,0
628057,246,246,0,0,0
628060,299,299,0,0,0
628074,97,97,0,0,0
628080,97,97,0,0,0
628093,8,8,0,0,0
628096,4,4,0,0,0
628106,83,83,0,0,0
628118,193,193,0,0,0
628130,255,255,0,0,0
628139,345,345,0,0,0
628169,15,15,0,0,0
628176,120,120,0,0,0
628189,121,121,0,0,0
628222,151,151,0,0,0
628223,87,87,0,0,0
628227,43,43,0,0,0
628228,65,65,0,0,0
628266,102,102,0,0,0
628269,259,259,0,0,0
628281,144,144,0,0,0
628288,232,232,0,0,0
628293,167,167,0,0,0
628305,54,54,0,0,0
628334,13,13,0,0,0
628362,345,345,0,0,0
628379,22,22,0,0,0
628386,85,85,0,0,0
628395,6,6,0,0,0
628406,44,44,0,0,0
628409,345,345,0,0,0
628426,29,29,0,0,0
628439,143,143,0,0,0
628446,158,158,0,0,0
628456,345,345,0,0,0
628484,167,167,0,0,0
628491,131,131,0,0,0
628495,306,306,0,0,0
628498,66,66,0,0,0
628500,121,121,0,0,0
628506,24,24,0,0,0
628512,102,102,0,0,0
628516,14,14,0,0,0
628519,345,345,0,0,0
628533,45,45,0,0,0
628543,310,310,0,0,0
628545,359,359,0,0,0
628548,246,246,0,0,0
628551,128,128,0,0,0
628555,76,76,0,0,0
628562,353,353,0,0,0
628569,201,201,0,0,0
628600,246,246,0,0,0
628605,246,246,0,0,0
628612,70,70,0,0,0
628633,281,281,0,0,0
628642,252,252,0,0,0
628653,94,94,0,0,0
628671,251,251,0,0,0
628693,313,313,0,0,0
628697,402,402,0,0,0
628739,167,167,0,0,0
628740,56,56,0,0,0
628750,345,345,0,0,0
628788,71,71,0,0,0
628796,57,57,0,0,0
628799,353,353,0,0,0
628811,36,36,0,0,0
628863,7,7,0,0,0
628868,128,128,0,0,0
628873,36,36,0,0,0
628893,252,252,0,0,0
628902,102,102,0,0,0
628913,353,353,0,0,0
628915,198,198,0,0,0
628921,345,345,0,0,0
628931,359,359,0,0,0
628941,315,315,0,0,0
628980,144,144,0,0,0
628992,20,20,0,0,0
629008,41,41,0,0,0
629019,315,315,0,0,0
629026,22,22,0,0,0
629031,130,130,0,0,0
629037,232,232,0,0,0
629038,74,74,0,0,0
629048,299,299,0,0,0
629054,345,345,0,0,0
629057,2,2,0,0,0
629059,255,255,0,0,0
629074,193,193,0,0,0
629094,345,345,0,0,0
629097,251,251,0,0,0
629098,132,132,0,0,0
629124,17,17,0,0,0
629126,299,299,0,0,0
629131,87,87,0,0,0
629156,345,345,0,0,0
629163,163,163,0,0,0
629178,24,24,0,0,0
629184,402,402,0,0,0
629195,259,259,0,0,0
629197,15,15,0,0,0
629198,281,281,0,0,0
629200,114,114,0,0,0
629235,83,83,0,0,0
629249,25,25,0,0,0
629264,184,184,0,0,0
629268,36,36,0,0,0
629276,315,315,0,0,0
629299,3,3,0,0,0
629301,198,198,0,0,0
629328,359,359,0,0,0
629331,114,114,0,0,0
629339,345,345,0,0,0
629347,83,83,0,0,0
629370,102,102,0,0,0
629371,184,184,0,0,0
629373,70,70,0,0,0
629376,359,359,0,0,0
629379,22,22,0,0,0
629385,345,345,0,0,0
629413,171,171,0,0,0
629451,20,20,0,0,0
629481,2,2,0,0,0
629507,359,359,0,0,0
629516,27,27,0,0,0
629523,184,184,0,0,0
629534,8,8,0,0,0
629550,137,137,0,0,0
629559,7,7,0,0,0
629562,39,39,0,0,0
629564,43,43,0,0,0
629581,20,20,0,0,0
629603,102,102,0,0,0
629629,299,299,0,0,0
629644,17,17,0,0,0
629649,74,74,0,0,0
629668,121,121,0,0,0
629669,29,29,0,0,0
629688,198,198,0,0,0
629691,35,35,0,0,0
629695,306,306,0,0,0
629696,137,137,0,0,0
629730,113,113,0,0,0
629740,259,259,0,0,0
629742,345,345,0,0,0
629744,40,40,0,0,0
629749,359,359,0,0,0
629750,29,29,0,0,0
629764,315,315,0,0,0
629776,193,193,0,0,0
629779,168,168,0,0,0
629803,137,137,0,0,0
629820,76,76,0,0,0
629824,251,251,0,0,0
629829,168,168,0,0,0
629831,152,152,0,0,0
629842,13,13,0,0,0
629843,35,35,0,0,0
629850,63,63,0,0,0
629852,13,13,0,0,0
629870,30,30,0,0,0
629873,58,58,0,0,0
629879,102,102,0,0,0
629888,306,306,0,0,0
629897,102,102,0,0,0
629933,20,20,0,0,0
629940,246,246,0,0,0
629971,246,246,0,0,0
629982,158,158,0,0,0
629987,310,310,0,0,0
629988,402,402,0,0,0
630004,120,120,0,0,0
630010,151,151,0,0,0
630024,43,43,0,0,0
630046,74,74,0,0,0
630055,102,102,0,0,0
630066,133,133,0,0,0
630080,3,3,0,0,0
630092,121,121,0,0,0
630095,252,252,0,0,0
630102,168,168,0,0,0
630125,101,101,0,0,0
630127,198,198,0,0,0
630129,345,345,0,0,0
630130,353,353,0,0,0
630132,252,252,0,0,0
630134,74,74,0,0,0
630149,8,8,0,0,0
630188,201,201,0,0,0
630219,246,246,0,0,0
630225,102,102,0,0,0
630228,137,137,0,0,0
630238,7,7,0,0,0
630253,143,143,0,0,0
630268,144,144,0,0,0
630276,313,313,0,0,0
630278,25,25,0,0,0
630288,120,120,0,0,0
630291,359,359,0,0,0
630301,29,29,0,0,0
630308,70,70,0,0,0
630311,137,137,0,0,0
630324,25,25,0,0,0
630331,232,232,0,0,0
630344,306,306,0,0,0
630351,193,193,0,0,0
630364,232,232,0,0,0
630382,402,402,0,0,0
630403,65,65,0,0,0
630437,121,121,0,0,0
630450,144,144,0,0,0
630455,345,345,0,0,0
630471,132,132,0,0,0
630479,40,40,0,0,0
630487,77,77,0,0,0
630488,18,18,0,0,0
630489,402,402,0,0,0
630498,158,158,0,0,0
630501,63,63,0,0,0
630541,97,97,0,0,0
630542,4,4,0,0,0
630546,132,132,0,0,0
630549,359,359,0,0,0
630562,27,27,0,0,0
630580,144,144,0,0,0
630585,70,70,0,0,0
630605,120,120,0,0,0
630631,102,102,0,0,0
630639,252,252,0,0,0
630651,76,76,0,0,0
630676,133,133,0,0,0
630688,281,281,0,0,0
630694,252,252,0,0,0
630713,137,137,0,0,0
630719,3,3,0,0,0
630744,282,282,0,0,0
630753,252,252,0,0,0
630755,77,77,0,0,0
630756,54,54,0,0,0
630762,201,201,0,0,0
630763,18,18,0,0,0
630774,306,306,0,0,0
630776,74,74,0,0,0
630785,102,102,0,0,0
630812,70,70,0,0,0
630827,198,198,0,0,0
630906,24,24,0,0,0
630928,345,345,0,0,0
630935,353,353,0,0,0
630945,101,101,0,0,0
630949,70,70,0,0,0
630960,71,71,0,0,0
630967,20,20,0,0,0
630970,137,137,0,0,0
630986,315,315,0,0,0
630991,114,114,0,0,0
631000,3,3,0,0,0
631019,315,315,0,0,0
631030,193,193,0,0,0
631032,63,63,0,0,0
631063,10,10,0,0,0
631079,102,102,0,0,0
631082,193,193,0,0,0
631084,137,137,0,0,0
631100,137,137,0,0,0
631115,255,255,0,0,0
631119,171,171,0,0,0
631138,310,310,0,0,0
631145,232,232,0,0,0
631146,72,72,0,0,0
631160,402,402,0,0,0
631162,16,16,0,0,0
631183,94,94,0,0,0
631185,70,70,0,0,0
631194,121,121,0,0,0
631202,128,128,0,0,0
631219,76,76,0,0,0
631227,44,44,0,0,0
631233,43,43,0,0,0
631236,35,35,0,0,0
631237,152,152,0,0,0
631305,23,23,0,0,0
631321,152,152,0,0,0
631328,9,9,0,0,0
631339,7,7,0,0,0
631370,17,17,0,0,0
631373,15,15,0,0,0
631374,299,299,0,0,0
631390,132,132,0,0,0
631391,10,10,0,0,0
631416,152,152,0,0,0
631436,82,82,0,0,0
631437,167,167,0,0,0
631448,29,29,0,0,0
631454,251,251,0,0,0
631457,114,114,0,0,0
631469,282,282,0,0,0
631473,3,3,0,0,0
631479,75,75,0,0,0
631497,8,8,0,0,0
631501,36,36,0,0,0
631508,315,315,0,0,0
631524,23,23,0,0,0
631530,402,402,0,0,0
631534,15,15,0,0,0
631558,259,259,0,0,0
631561,306,306,0,0,0
631577,315,315,0,0,0
631588,102,102,0,0,0
631589,103,103,0,0,0
631605,132,132,0,0,0
631616,9,9,0,0,0
631618,163,163,0,0,0
631619,143,143,0,0,0
631622,137,137,0,0,0
631642,56,56,0,0,0
631680,72,72,0,0,0
631685,259,259,0,0,0
631688,4,4,0,0,0
631708,101,101,0,0,0
631718,299,299,0,0,0
631721,255,255,0,0,0
631748,246,246,0,0,0
631750,255,255,0,0,0
631751,50,50,0,0,0
631785,345,345,0,0,0
631796,359,359,0,0,0
631800,11,11,0,0,0
631847,315,315,0,0,0
631861,246,246,0,0,0
631863,10,10,0,0,0
631870,137,137,0,0,0
631873,313,313,0,0,0
631877,45,45,0,0,0
631898,131,131,0,0,0
631903,15,15,0,0,0
631918,35,35,0,0,0
631932,25,25,0,0,0
631942,94,94,0,0,0
631956,282,282,0,0,0
631958,306,306,0,0,0
631961,198,198,0,0,0
631986,76,76,0,0,0
631988,75,75,0,0,0
631990,402,402,0,0,0
632014,10,10,0,0,0
632022,315,315,0,0,0
632038,72,72,0,0,0
632044,158,158,0,0,0
632047,315,315,0,0,0
632051,102,102,0,0,0
632052,75,75,0,0,0
632076,39,39,0,0,0
632084,10,10,0,0,0
632097,143,143,0,0,0
632113,353,353,0,0,0
632114,252,252,0,0,0
632132,259,259,0,0,0
632145,167,167,0,0,0
632156,282,282,0,0,0
632158,75,75,0,0,0
632188,252,252,0,0,0
632203,130,130,0,0,0
632205,255,255,0,0,0
632208,3,3,0,0,0
632213,171,171,0,0,0
632225,120,120,0,0,0
632257,83,83,0,0,0
632260,193,193,0,0,0
632261,120,120,0,0,0
632266,259,259,0,0,0
632270,313,313,0,0,0
632282,198,198,0,0,0
632294,184,184,0,0,0
632299,34,34,0,0,0
632322,299,299,0,0,0
632358,163,163,0,0,0
632373,14,14,0,0,0
632398,282,282,0,0,0
632416,282,282,0,0,0
632424,232,232,0,0,0
632425,306,306,0,0,0
632440,255,255,0,0,0
632446,152,152,0,0,0
632456,315,315,0,0,0
632464,83,83,0,0,0
632468,143,143,0,0,0
632471,137,137,0,0,0
632482,128,128,0,0,0
632492,168,168,0,0,0
632495,306,306,0,0,0
632498,201,201,0,0,0
632505,345,345,0,0,0
632512,19,19,0,0,0
632514,246,246,0,0,0
632533,402,402,0,0,0
632547,353,353,0,0,0
632563,19,19,0,0,0
632566,143,143,0,0,0
632586,167,167,0,0,0
632606,1,1,0,0,0
632608,114,114,0,0,0
632643,27,27,0,0,0
632647,120,120,0,0,0
632653,67,67,0,0,0
632672,167,167,0,0,0
632678,18,18,0,0,0
632696,102,102,0,0,0
632712,18,18,0,0,0
632721,158,158,0,0,0
632733,35,35,0,0,0
632734,85,85,0,0,0
632738,102,102,0,0,0
632745,345,345,0,0,0
632752,5,5,0,0,0
632778,5,5,0,0,0
632802,66,66,0,0,0
632811,137,137,0,0,0
632837,102,102,0,0,0
632844,55,55,0,0,0
632853,251,251,0,0,0
632878,198,198,0,0,0
632895,315,315,0,0,0
632898,83,83,0,0,0
632902,130,130,0,0,0
632921,252,252,0,0,0
632922,102,102,0,0,0
632924,11,11,0,0,0
632933,8,8,0,0,0
632939,76,76,0,0,0
632955,137,137,0,0,0
632967,143,143,0,0,0
632971,121,121,0,0,0
632976,259,259,0,0,0
632991,180,180,0,0,0
633011,281,281,0,0,0
633022,246,246,0,0,0
633057,14,14,0,0,0
633070,102,102,0,0,0
633085,282,282,0,0,0
633096,137,137,0,0,0
633105,74,74,0,0,0
633107,359,359,0,0,0
633131,12,12,0,0,0
633166,15,15,0,0,0
633167,310,310,0,0,0
633169,151,151,0,0,0
633170,24,24,0,0,0
633173,3,3,0,0,0
633191,114,114,0,0,0
633217,255,255,0,0,0
633218,345,345,0,0,0
633226,77,77,0,0,0
633228,282,282,0,0,0
633234,353,353,0,0,0
633237,10,10,0,0,0
633239,198,198,0,0,0
633241,359,359,0,0,0
633253,313,313,0,0,0
633271,168,168,0,0,0
633286,121,121,0,0,0
633289,35,35,0,0,0
633290,180,180,0,0,0
633295,315,315,0,0,0
633310,198,198,0,0,0
633315,313,313,0,0,0
633348,2,2,0,0,0
633353,58,58,0,0,0
633401,27,27,0,0,0
633429,180,180,0,0,0
633433,36,36,0,0,0
633449,282,282,0,0,0
633475,345,345,0,0,0
633478,201,201,0,0,0
633507,255,255,0,0,0
633512,102,102,0,0,0
633521,402,402,0,0,0
633548,402,402,0,0,0
633553,252,252,0,0,0
633554,58,58,0,0,0
633564,27,27,0,0,0
633593,102,102,0,0,0
633595,201,201,0,0,0
633613,114,114,0,0,0
633615,144,144,0,0,0
633622,18,18,0,0,0
633631,246,246,0,0,0
633634,180,180,0,0,0
633655,94,94,0,0,0
633675,313,313,0,0,0
633681,34,34,0,0,0
633683,44,44,0,0,0
633694,75,75,0,0,0
633698,54,54,0,0,0
633725,246,246,0,0,0
633726,259,259,0,0,0
633731,310,310,0,0,0
633742,310,310,0,0,0
633758,313,313,0,0,0
633787,299,299,0,0,0
633799,345,345,0,0,0
633804,306,306,0,0,0
633805,143,143,0,0,0
633813,41,41,0,0,0
633815,137,137,0,0,0
633822,12,12,0,0,0
633863,137,137,0,0,0
633891,56,56,0,0,0
633896,114,114,0,0,0
633913,130,130,0,0,0
633914,19,19,0,0,0
633922,35,35,0,0,0
633925,11,11,0,0,0
633928,353,353,0,0,0
633949,259,259,0,0,0
633954,246,246,0,0,0
633958,255,255,0,0,0
633959,158,158,0,0,0
633986,102,102,0,0,0
634011,131,131,0,0,0
634018,128,128,0,0,0
634031,167,167,0,0,0
634033,65,65,0,0,0
634047,252,252,0,0,0
634054,259,259,0,0,0
634078,353,353,0,0,0
634083,299,299,0,0,0
634094,97,97,0,0,0
634100,25,25,0,0,0
634101,34,34,0,0,0
634109,315,315,0,0,0
634124,345,345,0,0,0
634140,19,19,0,0,0
634147,121,121,0,0,0
634151,29,29,0,0,0
634153,353,353,0,0,0
634164,16,16,0,0,0
634194,133,133,0,0,0
634200,184,184,0,0,0
634209,353,353,0,0,0
634230,102,102,0,0,0
634237,259,259,0,0,0
634269,114,114,0,0,0
634282,102,102,0,0,0
634286,306,306,0,0,0
634303,180,180,0,0,0
634314,102,102,0,0,0
634319,180,180,0,0,0
634323,171,171,0,0,0
634327,121,121,0,0,0
634346,41,41,0,0,0
634378,102,102,0,0,0
634380,168,168,0,0,0
634381,402,402,0,0,0
634401,152,152,0,0,0
634419,18,18,0,0,0
634440,163,163,0,0,0
634441,143,143,0,0,0
634442,101,101,0,0,0
634447,102,102,0,0,0
634450,345,345,0,0,0
634462,167,167,0,0,0
634466,87,87,0,0,0
634467,36,36,0,0,0
634483,114,114,0,0,0
634489,3,3,0,0,0
634491,299,299,0,0,0
634492,22,22,0,0,0
634501,17,17,0,0,0
634505,44,44,0,0,0
634509,158,158,0,0,0
634512,306,306,0,0,0
634513,345,345,0,0,0
634550,310,310,0,0,0
634553,102,102,0,0,0
634559,402,402,0,0,0
634571,58,58,0,0,0
634574,143,143,0,0,0
634585,75,75,0,0,0
634586,282,282,0,0,0
634632,13,13,0,0,0
634637,184,184,0,0,0
634644,76,76,0,0,0
634654,97,97,0,0,0
634656,281,281,0,0,0
634658,143,143,0,0,0
634670,5,5,0,0,0
634671,402,402,0,0,0
634672,143,143,0,0,0
634673,66,66,0,0,0
634688,180,180,0,0,0
634699,57,57,0,0,0
634704,40,40,0,0,0
634709,144,144,0,0,0
634711,133,133,0,0,0
634713,402,402,0,0,0
634737,45,45,0,0,0
634739,101,101,0,0,0
634741,168,168,0,0,0
634746,32,32,0,0,0
634753,5,5,0,0,0
634763,252,252,0,0,0
634765,6,6,0,0,0
634774,313,313,0,0,0
634786,353,353,0,0,0
634790,353,353,0,0,0
634815,121,121,0,0,0
634830,299,299,0,0,0
634855,315,315,0,0,0
634864,281,281,0,0,0
634880,114,114,0,0,0
634895,306,306,0,0,0
634898,282,282,0,0,0
634906,83,83,0,0,0
634940,35,35,0,0,0
634947,168,168,0,0,0
634949,251,251,0,0,0
634955,299,299,0,0,0
634957,281,281,0,0,0
634959,101,101,0,0,0
634961,402,402,0,0,0
634969,94,94,0,0,0
635004,3,3,0,0,0
635015,353,353,0,0,0
635026,255,255,0,0,0
635040,87,87,0,0,0
635046,39,39,0,0,0
635047,402,402,0,0,0
635051,4,4,0,0,0
635071,313,313,0,0,0
635073,259,259,0,0,0
635077,18,18,0,0,0
635078,198,198,0,0,0
635099,24,24,0,0,0
635114,69,69,0,0,0
635140,353,353,0,0,0
635145,25,25,0,0,0
635169,17,17,0,0,0
635171,8,8,0,0,0
635181,246,246,0,0,0
635193,102,102,0,0,0
635195,58,58,0,0,0
635199,25,25,0,0,0
635203,4,4,0,0,0
635207,144,144,0,0,0
635209,353,353,0,0,0
635214,76,76,0,0,0
635237,5,5,0,0,0
635244,114,114,0,0,0
635246,34,34,0,0,0
635250,151,151,0,0,0
635251,143,143,0,0,0
635258,359,359,0,0,0
635264,128,128,0,0,0
635292,113,113,0,0,0
635295,232,232,0,0,0
635308,27,27,0,0,0
635341,56,56,0,0,0
635351,69,69,0,0,0
635353,158,158,0,0,0
635410,144,144,0,0,0
635415,345,345,0,0,0
635446,310,310,0,0,0
635465,359,359,0,0,0
635477,85,85,0,0,0
635483,259,259,0,0,0
635494,306,306,0,0,0
635512,310,310,0,0,0
635515,16,16,0,0,0
635516,6,6,0,0,0
635529,13,13,0,0,0
635537,201,201,0,0,0
635554,402,402,0,0,0
635566,6,6,0,0,0
635568,345,345,0,0,0
635586,16,16,0,0,0
635598,201,201,0,0,0
635617,299,299,0,0,0
635619,17,17,0,0,0
635624,193,193,0,0,0
635633,121,121,0,0,0
635639,128,128,0,0,0
635641,131,131,0,0,0
635652,1,1,0,0,0
635655,259,259,0,0,0
635661,9,9,0,0,0
635666,43,43,0,0,0
635667,184,184,0,0,0
635698,113,113,0,0,0
635733,22,22,0,0,0
635748,66,66,0,0,0
635749,251,251,0,0,0
635753,345,345,0,0,0
635761,232,232,0,0,0
635767,70,70,0,0,0
635770,306,306,0,0,0
635775,137,137,0,0,0
635794,255,255,0,0,0
635814,168,168,0,0,0
635832,19,19,0,0,0
635837,310,310,0,0,0
635850,120,120,0,0,0
635862,43,43,0,0,0
635902,69,69,0,0,0
635912,152,152,0,0,0
635923,151,151,0,0,0
635933,306,306,0,0,0
635935,313,313,0,0,0
635947,345,345,0,0,0
635951,259,259,0,0,0
635956,14,14,0,0,0
635958,163,163,0,0,0
635964,184,184,0,0,0
635972,16,16,0,0,0
636015,281,281,0,0,0
636047,184,184,0,0,0
636064,259,259,0,0,0
636068,151,151,0,0,0
636070,315,315,0,0,0
636084,402,402,0,0,0
636099,120,120,0,0,0
636112,2,2,0,0,0
636113,39,39,0,0,0
636122,137,137,0,0,0
636138,281,281,0,0,0
636175,281,281,0,0,0
636180,259,259,0,0,0
636184,171,171,0,0,0
636189,56,56,0,0,0
636202,30,30,0,0,0
636203,193,193,0,0,0
636240,184,184,0,0,0
636246,76,76,0,0,0
636260,345,345,0,0,0
636267,353,353,0,0,0
636273,313,313,0,0,0
636298,121,121,0,0,0
636329,198,198,0,0,0
636330,353,353,0,0,0
636340,143,143,0,0,0
636344,158,158,0,0,0
636347,55,55,0,0,0
636356,251,251,0,0,0
636370,402,402,0,0,0
636384,128,128,0,0,0
636390,128,128,0,0,0
636423,85,85,0,0,0
636429,130,130,0,0,0
636444,198,198,0,0,0
636445,359,359,0,0,0
636450,201,201,0,0,0
636463,252,252,0,0,0
636481,184,184,0,0,0
636501,39,39,0,0,0
636507,40,40,0,0,0
636508,310,310,0,0,0
636516,184,184,0,0,0
636522,315,315,0,0,0
636523,193,193,0,0,0
636528,353,353,0,0,0
636531,20,20,0,0,0
636537,3,3,0,0,0
636538,128,128,0,0,0
636547,315,315,0,0,0
636553,65,65,0,0,0
636558,102,102,0,0,0
636564,168,168,0,0,0
636566,137,137,0,0,0
636584,137,137,0,0,0
636585,35,35,0,0,0
636599,201,201,0,0,0
636606,70,70,0,0,0
636609,77,77,0,0,0
636612,70,70,0,0,0
636615,255,255,0,0,0
636617,180,180,0,0,0
636620,66,66,0,0,0
636640,50,50,0,0,0
636650,14,14,0,0,0
636653,25,25,0,0,0
636654,167,167,0,0,0
636666,114,114,0,0,0
636667,102,102,0,0,0
636669,85,85,0,0,0
636672,2,2,0,0,0
636685,198,198,0,0,0
636707,72,72,0,0,0
636713,163,163,0,0,0
636724,193,193,0,0,0
636734,102,102,0,0,0
636745,14,14,0,0,0
636748,345,345,0,0,0
636752,6,6,0,0,0
636762,82,82,0,0,0
636763,255,255,0,0,0
636778,281,281,0,0,0
636779,18,18,0,0,0
636781,50,50,0,0,0
636785,12,12,0,0,0
636791,252,252,0,0,0
636811,69,69,0,0,0
636812,198,198,0,0,0
636823,143,143,0,0,0
636831,17,17,0,0,0
636837,76,76,0,0,0
636851,50,50,0,0,0
636869,18,18,0,0,0
636880,133,133,0,0,0
636895,102,102,0,0,0
636913,15,15,0,0,0
636921,198,198,0,0,0
636936,193,193,0,0,0
636953,121,121,0,0,0
636955,137,137,0,0,0
636969,180,180,0,0,0
636974,252,252,0,0,0
636986,5,5,0,0,0
636987,198,198,0,0,0
636993,299,299,0,0,0
637000,8,8,0,0,0
637062,310,310,0,0,0
637071,85,85,0,0,0
637077,184,184,0,0,0
637081,102,102,0,0,0
637098,168,168,0,0,0
637100,39,39,0,0,0
637113,130,130,0,0,0
637119,201,201,0,0,0
637123,353,353,0,0,0
637128,184,184,0,0,0
637145,14,14,0,0,0
637170,310,310,0,0,0
637210,76,76,0,0,0
637213,121,121,0,0,0
637220,299,299,0,0,0
637223,359,359,0,0,0
637230,72,72,0,0,0
637233,20,20,0,0,0
637248,193,193,0,0,0
637281,345,345,0,0,0
637282,121,121,0,0,0
637300,167,167,0,0,0
637304,402,402,0,0,0
637333,402,402,0,0,0
637357,9,9,0,0,0
637368,113,113,0,0,0
637384,180,180,0,0,0
637396,101,101,0,0,0
637397,246,246,0,0,0
637408,299,299,0,0,0
637428,313,313,0,0,0
637435,353,353,0,0,0
637449,75,75,0,0,0
637469,313,313,0,0,0
637475,6,6,0,0,0
637514,184,184,0,0,0
637516,193,193,0,0,0
637525,113,113,0,0,0
637539,345,345,0,0,0
637540,163,163,0,0,0
637564,310,310,0,0,0
637571,63,63,0,0,0
637573,41,41,0,0,0
637576,143,143,0,0,0
637580,282,282,0,0,0
637583,97,97,0,0,0
637590,313,313,0,0,0
637595,353,353,0,0,0
637609,184,184,0,0,0
637623,232,232,0,0,0
637634,45,45,0,0,0
637674,282,282,0,0,0
637685,34,34,0,0,0
637693,76,76,0,0,0
637721,232,232,0,0,0
637728,15,15,0,0,0
637729,24,24,0,0,0
637745,259,259,0,0,0
637762,41,41,0,0,0
637765,246,246,0,0,0
637771,30,30,0,0,0
637774,83,83,0,0,0
637775,306,306,0,0,0
637779,345,345,0,0,0
637790,144,144,0,0,0
637798,7,7,0,0,0
637823,402,402,0,0,0
637843,3,3,0,0,0
637854,27,27,0,0,0
637865,353,353,0,0,0
637869,299,299,0,0,0
637874,163,163,0,0,0
637901,103,103,0,0,0
637934,128,128,0,0,0
637938,24,24,0,0,0
637967,30,30,0,0,0
637984,232,232,0,0,0
637987,3,3,0,0,0
637997,353,353,0,0,0
638007,282,282,0,0,0
638008,76,76,0,0,0
638019,252,252,0,0,0
638028,353,353,0,0,0
638030,255,255,0,0,0
638035,163,163,0,0,0
638043,171,171,0,0,0
638045,85,85,0,0,0
638048,232,232,0,0,0
638053,282,282,0,0,0
638055,6,6,0,0,0
638063,232,232,0,0,0
638066,232,232,0,0,0
638073,353,353,0,0,0
638089,168,168,0,0,0
638095,77,77,0,0,0
638127,103,103,0,0,0
638131,232,232,0,0,0
638136,54,54,0,0,0
638139,22,22,0,0,0
638140,171,171,0,0,0
638146,201,201,0,0,0
638155,66,66,0,0,0
638158,66,66,0,0,0
638167,16,16,0,0,0
638172,158,158,0,0,0
638185,171,171,0,0,0
638196,50,50,0,0,0
638202,87,87,0,0,0
638221,36,36,0,0,0
638230,17,17,0,0,0
638237,353,353,0,0,0
638250,198,198,0,0,0
638266,359,359,0,0,0
638271,18,18,0,0,0
638295,402,402,0,0,0
638308,180,180,0,0,0
638324,198,198,0,0,0
638405,70,70,0,0,0
638407,310,310,0,0,0
638420,402,402,0,0,0
638432,102,102,0,0,0
638441,15,15,0,0,0
638445,282,282,0,0,0
638450,131,131,0,0,0
638465,120,120,0,0,0
638482,306,306,0,0,0
638485,18,18,0,0,0
638489,76,76,0,0,0
638490,252,252,0,0,0
638604,315,315,0,0,0
638615,158,158,0,0,0
638628,246,246,0,0,0
638632,15,15,0,0,0
638634,72,72,0,0,0
638648,137,137,0,0,0
638656,137,137,0,0,0
638678,306,306,0,0,0
638705,101,101,0,0,0
638742,255,255,0,0,0
638776,144,144,0,0,0
638777,114,114,0,0,0
638781,299,299,0,0,0
638789,131,131,0,0,0
638802,131,131,0,0,0
638806,255,255,0,0,0
638843,313,313,0,0,0
638848,151,151,0,0,0
638850,315,315,0,0,0
638863,402,402,0,0,0
638873,39,39,0,0,0
638876,281,281,0,0,0
638880,58,58,0,0,0
638885,56,56,0,0,0
638886,113,113,0,0,0
638887,87,87,0,0,0
638893,74,74,0,0,0
638906,128,128,0,0,0
638915,246,246,0,0,0
638965,9,9,0,0,0
638968,193,193,0,0,0
639040,35,35,0,0,0
639044,180,180,0,0,0
639045,353,353,0,0,0
639058,198,198,0,0,0
639063,36,36,0,0,0
639083,71,71,0,0,0
639090,102,102,0,0,0
639091,32,32,0,0,0
639099,43,43,0,0,0
639103,168,168,0,0,0
639118,20,20,0,0,0
639136,5,5,0,0,0
639142,34,34,0,0,0
639189,114,114,0,0,0
639199,151,151,0,0,0
639210,345,345,0,0,0
639224,70,70,0,0,0
639238,246,246,0,0,0
639243,133,133,0,0,0
639252,163,163,0,0,0
639276,3,3,0,0,0
639280,137,137,0,0,0
639282,345,345,0,0,0
639297,76,76,0,0,0
639312,1,1,0,0,0
639327,74,74,0,0,0
639341,121,121,0,0,0
639347,54,54,0,0,0
639348,345,345,0,0,0
639355,255,255,0,0,0
639386,198,198,0,0,0
639414,75,75,0,0,0
639431,193,193,0,0,0
639442,114,114,0,0,0
639459,114,114,0,0,0
639460,121,121,0,0,0
639466,402,402,0,0,0
639469,353,353,0,0,0
639490,4,4,0,0,0
639492,5,5,0,0,0
639494,232,232,0,0,0
639495,255,255,0,0,0
639513,8,8,0,0,0
639523,402,402,0,0,0
639524,130,130,0,0,0
639552,39,39,0,0,0
639560,13,13,0,0,0
639563,163,163,0,0,0
639571,180,180,0,0,0
639574,113,113,0,0,0
639575,167,167,0,0,0
639582,97,97,0,0,0
639597,121,121,0,0,0
639606,56,56,0,0,0
639609,345,345,0,0,0
639628,171,171,0,0,0
639629,359,359,0,0,0
639687,137,137,0,0,0
639692,18,18,0,0,0
639712,353,353,0,0,0
639732,19,19,0,0,0
639734,315,315,0,0,0
639736,35,35,0,0,0
639745,353,353,0,0,0
639750,20,20,0,0,0
639763,76,76,0,0,0
639790,102,102,0,0,0
639791,345,345,0,0,0
639794,184,184,0,0,0
639799,34,34,0,0,0
639807,306,306,0,0,0
639829,281,281,0,0,0
639831,74,74,0,0,0
639834,39,39,0,0,0
639844,70,70,0,0,0
639845,29,29,0,0,0
639860,11,11,0,0,0
639887,6,6,0,0,0
639895,252,252,0,0,0
639903,36,36,0,0,0
639913,54,54,0,0,0
639935,171,171,0,0,0
639939,299,299,0,0,0
639944,259,259,0,0,0
639951,16,16,0,0,0
639959,20,20,0,0,0
639962,255,255,0,0,0
639993,97,97,0,0,0
639999,101,101,0,0,0
640008,144,144,0,0,0
640025,151,151,0,0,0
640030,353,353,0,0,0
640038,55,55,0,0,0
640046,132,132,0,0,0
640057,58,58,0,0,0
640077,71,71,0,0,0
640091,299,299,0,0,0
640095,69,69,0,0,0
640099,193,193,0,0,0
640129,1,1,0,0,0
640141,310,310,0,0,0
640149,282,282,0,0,0
640156,94,94,0,0,0
640163,9,9,0,0,0
640164,299,299,0,0,0
640166,359,359,0,0,0
640187,246,246,0,0,0
640194,74,74,0,0,0
640199,74,74,0,0,0
640214,259,259,0,0,0
640216,65,65,0,0,0
640233,255,255,0,0,0
640257,252,252,0,0,0
640268,36,36,0,0,0
640294,34,34,0,0,0
640311,101,101,0,0,0
640312,55,55,0,0,0
640342,315,315,0,0,0
640363,128,128,0,0,0
640365,44,44,0,0,0
640390,232,232,0,0,0
640396,3,3,0,0,0
640401,315,315,0,0,0
640403,198,198,0,0,0
640416,74,74,0,0,0
640431,102,102,0,0,0
640441,282,282,0,0,0
640447,8,8,0,0,0
640449,24,24,0,0,0
640457,251,251,0,0,0
640459,15,15,0,0,0
640466,359,359,0,0,0
640471,315,315,0,0,0
640491,10,10,0,0,0
640492,251,251,0,0,0
640511,282,282,0,0,0
640517,76,76,0,0,0
640519,201,201,0,0,0
640526,10,10,0,0,0
640543,259,259,0,0,0
640565,35,35,0,0,0
640581,101,101,0,0,0
640590,72,72,0,0,0
640592,28,28,0,0,0
640601,14,14,0,0,0
640609,36,36,0,0,0
640619,168,168,0,0,0
640622,198,198,0,0,0
640626,17,17,0,0,0
640642,282,282,0,0,0
640662,131,131,0,0,0
640680,306,306,0,0,0
640685,345,345,0,0,0
640688,87,87,0,0,0
640692,133,133,0,0,0
640696,345,345,0,0,0
640704,67,67,0,0,0
640721,103,103,0,0,0
640726,345,345,0,0,0
640728,151,151,0,0,0
640749,281,281,0,0,0
640760,82,82,0,0,0
640761,7,7,0,0,0
640766,251,251,0,0,0
640770,151,151,0,0,0
640788,144,144,0,0,0
640804,2,2,0,0,0
640813,27,27,0,0,0
640841,25,25,0,0,0
640857,66,66,0,0,0
640863,281,281,0,0,0
640869,11,11,0,0,0
640872,14,14,0,0,0
640882,65,65,0,0,0
640897,281,281,0,0,0
640900,143,143,0,0,0
640902,65,65,0,0,0
640905,315,315,0,0,0
640911,299,299,0,0,0
640912,184,184,0,0,0
640921,29,29,0,0,0
640930,121,121,0,0,0
640940,83,83,0,0,0
640963,198,198,0,0,0
641000,83,83,0,0,0
641018,131,131,0,0,0
641022,137,137,0,0,0
641089,180,180,0,0,0
641103,353,353,0,0,0
641107,137,137,0,0,0
641108,171,171,0,0,0
641125,252,252,0,0,0
641133,306,306,0,0,0
641140,43,43,0,0,0
641152,1,1,0,0,0
641156,201,201,0,0,0
641164,259,259,0,0,0
641168,251,251,0,0,0
641175,171,171,0,0,0
641183,137,137,0,0,0
641195,152,152,0,0,0
641203,65,65,0,0,0
641210,103,103,0,0,0
641219,6,6,0,0,0
641241,359,359,0,0,0
641251,359,359,0,0,0
641265,251,251,0,0,0
641267,36,36,0,0,0
641273,198,198,0,0,0
641276,259,259,0,0,0
641280,353,353,0,0,0
641282,128,128,0,0,0
641292,353,353,0,0,0
641294,65,65,0,0,0
641331,113,113,0,0,0
641333,252,252,0,0,0
641334,13,13,0,0,0
641338,65,65,0,0,0
641339,306,306,0,0,0
641340,83,83,0,0,0
641341,402,402,0,0,0
641352,69,69,0,0,0
641361,55,55,0,0,0
641400,310,310,0,0,0
641407,3,3,0,0,0
641413,198,198,0,0,0
641441,198,198,0,0,0
641444,143,143,0,0,0
641468,1,1,0,0,0
641474,246,246,0,0,0
641479,306,306,0,0,0
641502,40,40,0,0,0
641520,5,5,0,0,0
641533,259,259,0,0,0
641563,163,163,0,0,0
641579,101,101,0,0,0
641602,16,16,0,0,0
641612,255,255,0,0,0
641627,20,20,0,0,0
641636,299,299,0,0,0
641649,9,9,0,0,0
641653,345,345,0,0,0
641656,137,137,0,0,0
641669,121,121,0,0,0
641670,21,21,0,0,0
641672,70,70,0,0,0
641682,255,255,0,0,0
641729,306,306,0,0,0
641739,353,353,0,0,0
641744,103,103,0,0,0
641761,281,281,0,0,0
641766,21,21,0,0,0
641769,246,246,0,0,0
641807,121,121,0,0,0
641819,94,94,0,0,0
641834,299,299,0,0,0
641850,137,137,0,0,0
641870,246,246,0,0,0
641871,345,345,0,0,0
641927,152,152,0,0,0
641931,3,3,0,0,0
641943,2,2,0,0,0
641958,310,310,0,0,0
641963,255,255,0,0,0
642029,246,246,0,0,0
642047,299,299,0,0,0
642058,76,76,0,0,0
642060,152,152,0,0,0
642065,353,353,0,0,0
642071,35,35,0,0,0
642079,83,83,0,0,0
642082,3,3,0,0,0
642093,359,359,0,0,0
642103,113,113,0,0,0
642104,133,133,0,0,0
642121,22,22,0,0,0
642128,72,72,0,0,0
642133,128,128,0,0,0
642139,167,167,0,0,0
642181,77,77,0,0,0
642184,201,201,0,0,0
642212,282,282,0,0,0
642220,20,20,0,0,0
642221,198,198,0,0,0
642227,402,402,0,0,0
642239,282,282,0,0,0
642241,281,281,0,0,0
642244,353,353,0,0,0
642248,163,163,0,0,0
642261,76,76,0,0,0
642272,167,167,0,0,0
642277,359,359,0,0,0
642280,359,359,0,0,0
642361,282,282,0,0,0
642362,180,180,0,0,0
642365,158,158,0,0,0
642373,133,133,0,0,0
642398,143,143,0,0,0
642404,137,137,0,0,0
642412,20,20,0,0,0
642439,198,198,0,0,0
642458,130,130,0,0,0
642460,30,30,0,0,0
642488,101,101,0,0,0
642514,16,16,0,0,0
642520,137,137,0,0,0
642528,87,87,0,0,0
642530,193,193,0,0,0
642534,313,313,0,0,0
642557,180,180,0,0,0
642564,359,359,0,0,0
642583,67,67,0,0,0
642597,171,171,0,0,0
642617,36,36,0,0,0
642625,41,41,0,0,0
642636,102,102,0,0,0
642647,76,76,0,0,0
642649,102,102,0,0,0
642679,167,167,0,0,0
642680,57,57,0,0,0
642685,23,23,0,0,0
642689,137,137,0,0,0
642707,252,252,0,0,0
642723,75,75,0,0,0
642740,137,137,0,0,0
642763,12,12,0,0,0
642767,2,2,0,0,0
642807,171,171,0,0,0
642824,29,29,0,0,0
642849,121,121,0,0,0
642851,313,313,0,0,0
642855,56,56,0,0,0
642859,56,56,0,0,0
642863,76,76,0,0,0
642876,13,13,0,0,0
642881,3,3,0,0,0
642889,201,201,0,0,0
642903,74,74,0,0,0
642911,310,310,0,0,0
642914,246,246,0,0,0
642919,167,167,0,0,0
642922,281,281,0,0,0
642937,306,306,0,0,0
642939,35,35,0,0,0
642954,158,158,0,0,0
642992,137,137,0,0,0
642994,198,198,0,0,0
642995,87,87,0,0,0
642998,282,282,0,0,0
643007,310,310,0,0,0
643011,359,359,0,0,0
643026,306,306,0,0,0
643033,132,132,0,0,0
643034,74,74,0,0,0
643039,198,198,0,0,0
643051,255,255,0,0,0
643055,27,27,0,0,0
643067,18,18,0,0,0
643070,306,306,0,0,0
643073,7,7,0,0,0
643099,34,34,0,0,0
643117,97,97,0,0,0
643130,299,299,0,0,0
643174,171,171,0,0,0
643187,35,35,0,0,0
643192,114,114,0,0,0
643199,193,193,0,0,0
643207,21,21,0,0,0
643234,24,24,0,0,0
643247,102,102,0,0,0
643260,39,39,0,0,0
643265,315,315,0,0,0
643272,72,72,0,0,0
643289,313,313,0,0,0
643297,2,2,0,0,0
643301,299,299,0,0,0
643313,114,114,0,0,0
643320,152,152,0,0,0
643330,70,70,0,0,0
643331,167,167,0,0,0
643335,4,4,0,0,0
643347,77,77,0,0,0
643355,22,22,0,0,0
643357,359,359,0,0,0
643360,41,41,0,0,0
643382,85,85,0,0,0
643392,70,70,0,0,0
643415,29,29,0,0,0
643427,246,246,0,0,0
643435,359,359,0,0,0
643447,56,56,0,0,0
643467,66,66,0,0,0
643482,120,120,0,0,0
643493,29,29,0,0,0
643517,282,282,0,0,0
643525,25,25,0,0,0
643555,11,11,0,0,0
643558,353,353,0,0,0
643565,7,7,0,0,0
643584,76,76,0,0,0
643588,71,71,0,0,0
643615,345,345,0,0,0
643621,353,353,0,0,0
643627,359,359,0,0,0
643628,102,102,0,0,0
643640,97,97,0,0,0
643642,77,77,0,0,0
643651,359,359,0,0,0
643667,359,359,0,0,0
643688,102,102,0,0,0
643699,402,402,0,0,0
643700,82,82,0,0,0
643710,2,2,0,0,0
643712,281,281,0,0,0
643721,252,252,0,0,0
643742,345,345,0,0,0
643777,180,180,0,0,0
643784,76,76,0,0,0
643801,25,25,0,0,0
643809,167,167,0,0,0
643813,282,282,0,0,0
643820,171,171,0,0,0
643832,315,315,0,0,0
643834,74,74,0,0,0
643841,402,402,0,0,0
643845,246,246,0,0,0
643853,128,128,0,0,0
643868,101,101,0,0,0
643870,299,299,0,0,0
643877,152,152,0,0,0
643883,152,152,0,0,0
643905,69,69,0,0,0
643925,282,282,0,0,0
643933,114,114,0,0,0
643964,69,69,0,0,0
643971,27,27,0,0,0
643976,12,12,0,0,0
643983,10,10,0,0,0
643984,252,252,0,0,0
643985,74,74,0,0,0
644007,259,259,0,0,0
644014,402,402,0,0,0
644015,193,193,0,0,0
644020,102,102,0,0,0
644025,143,143,0,0,0
644029,101,101,0,0,0
644041,310,310,0,0,0
644048,232,232,0,0,0
644050,76,76,0,0,0
644052,94,94,0,0,0
644073,25,25,0,0,0
644079,402,402,0,0,0
644108,76,76,0,0,0
644112,158,158,0,0,0
644129,97,97,0,0,0
644132,56,56,0,0,0
644152,180,180,0,0,0
644157,137,137,0,0,0
644164,44,44,0,0,0
644193,74,74,0,0,0
644195,66,66,0,0,0
644202,232,232,0,0,0
644207,252,252,0,0,0
644218,315,315,0,0,0
644228,255,255,0,0,0
644234,67,67,0,0,0
644236,198,198,0,0,0
644250,128,128,0,0,0
644259,83,83,0,0,0
644266,77,77,0,0,0
644282,82,82,0,0,0
644290,102,102,0,0,0
644295,306,306,0,0,0
644297,14,14,0,0,0
644300,65,65,0,0,0
644344,168,168,0,0,0
644381,353,353,0,0,0
644389,402,402,0,0,0
644416,143,143,0,0,0
644420,85,85,0,0,0
644427,359,359,0,0,0
644428,102,102,0,0,0
644440,29,29,0,0,0
644453,259,259,0,0,0
644478,29,29,0,0,0
644490,94,94,0,0,0
644494,252,252,0,0,0
644510,114,114,0,0,0
644532,255,255,0,0,0
644537,103,103,0,0,0
644540,24,24,0,0,0
644542,71,71,0,0,0
644551,97,97,0,0,0
644554,232,232,0,0,0
644561,9,9,0,0,0
644592,11,11,0,0,0
644597,402,402,0,0,0
644604,65,65,0,0,0
644613,255,255,0,0,0
644630,402,402,0,0,0
644637,75,75,0,0,0
644654,315,315,0,0,0
644683,23,23,0,0,0
644686,74,74,0,0,0
644701,171,171,0,0,0
644702,12,12,0,0,0
644712,251,251,0,0,0
644720,402,402,0,0,0
644728,128,128,0,0,0
644759,4,4,0,0,0
644778,97,97,0,0,0
644779,168,168,0,0,0
644792,353,353,0,0,0
644808,70,70,0,0,0
644814,299,299,0,0,0
644815,114,114,0,0,0
644826,130,130,0,0,0
644827,94,94,0,0,0
644830,306,306,0,0,0
644856,130,130,0,0,0
644865,152,152,0,0,0
644886,171,171,0,0,0
644896,55,55,0,0,0
644904,184,184,0,0,0
644911,121,121,0,0,0
644916,7,7,0,0,0
644922,232,232,0,0,0
644930,315,315,0,0,0
644946,313,313,0,0,0
644959,310,310,0,0,0
644960,251,251,0,0,0
644966,184,184,0,0,0
644983,18,18,0,0,0
645007,34,34,0,0,0
645018,57,57,0,0,0
645019,252,252,0,0,0
645030,120,120,0,0,0
645033,143,143,0,0,0
645039,144,144,0,0,0
645041,131,131,0,0,0
645042,359,359,0,0,0
645043,65,65,0,0,0
645044,14,14,0,0,0
645069,252,252,0,0,0
645076,10,10,0,0,0
645151,281,281,0,0,0
645154,152,152,0,0,0
645158,133,133,0,0,0
645172,69,69,0,0,0
645191,315,315,0,0,0
645200,158,158,0,0,0
645241,246,246,0,0,0
645246,121,121,0,0,0
645251,158,158,0,0,0
645256,246,246,0,0,0
645265,259,259,0,0,0
645291,128,128,0,0,0
645308,251,251,0,0,0
645332,255,255,0,0,0
645394,252,252,0,0,0
645397,94,94,0,0,0
645405,74,74,0,0,0
645406,50,50,0,0,0
645409,58,58,0,0,0
645412,313,313,0,0,0
645427,71,71,0,0,0
645441,282,282,0,0,0
645451,10,10,0,0,0
645453,232,232,0,0,0
645486,251,251,0,0,0
645513,281,281,0,0,0
645524,281,281,0,0,0
645533,282,282,0,0,0
645542,167,167,0,0,0
645550,18,18,0,0,0
645551,87,87,0,0,0
645578,281,281,0,0,0
645579,158,158,0,0,0
645591,353,353,0,0,0
645603,299,299,0,0,0
645609,167,167,0,0,0
645610,25,25,0,0,0
645614,201,201,0,0,0
645617,246,246,0,0,0
645628,36,36,0,0,0
645631,193,193,0,0,0
645650,67,67,0,0,0
645652,103,103,0,0,0
645675,313,313,0,0,0
645713,87,87,0,0,0
645717,143,143,0,0,0
645740,151,151,0,0,0
645741,252,252,0,0,0
645743,281,281,0,0,0
645762,168,168,0,0,0
645789,168,168,0,0,0
645827,113,113,0,0,0
645828,97,97,0,0,0
645843,75,75,0,0,0
645847,310,310,0,0,0
645853,12,12,0,0,0
645858,282,282,0,0,0
645864,137,137,0,0,0
645872,17,17,0,0,0
645874,353,353,0,0,0
645880,345,345,0,0,0
645890,180,180,0,0,0
645895,71,71,0,0,0
645938,232,232,0,0,0
645951,56,56,0,0,0
645965,252,252,0,0,0
645966,232,232,0,0,0
645969,12,12,0,0,0
645972,54,54,0,0,0
645984,232,232,0,0,0
645993,201,201,0,0,0
646006,143,143,0,0,0
646012,44,44,0,0,0
646015,143,143,0,0,0
646024,130,130,0,0,0
646040,3,3,0,0,0
646043,281,281,0,0,0
646049,131,131,0,0,0
646052,255,255,0,0,0
646078,41,41,0,0,0
646092,3,3,0,0,0
646121,353,353,0,0,0
646128,97,97,0,0,0
646152,44,44,0,0,0
646153,198,198,0,0,0
646161,251,251,0,0,0
646166,137,137,0,0,0
646168,345,345,0,0,0
646184,184,184,0,0,0
646186,281,281,0,0,0
646193,171,171,0,0,0
646199,193,193,0,0,0
646211,70,70,0,0,0
646251,121,121,0,0,0
646268,402,402,0,0,0
646288,76,76,0,0,0
646293,66,66,0,0,0
646299,35,35,0,0,0
646309,82,82,0,0,0
646315,5,5,0,0,0
646324,54,54,0,0,0
646342,120,120,0,0,0
646353,313,313,0,0,0
646358,313,313,0,0,0
646374,114,114,0,0,0
646375,246,246,0,0,0
646390,13,13,0,0,0
646408,251,251,0,0,0
646422,306,306,0,0,0
646429,55,55,0,0,0
646432,143,143,0,0,0
646437,313,313,0,0,0
646448,402,402,0,0,0
646450,103,103,0,0,0
646460,402,402,0,0,0
646470,144,144,0,0,0
646493,45,45,0,0,0
646554,101,101,0,0,0
646569,130,130,0,0,0
646593,85,85,0,0,0
646597,345,345,0,0,0
646606,152,152,0,0,0
646608,282,282,0,0,0
646614,131,131,0,0,0
646615,232,232,0,0,0
646629,255,255,0,0,0
646632,299,299,0,0,0
646638,113,113,0,0,0
646660,102,102,0,0,0
646663,171,171,0,0,0
646672,359,359,0,0,0
646682,315,315,0,0,0
646684,143,143,0,0,0
646687,310,310,0,0,0
646692,232,232,0,0,0
646699,130,130,0,0,0
646702,76,76,0,0,0
646703,45,45,0,0,0
646707,121,121,0,0,0
646722,76,76,0,0,0
646725,85,85,0,0,0
646734,201,201,0,0,0
646738,143,143,0,0,0
646741,310,310,0,0,0
646743,120,120,0,0,0
646770,76,76,0,0,0
646801,83,83,0,0,0
646819,315,315,0,0,0
646821,315,315,0,0,0
646835,282,282,0,0,0
646845,114,114,0,0,0
646854,144,144,0,0,0
646862,252,252,0,0,0
646872,353,353,0,0,0
646878,3,3,0,0,0
646879,137,137,0,0,0
646880,8,8,0,0,0
646900,4,4,0,0,0
646904,94,94,0,0,0
646909,359,359,0,0,0
646930,94,94,0,0,0
646936,97,97,0,0,0
646942,167,167,0,0,0
646946,359,359,0,0,0
646951,299,299,0,0,0
646955,143,143,0,0,0
646970,25,25,0,0,0
646974,66,66,0,0,0
647014,69,69,0,0,0
647022,3,3,0,0,0
647025,102,102,0,0,0
647048,306,306,0,0,0
647050,94,94,0,0,0
647053,246,246,0,0,0
647055,34,34,0,0,0
647057,12,12,0,0,0
647064,30,30,0,0,0
647065,180,180,0,0,0
647086,167,167,0,0,0
647091,35,35,0,0,0
647107,299,299,0,0,0
647146,131,131,0,0,0
647192,143,143,0,0,0
647216,114,114,0,0,0
647229,402,402,0,0,0
647232,345,345,0,0,0
647248,24,24,0,0,0
647253,359,359,0,0,0
647258,121,121,0,0,0
647278,102,102,0,0,0
647280,306,306,0,0,0
647296,40,40,0,0,0
647307,345,345,0,0,0
647310,282,282,0,0,0
647332,313,313,0,0,0
647333,353,353,0,0,0
647334,163,163,0,0,0
647352,184,184,0,0,0
647363,17,17,0,0,0
647365,163,163,0,0,0
647372,50,50,0,0,0
647400,255,255,0,0,0
647443,193,193,0,0,0
647448,74,74,0,0,0
647474,259,259,0,0,0
647477,50,50,0,0,0
647482,34,34,0,0,0
647514,10,10,0,0,0
647525,19,19,0,0,0
647530,353,353,0,0,0
647533,299,299,0,0,0
647585,353,353,0,0,0
647587,11,11,0,0,0
647589,299,299,0,0,0
647615,22,22,0,0,0
647642,168,168,0,0,0
647647,144,144,0,0,0
647650,3,3,0,0,0
647651,345,345,0,0,0
647654,402,402,0,0,0
647671,353,353,0,0,0
647674,345,345,0,0,0
647678,252,252,0,0,0
647697,12,12,0,0,0
647701,25,25,0,0,0
647703,41,41,0,0,0
647740,45,45,0,0,0
647741,282,282,0,0,0
647746,353,353,0,0,0
647759,94,94,0,0,0
647761,137,137,0,0,0
647770,10,10,0,0,0
647803,82,82,0,0,0
647843,315,315,0,0,0
647847,353,353,0,0,0
647849,67,67,0,0,0
647850,44,44,0,0,0
647860,29,29,0,0,0
647881,85,85,0,0,0
647887,85,85,0,0,0
647892,359,359,0,0,0
647894,20,20,0,0,0
647895,65,65,0,0,0
647897,143,143,0,0,0
647898,345,345,0,0,0
647916,131,131,0,0,0
647918,18,18,0,0,0
647929,198,198,0,0,0
647946,94,94,0,0,0
647948,158,158,0,0,0
647971,121,121,0,0,0
647973,50,50,0,0,0
647976,39,39,0,0,0
647981,353,353,0,0,0
648005,345,345,0,0,0
648032,299,299,0,0,0
648035,29,29,0,0,0
648039,282,282,0,0,0
648043,252,252,0,0,0
648073,402,402,0,0,0
648076,201,201,0,0,0
648099,184,184,0,0,0
648105,232,232,0,0,0
648131,345,345,0,0,0
648134,65,65,0,0,0
648136,21,21,0,0,0
648154,27,27,0,0,0
648173,97,97,0,0,0
648175,193,193,0,0,0
648178,201,201,0,0,0
648186,163,163,0,0,0
648196,128,128,0,0,0
648210,252,252,0,0,0
648219,252,252,0,0,0
648221,282,282,0,0,0
648233,171,171,0,0,0
648253,76,76,0,0,0
648256,94,94,0,0,0
648292,259,259,0,0,0
648293,306,306,0,0,0
648299,40,40,0,0,0
648315,131,131,0,0,0
648316,121,121,0,0,0
648327,15,15,0,0,0
648335,345,345,0,0,0
648353,184,184,0,0,0
648377,34,34,0,0,0
648384,313,313,0,0,0
648395,101,101,0,0,0
648398,402,402,0,0,0
648421,246,246,0,0,0
648446,144,144,0,0,0
648452,402,402,0,0,0
648455,74,74,0,0,0
648456,20,20,0,0,0
648472,152,152,0,0,0
648477,313,313,0,0,0
648495,402,402,0,0,0
648500,75,75,0,0,0
648507,151,151,0,0,0
648529,152,152,0,0,0
648546,113,113,0,0,0
648548,131,131,0,0,0
648564,57,57,0,0,0
648585,3,3,0,0,0
648591,74,74,0,0,0
648592,102,102,0,0,0
648629,16,16,0,0,0
648633,252,252,0,0,0
648636,359,359,0,0,0
648639,14,14,0,0,0
648648,345,345,0,0,0
648669,97,97,0,0,0
648678,24,24,0,0,0
648692,282,282,0,0,0
648706,201,201,0,0,0
648707,114,114,0,0,0
648715,180,180,0,0,0
648721,2,2,0,0,0
648734,259,259,0,0,0
648741,281,281,0,0,0
648742,313,313,0,0,0
648760,299,299,0,0,0
648779,281,281,0,0,0
648789,359,359,0,0,0
648792,198,198,0,0,0
648800,402,402,0,0,0
648813,359,359,0,0,0
648815,94,94,0,0,0
648817,299,299,0,0,0
648832,137,137,0,0,0
648840,246,246,0,0,0
648842,152,152,0,0,0
648855,143,143,0,0,0
648861,76,76,0,0,0
648889,54,54,0,0,0
648903,259,259,0,0,0
648904,201,201,0,0,0
648917,359,359,0,0,0
648924,25,25,0,0,0
648937,113,113,0,0,0
648952,168,168,0,0,0
648965,313,313,0,0,0
648976,158,158,0,0,0
648980,18,18,0,0,0
648981,57,57,0,0,0
648991,180,180,0,0,0
649019,43,43,0,0,0
649028,232,232,0,0,0
649051,198,198,0,0,0
649071,315,315,0,0,0
649075,114,114,0,0,0
649083,402,402,0,0,0
649090,255,255,0,0,0
649091,310,310,0,0,0
649105,353,353,0,0,0
649113,281,281,0,0,0
649114,252,252,0,0,0
649127,82,82,0,0,0
649138,315,315,0,0,0
649153,143,143,0,0,0
649160,252,252,0,0,0
649171,54,54,0,0,0
649175,35,35,0,0,0
649191,180,180,0,0,0
649195,137,137,0,0,0
649212,282,282,0,0,0
649213,3,3,0,0,0
649225,66,66,0,0,0
649227,36,36,0,0,0
649232,345,345,0,0,0
649235,282,282,0,0,0
649243,137,137,0,0,0
649257,114,114,0,0,0
649272,58,58,0,0,0
649287,282,282,0,0,0
649295,13,13,0,0,0
649296,32,32,0,0,0
649329,24,24,0,0,0
649335,55,55,0,0,0
649346,201,201,0,0,0
649352,282,282,0,0,0
649367,41,41,0,0,0
649380,402,402,0,0,0
649388,359,359,0,0,0
649391,34,34,0,0,0
649400,102,102,0,0,0
649444,83,83,0,0,0
649450,251,251,0,0,0
649464,281,281,0,0,0
649467,144,144,0,0,0
649472,313,313,0,0,0
649477,232,232,0,0,0
649480,34,34,0,0,0
649486,137,137,0,0,0
649511,22,22,0,0,0
649521,102,102,0,0,0
649522,353,353,0,0,0
649537,131,131,0,0,0
649542,198,198,0,0,0
649585,282,282,0,0,0
649594,102,102,0,0,0
649608,72,72,0,0,0
649609,232,232,0,0,0
649610,43,43,0,0,0
649637,313,313,0,0,0
649638,246,246,0,0,0
649652,193,193,0,0,0
649659,313,313,0,0,0
649680,83,83,0,0,0
649690,143,143,0,0,0
649747,198,198,0,0,0
649766,71,71,0,0,0
649769,50,50,0,0,0
649783,113,113,0,0,0
649784,353,353,0,0,0
649788,36,36,0,0,0
649791,67,67,0,0,0
649816,11,11,0,0,0
649824,87,87,0,0,0
649826,143,143,0,0,0
649830,282,282,0,0,0
649834,82,82,0,0,0
649850,359,359,0,0,0
649864,29,29,0,0,0
649884,16,16,0,0,0
649899,180,180,0,0,0
649904,83,83,0,0,0
649929,359,359,0,0,0
649930,259,259,0,0,0
649941,232,232,0,0,0
649943,168,168,0,0,0
649971,130,130,0,0,0
649973,299,299,0,0,0
649974,120,120,0,0,0
649994,76,76,0,0,0
650026,102,102,0,0,0
650034,23,23,0,0,0
650046,252,252,0,0,0
650050,151,151,0,0,0
650056,345,345,0,0,0
650067,158,158,0,0,0
650077,54,54,0,0,0
650100,402,402,0,0,0
650121,101,101,0,0,0
650148,11,11,0,0,0
650154,56,56,0,0,0
650157,193,193,0,0,0
650163,4,4,0,0,0
650173,131,131,0,0,0
650204,151,151,0,0,0
650224,163,163,0,0,0
650229,152,152,0,0,0
650232,171,171,0,0,0
650233,345,345,0,0,0
650237,313,313,0,0,0
650260,58,58,0,0,0
650266,402,402,0,0,0
650274,41,41,0,0,0
650276,158,158,0,0,0
650320,402,402,0,0,0
650335,34,34,0,0,0
650344,184,184,0,0,0
650349,67,67,0,0,0
650351,281,281,0,0,0
650356,163,163,0,0,0
650363,246,246,0,0,0
650381,193,193,0,0,0
650399,201,201,0,0,0
650406,201,201,0,0,0
650409,40,40,0,0,0
650412,56,56,0,0,0
650440,121,121,0,0,0
650448,137,137,0,0,0
650452,252,252,0,0,0
650454,152,152,0,0,0
650461,43,43,0,0,0
650467,402,402,0,0,0
650470,255,255,0,0,0
650518,11,11,0,0,0
650523,19,19,0,0,0
650528,232,232,0,0,0
650529,143,143,0,0,0
650532,143,143,0,0,0
650538,282,282,0,0,0
650543,163,163,0,0,0
650556,353,353,0,0,0
650561,345,345,0,0,0
650562,306,306,0,0,0
650571,67,67,0,0,0
650577,128,128,0,0,0
650583,198,198,0,0,0
650594,32,32,0,0,0
650618,35,35,0,0,0
650636,313,313,0,0,0
650647,315,315,0,0,0
650652,22,22,0,0,0
650660,402,402,0,0,0
650661,255,255,0,0,0
650677,359,359,0,0,0
650678,4,4,0,0,0
650703,40,40,0,0,0
650706,121,121,0,0,0
650707,259,259,0,0,0
650709,56,56,0,0,0
650717,20,20,0,0,0
650721,20,20,0,0,0
650722,315,315,0,0,0
650725,251,251,0,0,0
650746,5,5,0,0,0
650752,345,345,0,0,0
650764,299,299,0,0,0
650774,282,282,0,0,0
650787,198,198,0,0,0
650789,282,282,0,0,0
650797,152,152,0,0,0
650798,402,402,0,0,0
650841,7,7,0,0,0
650852,251,251,0,0,0
650860,184,184,0,0,0
650869,315,315,0,0,0
650880,15,15,0,0,0
650903,75,75,0,0,0
650912,246,246,0,0,0
650914,76,76,0,0,0
650935,1,1,0,0,0
650974,8,8,0,0,0
650981,282,282,0,0,0
650988,85,85,0,0,0
650990,20,20,0,0,0
650997,63,63,0,0,0
651002,102,102,0,0,0
651003,131,131,0,0,0
651004,193,193,0,0,0
651033,66,66,0,0,0
651039,180,180,0,0,0
651055,14,14,0,0,0
651079,121,121,0,0,0
651085,152,152,0,0,0
651091,306,306,0,0,0
651098,113,113,0,0,0
651102,353,353,0,0,0
651106,9,9,0,0,0
651108,71,71,0,0,0
651110,252,252,0,0,0
651111,168,168,0,0,0
651121,14,14,0,0,0
651123,168,168,0,0,0
651145,7,7,0,0,0
651156,56,56,0,0,0
651160,353,353,0,0,0
651167,130,130,0,0,0
651173,168,168,0,0,0
651177,63,63,0,0,0
651192,315,315,0,0,0
651193,402,402,0,0,0
651194,201,201,0,0,0
651207,97,97,0,0,0
651233,35,35,0,0,0
651244,54,54,0,0,0
651264,402,402,0,0,0
651266,8,8,0,0,0
651281,282,282,0,0,0
651291,114,114,0,0,0
651302,184,184,0,0,0
651318,281,281,0,0,0
651320,12,12,0,0,0
651322,402,402,0,0,0
651333,63,63,0,0,0
651344,34,34,0,0,0
651346,143,143,0,0,0
651354,16,16,0,0,0
651357,34,34,0,0,0
651359,167,167,0,0,0
651385,97,97,0,0,0
651394,130,130,0,0,0
651411,102,102,0,0,0
651415,152,152,0,0,0
651418,36,36,0,0,0
651428,35,35,0,0,0
651434,168,168,0,0,0
651436,252,252,0,0,0
651470,57,57,0,0,0
651476,359,359,0,0,0
651502,315,315,0,0,0
651509,102,102,0,0,0
651511,133,133,0,0,0
651550,152,152,0,0,0
651562,345,345,0,0,0
651573,74,74,0,0,0
651580,137,137,0,0,0
651582,44,44,0,0,0
651584,163,163,0,0,0
651588,306,306,0,0,0
651596,3,3,0,0,0
651601,8,8,0,0,0
651607,353,353,0,0,0
651610,70,70,0,0,0
651618,353,353,0,0,0
651621,44,44,0,0,0
651625,35,35,0,0,0
651670,39,39,0,0,0
651679,359,359,0,0,0
651681,402,402,0,0,0
651685,131,131,0,0,0
651689,65,65,0,0,0
651697,76,76,0,0,0
651708,67,67,0,0,0
651722,259,259,0,0,0
651733,315,315,0,0,0
651742,198,198,0,0,0
651747,313,313,0,0,0
651752,353,353,0,0,0
651775,23,23,0,0,0
651781,21,21,0,0,0
651784,299,299,0,0,0
651790,353,353,0,0,0
651792,180,180,0,0,0
651796,67,67,0,0,0
651800,255,255,0,0,0
651808,76,76,0,0,0
651813,168,168,0,0,0
651817,353,353,0,0,0
651819,313,313,0,0,0
651824,137,137,0,0,0
651842,310,310,0,0,0
651850,58,58,0,0,0
651854,402,402,0,0,0
651864,359,359,0,0,0
651870,35,35,0,0,0
651889,306,306,0,0,0
651909,16,16,0,0,0
651911,77,77,0,0,0
651917,114,114,0,0,0
651925,29,29,0,0,0
651936,255,255,0,0,0
651938,74,74,0,0,0
651939,66,66,0,0,0
651952,167,167,0,0,0
651966,20,20,0,0,0
651991,168,168,0,0,0
652007,281,281,0,0,0
652013,313,313,0,0,0
652040,131,131,0,0,0
652077,82,82,0,0,0
652085,310,310,0,0,0
652095,76,76,0,0,0
652103,151,151,0,0,0
652104,130,130,0,0,0
652105,69,69,0,0,0
652114,15,15,0,0,0
652159,259,259,0,0,0
652162,246,246,0,0,0
652166,76,76,0,0,0
652183,65,65,0,0,0
652195,17,17,0,0,0
652197,402,402,0,0,0
652206,74,74,0,0,0
652208,359,359,0,0,0
652249,4,4,0,0,0
652259,282,282,0,0,0
652260,184,184,0,0,0
652265,144,144,0,0,0
652302,133,133,0,0,0
652307,11,11,0,0,0
652308,198,198,0,0,0
652315,18,18,0,0,0
652316,259,259,0,0,0
652322,102,102,0,0,0
652329,402,402,0,0,0
652332,74,74,0,0,0
652342,359,359,0,0,0
652349,345,345,0,0,0
652366,353,353,0,0,0
652367,102,102,0,0,0
652370,65,65,0,0,0
652374,353,353,0,0,0
652387,402,402,0,0,0
652392,71,71,0,0,0
652397,345,345,0,0,0
652419,128,128,0,0,0
652443,158,158,0,0,0
652445,246,246,0,0,0
652451,163,163,0,0,0
652459,255,255,0,0,0
652482,18,18,0,0,0
652502,121,121,0,0,0
652553,56,56,0,0,0
652565,281,281,0,0,0
652567,251,251,0,0,0
652579,6,6,0,0,0
652583,402,402,0,0,0
652587,345,345,0,0,0
652594,22,22,0,0,0
652623,14,14,0,0,0
652626,58,58,0,0,0
652627,44,44,0,0,0
652630,359,359,0,0,0
652633,137,137,0,0,0
652636,359,359,0,0,0
652639,76,76,0,0,0
652642,281,281,0,0,0
652651,5,5,0,0,0
652663,246,246,0,0,0
652664,232,232,0,0,0
652684,402,402,0,0,0
652689,120,120,0,0,0
652709,359,359,0,0,0
652731,310,310,0,0,0
652738,299,299,0,0,0
652748,27,27,0,0,0
652754,152,152,0,0,0
652755,402,402,0,0,0
652757,19,19,0,0,0
652779,76,76,0,0,0
652795,151,151,0,0,0
652804,72,72,0,0,0
652837,63,63,0,0,0
652853,4,4,0,0,0
652855,21,21,0,0,0
652857,193,193,0,0,0
652869,74,74,0,0,0
652883,43,43,0,0,0
652891,57,57,0,0,0
652893,313,313,0,0,0
652894,255,255,0,0,0
652895,171,171,0,0,0
652897,158,158,0,0,0
652908,299,299,0,0,0
652927,128,128,0,0,0
652931,163,163,0,0,0
652932,255,255,0,0,0
652955,315,315,0,0,0
652974,85,85,0,0,0
652977,353,353,0,0,0
652989,131,131,0,0,0
653003,168,168,0,0,0
653016,310,310,0,0,0
653058,41,41,0,0,0
653060,82,82,0,0,0
653088,102,102,0,0,0
653103,232,232,0,0,0
653117,24,24,0,0,0
653121,359,359,0,0,0
653145,1,1,0,0,0
653194,353,353,0,0,0
653195,353,353,0,0,0
653199,8,8,0,0,0
653203,310,310,0,0,0
653209,281,281,0,0,0
653231,252,252,0,0,0
653244,10,10,0,0,0
653268,35,35,0,0,0
653285,180,180,0,0,0
653302,23,23,0,0,0
653320,12,12,0,0,0
653327,232,232,0,0,0
653364,87,87,0,0,0
653368,82,82,0,0,0
653385,281,281,0,0,0
653394,72,72,0,0,0
653395,35,35,0,0,0
653408,21,21,0,0,0
653412,345,345,0,0,0
653413,315,315,0,0,0
653444,198,198,0,0,0
653462,353,353,0,0,0
653467,103,103,0,0,0
653471,282,282,0,0,0
653472,69,69,0,0,0
653493,94,94,0,0,0
653502,76,76,0,0,0
653507,232,232,0,0,0
653535,246,246,0,0,0
653560,44,44,0,0,0
653564,3,3,0,0,0
653577,82,82,0,0,0
653578,94,94,0,0,0
653626,5,5,0,0,0
653643,359,359,0,0,0
653648,85,85,0,0,0
653699,11,11,0,0,0
653725,9,9,0,0,0
653730,133,133,0,0,0
653736,163,163,0,0,0
653741,18,18,0,0,0
653745,103,103,0,0,0
653752,20,20,0,0,0
653759,315,315,0,0,0
653773,251,251,0,0,0
653777,167,167,0,0,0
653782,65,65,0,0,0
653783,21,21,0,0,0
653788,101,101,0,0,0
653789,114,114,0,0,0
653815,232,232,0,0,0
653818,282,282,0,0,0
653819,402,402,0,0,0
653853,158,158,0,0,0
653877,402,402,0,0,0
653882,402,402,0,0,0
653894,163,163,0,0,0
653906,114,114,0,0,0
653914,353,353,0,0,0
653920,151,151,0,0,0
653928,137,137,0,0,0
653930,87,87,0,0,0
653937,102,102,0,0,0
653943,114,114,0,0,0
653955,198,198,0,0,0
653965,251,251,0,0,0
653966,9,9,0,0,0
653973,85,85,0,0,0
653984,180,180,0,0,0
653997,252,252,0,0,0
654004,36,36,0,0,0
654006,345,345,0,0,0
654007,299,299,0,0,0
654008,232,232,0,0,0
654013,66,66,0,0,0
654015,282,282,0,0,0
654020,193,193,0,0,0
654022,137,137,0,0,0
654025,102,102,0,0,0
654036,180,180,0,0,0
654054,259,259,0,0,0
654055,252,252,0,0,0
654060,306,306,0,0,0
654078,345,345,0,0,0
654085,72,72,0,0,0
654086,143,143,0,0,0
654087,103,103,0,0,0
654091,252,252,0,0,0
654104,201,201,0,0,0
654110,70,70,0,0,0
654171,50,50,0,0,0
654172,15,15,0,0,0
654178,10,10,0,0,0
654188,56,56,0,0,0
654191,313,313,0,0,0
654199,17,17,0,0,0
654208,69,69,0,0,0
654222,102,102,0,0,0
654225,102,102,0,0,0
654231,306,306,0,0,0
654238,128,128,0,0,0
654252,180,180,0,0,0
654260,193,193,0,0,0
654266,259,259,0,0,0
654279,313,313,0,0,0
654309,198,198,0,0,0
654315,144,144,0,0,0
654325,313,313,0,0,0
654336,121,121,0,0,0
654366,34,34,0,0,0
654375,70,70,0,0,0
654386,281,281,0,0,0
654391,359,359,0,0,0
654393,345,345,0,0,0
654399,34,34,0,0,0
654429,232,232,0,0,0
654442,102,102,0,0,0
654449,70,70,0,0,0
654453,255,255,0,0,0
654457,299,299,0,0,0
654459,120,120,0,0,0
654461,168,168,0,0,0
654474,82,82,0,0,0
654486,359,359,0,0,0
654492,246,246,0,0,0
654508,8,8,0,0,0
654509,345,345,0,0,0
654514,63,63,0,0,0
654537,255,255,0,0,0
654558,137,137,0,0,0
654573,18,18,0,0,0
654585,74,74,0,0,0
654618,85,85,0,0,0
654625,19,19,0,0,0
654643,9,9,0,0,0
654677,76,76,0,0,0
654680,83,83,0,0,0
654681,13,13,0,0,0
654719,36,36,0,0,0
654730,76,76,0,0,0
654748,12,12,0,0,0
654755,345,345,0,0,0
654780,315,315,0,0,0
654809,282,282,0,0,0
654817,402,402,0,0,0
654825,180,180,0,0,0
654831,70,70,0,0,0
654844,19,19,0,0,0
654850,143,143,0,0,0
654863,121,121,0,0,0
654875,76,76,0,0,0
654887,130,130,0,0,0
654888,16,16,0,0,0
654901,130,130,0,0,0
654920,198,198,0,0,0
654930,163,163,0,0,0
654954,121,121,0,0,0
654965,252,252,0,0,0
654966,345,345,0,0,0
654972,18,18,0,0,0
654973,306,306,0,0,0
654984,8,8,0,0,0
654999,85,85,0,0,0
655027,180,180,0,0,0
655033,143,143,0,0,0
655038,114,114,0,0,0
655040,19,19,0,0,0
655046,130,130,0,0,0
655057,74,74,0,0,0
655071,163,163,0,0,0
655075,35,35,0,0,0
655081,168,168,0,0,0
655107,163,163,0,0,0
655128,345,345,0,0,0
655144,85,85,0,0,0
655150,34,34,0,0,0
655171,72,72,0,0,0
655185,232,232,0,0,0
655186,402,402,0,0,0
655202,3,3,0,0,0
655227,56,56,0,0,0
655228,310,310,0,0,0
655229,152,152,0,0,0
655230,102,102,0,0,0
655233,246,246,0,0,0
655267,171,171,0,0,0
655271,43,43,0,0,0
655288,18,18,0,0,0
655290,94,94,0,0,0
655291,143,143,0,0,0
655298,133,133,0,0,0
655315,345,345,0,0,0
655323,102,102,0,0,0
655334,193,193,0,0,0
655338,85,85,0,0,0
655340,152,152,0,0,0
655345,143,143,0,0,0
655352,232,232,0,0,0
655353,130,130,0,0,0
655363,353,353,0,0,0
655374,313,313,0,0,0
655395,313,313,0,0,0
655400,19,19,0,0,0
655401,232,232,0,0,0
655411,130,130,0,0,0
655414,137,137,0,0,0
655416,15,15,0,0,0
655433,114,114,0,0,0
655442,345,345,0,0,0
655445,353,353,0,0,0
655449,137,137,0,0,0
655471,101,101,0,0,0
655491,74,74,0,0,0
655493,76,76,0,0,0
655501,114,114,0,0,0
655505,2,2,0,0,0
655520,144,144,0,0,0
655523,133,133,0,0,0
655531,72,72,0,0,0
655534,121,121,0,0,0
655557,103,103,0,0,0
655565,313,313,0,0,0
655568,34,34,0,0,0
655572,102,102,0,0,0
655590,232,232,0,0,0
655591,259,259,0,0,0
655592,121,121,0,0,0
655608,113,113,0,0,0
655622,34,34,0,0,0
655640,255,255,0,0,0
655651,306,306,0,0,0
655660,41,41,0,0,0
655676,137,137,0,0,0
655702,345,345,0,0,0
655703,251,251,0,0,0
655718,151,151,0,0,0
655731,281,281,0,0,0
655733,152,152,0,0,0
655735,359,359,0,0,0
655748,25,25,0,0,0
655758,35,35,0,0,0
655765,143,143,0,0,0
655781,74,74,0,0,0
655785,132,132,0,0,0
655806,310,310,0,0,0
655807,102,102,0,0,0
655818,168,168,0,0,0
655823,43,43,0,0,0
655826,5,5,0,0,0
655846,313,313,0,0,0
655851,114,114,0,0,0
655858,201,201,0,0,0
655871,310,310,0,0,0
655872,306,306,0,0,0
655886,193,193,0,0,0
655889,259,259,0,0,0
655902,113,113,0,0,0
655907,313,313,0,0,0
655924,71,71,0,0,0
655950,281,281,0,0,0
655952,120,120,0,0,0
655974,144,144,0,0,0
655984,137,137,0,0,0
655986,184,184,0,0,0
655988,345,345,0,0,0
655992,83,83,0,0,0
